DMA,Zip,Total Population,2024 Females Age 15-19,2024 Females Age 20-24,2024 Females Age 25-29,Total Female GenZ,GenZ Female %
Los Angeles,90095,4,2,1,0,3,0.75
Pittsburgh,15260,3,1,1,0,2,0.666666667
Indianapolis,47306,107,50,21,0,71,0.663551402
Springfield-Holyoke,1063,772,202,282,18,502,0.650259067
Mobile-Pensacola (Ft Walt),36688,2010,123,1024,147,1294,0.643781095
Cedar Rapids-Wtrlo-IWC&Dub,50614,2694,1221,471,3,1695,0.629175947
"Washington, DC (Hagrstwn)",20059,1893,250,910,14,1174,0.620179609
Salt Lake City,84602,4502,2448,328,14,2790,0.619724567
Greensboro-H.Point-W.Salem,27412,1912,751,409,21,1181,0.617677824
Tallahassee-Thomasville,32307,1045,448,158,17,623,0.596172249
Tallahassee-Thomasville,32306,6301,2992,715,16,3723,0.590858594
Tampa-St. Pete (Sarasota),33620,3463,1313,674,10,1997,0.576667629
Miami-Ft. Lauderdale,33199,3512,918,1080,24,2022,0.575740319
Harrisonburg,22807,5500,2366,773,16,3155,0.573636364
Norfolk-Portsmth-Newpt Nws,23668,117,31,35,1,67,0.572649573
Erie,16444,1208,385,295,11,691,0.572019868
Cleveland-Akron (Canton),44243,5011,1702,1081,80,2863,0.571343045
Oklahoma City,73019,4245,1397,1005,15,2417,0.569375736
Orlando-Daytona Bch-Melbrn,32816,8939,3960,1098,30,5088,0.569191185
"Columbus, GA (Opelika, AL)",36849,4013,1039,1207,22,2268,0.56516322
Ft. Myers-Naples,33965,2207,806,434,7,1247,0.56502039
Los Angeles,91330,2050,398,681,75,1154,0.562926829
Pittsburgh,15705,1780,552,430,11,993,0.557865169
Toledo,43403,4072,1532,695,37,2264,0.555992141
Syracuse,13244,436,47,191,2,240,0.550458716
Atlanta,30602,3691,309,1620,75,2004,0.542942292
Seattle-Tacoma,98195,3825,1447,622,6,2075,0.54248366
Austin,78712,5030,2185,517,19,2721,0.540954274
Missoula,59812,1198,211,424,12,647,0.540066778
New York,12604,2054,511,582,14,1107,0.538948393
Terre Haute,47809,1003,270,260,10,540,0.538384845
Los Angeles,92521,3705,1598,331,62,1991,0.537381916
Lansing,48825,5381,1746,1076,61,2883,0.53577402
Madison,53706,7069,3314,427,13,3754,0.531051068
Birmingham (Ann and Tusc),35229,2735,541,849,61,1451,0.530530165
Philadelphia,19716,4007,593,1337,194,2124,0.530072373
"Washington, DC (Hagrstwn)",20052,8058,1751,2182,299,4232,0.525192355
Philadelphia,19717,130,20,41,7,68,0.523076923
Lansing,48824,3446,1008,770,23,1801,0.522634939
Lincoln & Hastings-Krny,68588,3581,1371,488,6,1865,0.520804245
New York,11549,2898,692,784,30,1506,0.519668737
Santabarbra-Sanmar-Sanluob,93106,4854,1644,673,198,2515,0.518129378
Charlotte,28608,35,10,8,0,18,0.514285714
Greenvll-Spart-Ashevll-And,29634,6186,2467,701,10,3178,0.513740705
Flint-Saginaw-Bay City,48710,1622,683,138,12,833,0.513563502
San Diego,92093,9894,3212,1689,176,5077,0.513139276
Boston (Manchester),3435,998,294,215,3,512,0.513026052
Detroit,48109,4430,716,1511,39,2266,0.511512415
Salt Lake City,84322,1948,687,290,19,996,0.511293634
"Lafayette, IN",47907,4767,1618,811,5,2434,0.510593665
Kansas City,66045,3333,1238,439,15,1692,0.507650765
Lubbock,79409,6848,3019,418,25,3462,0.505549065
Gainesville,32611,10752,3906,1230,277,5413,0.50344122
Raleigh-Durham (Fayetvlle),27708,6026,1520,1319,193,3032,0.503153004
Oklahoma City,74078,1689,575,270,4,849,0.502664298
Baton Rouge,70803,18,8,1,0,9,0.5
Idaho Fals-Pocatllo(Jcksn),83460,18,5,4,0,9,0.5
San Diego,92182,8,1,3,0,4,0.5
Hartford & New Haven,6269,12461,3131,2957,79,6167,0.494904101
Indianapolis,47405,4612,2038,227,15,2280,0.494362533
Springfield-Holyoke,1003,8988,2538,1855,25,4418,0.491544281
Birmingham (Ann and Tusc),35487,12492,3557,2455,112,6124,0.49023375
Columbia-Jefferson City,65211,1346,443,199,13,655,0.486627043
"Columbus, OH",43210,9286,1714,2571,229,4514,0.48610812
Los Angeles,92697,7008,2397,580,423,3400,0.485159817
Santabarbra-Sanmar-Sanluob,93407,7347,1174,2288,77,3539,0.481693208
Dayton,45469,528,176,76,1,253,0.479166667
Philadelphia,19383,876,59,344,16,419,0.478310502
Indianapolis,47406,1773,435,385,24,844,0.476029329
Providence-New Bedford,2881,7938,2210,1504,64,3778,0.475938524
Minneapolis-St. Paul,55455,4707,1389,763,84,2236,0.475037179
Knoxville,37916,14248,3195,3367,193,6755,0.474101628
Denver,80309,4658,2021,162,9,2192,0.470588235
Charlottesville,22904,3840,1432,291,71,1794,0.4671875
"Washington, DC (Hagrstwn)",20742,9088,2058,2094,63,4215,0.463798415
Cincinnati,45221,742,177,164,3,344,0.46361186
Johnstown-Altoona-St Colge,16802,13563,1756,4321,209,6286,0.463466785
Baton Rouge,70813,2285,616,407,30,1053,0.46083151
St. Louis,62026,1195,239,283,18,540,0.451882845
Eugene,97331,3340,517,946,27,1490,0.446107784
Monterey-Salinas,95064,8559,1971,1656,186,3813,0.445495969
Seattle-Tacoma,98447,645,173,106,7,286,0.443410853
Charlotte,28223,2305,737,258,19,1014,0.439913232
Roanoke-Lynchburg,24061,10285,3390,1082,19,4491,0.436655323
Des Moines-Ames,50013,1255,483,61,0,544,0.433466135
Macon,31207,676,135,143,14,292,0.431952663
Spokane,99251,814,204,139,8,351,0.431203931
Atlanta,30322,2749,79,769,337,1185,0.431065842
Des Moines-Ames,50011,1738,664,85,0,749,0.430955121
Buffalo,14260,557,133,103,4,240,0.430879713
Philadelphia,8544,4368,612,1177,91,1880,0.43040293
Buffalo,14261,5911,1412,1093,37,2542,0.430045678
Baltimore,21251,1397,162,409,26,597,0.427344309
Salt Lake City,84112,3008,461,750,71,1282,0.426196809
Cedar Rapids-Wtrlo-IWC&Dub,52242,2243,307,456,191,954,0.425323228
Chicago,60208,2943,798,444,6,1248,0.424057085
Boston (Manchester),2215,26234,1936,5766,3304,11006,0.419531905
Greensboro-H.Point-W.Salem,27268,1551,344,290,16,650,0.419084462
San Francisco-Oak-San Jose,94720,1196,133,305,63,501,0.418896321
Salt Lake City,84113,147,22,36,3,61,0.414965986
Topeka,66506,3037,743,427,87,1257,0.413895291
New Orleans,70402,1913,459,312,20,791,0.41348667
Des Moines-Ames,50012,2249,756,169,1,926,0.41173855
Los Angeles,90089,1959,92,447,267,806,0.411434405
San Diego,92134,377,40,97,17,154,0.408488064
Birmingham (Ann and Tusc),35233,5555,660,1103,470,2233,0.401980198
Austin,78705,31558,2984,7878,1769,12631,0.400247164
Wichita-Hutchinson Plus,67260,942,218,131,24,373,0.39596603
Fargo,56563,1164,147,284,23,454,0.390034364
Phoenix (Prescott),85287,245,67,19,9,95,0.387755102
Los Angeles,90747,752,122,141,25,288,0.382978723
Los Angeles,90263,1494,225,318,26,569,0.38085676
Fargo,58202,2260,544,267,46,857,0.37920354
Pittsburgh,15213,31862,3724,7306,997,12027,0.377471596
Erie,16546,1410,248,261,21,530,0.375886525
Monroe-El Dorado,71245,4834,679,947,190,1816,0.375672321
Atlanta,30063,16,2,3,1,6,0.375
Reno,89557,32,4,6,2,12,0.375
"Columbia, SC",29201,29775,4252,5418,1473,11143,0.374240134
San Antonio,78236,9769,1392,1910,346,3648,0.373426144
San Francisco-Oak-San Jose,94704,32271,4082,6615,1332,12029,0.372749527
Los Angeles,92617,17913,997,4037,1390,6424,0.35862223
New York,10577,6141,1346,776,71,2193,0.357107963
Boston (Manchester),2115,30154,3184,5811,1715,10710,0.355176759
San Francisco-Oak-San Jose,94305,20830,381,3805,3119,7305,0.350696111
Montgomery-Selma,36088,4545,820,619,146,1585,0.348734873
Chattanooga,37403,5759,493,1275,230,1998,0.346935232
Minneapolis-St. Paul,55414,36188,1890,8280,2341,12511,0.345722339
"Charleston, SC",29424,232,21,52,7,80,0.344827586
Lincoln & Hastings-Krny,68849,1804,267,298,55,620,0.34368071
Providence-New Bedford,2912,50,8,9,0,17,0.34
Gainesville,32603,4956,234,1306,141,1681,0.339184826
Sacramnto-Stkton-Modesto,95211,1549,263,231,31,525,0.338928341
"Jackson, MS",39096,2224,328,392,30,750,0.337230216
"Columbus, OH",43201,43859,1788,9933,2962,14683,0.334777355
Cincinnati,45219,22338,2098,4539,822,7459,0.333915301
Omaha,68182,789,86,150,25,261,0.330798479
Boston (Manchester),3824,14982,1746,2750,447,4943,0.329929248
Syracuse,14853,5573,877,890,63,1830,0.328368922
Milwaukee,53233,15870,1415,3035,740,5190,0.327032136
Nashville,37212,23558,2473,3346,1836,7655,0.324942695
"Washington, DC (Hagrstwn)",20889,1008,53,218,56,327,0.324404762
Erie,16563,1436,137,318,9,464,0.323119777
San Angelo,76909,152,15,29,5,49,0.322368421
Tallahassee-Thomasville,32304,47374,3279,9732,2256,15267,0.322265378
Los Angeles,90024,50807,5700,8456,2080,16236,0.319562265
Waco-Temple-Bryan,77840,60828,5854,10583,2699,19136,0.314591964
Charleston-Huntington,25703,6429,810,1003,203,2016,0.313579095
Madison,53715,15631,1155,3109,628,4892,0.31296782
Syracuse,13210,28402,2890,4658,1305,8853,0.311703401
Gainesville,32601,22742,1551,4234,1280,7065,0.310658693
Salt Lake City,84606,34059,1513,7094,1937,10544,0.309580434
Richmond-Petersburg,23220,40471,3509,5683,3315,12507,0.3090361
Eugene,97403,15227,1733,2485,469,4687,0.307808498
Champaign&Sprngfld-Decatur,61820,40830,3611,7187,1727,12525,0.306759735
Boston (Manchester),2163,1333,7,26,374,407,0.305326332
Atlanta,30303,9874,1531,983,463,2977,0.301498886
Grand Rapids-Kalmzoo-B.Crk,49401,30572,3240,5250,723,9213,0.30135418
Orlando-Daytona Bch-Melbrn,32826,34971,4991,4183,1344,10518,0.30076349
Philadelphia,19085,11833,1600,1806,123,3529,0.298233753
Watertown,13699,1918,302,265,4,571,0.297705944
Philadelphia,19104,61362,5083,8808,4361,18252,0.297447932
Sacramnto-Stkton-Modesto,95616,54433,5381,8198,2603,16182,0.297282898
Buffalo,14802,4475,619,654,52,1325,0.296089385
Dayton,45314,5896,730,883,125,1738,0.294776119
Phoenix (Prescott),86001,41357,4539,6097,1547,12183,0.294581328
Dayton,45409,11562,1197,1964,234,3395,0.293634319
Boston (Manchester),2120,19206,1177,3374,1078,5629,0.293085494
Oklahoma City,73027,2822,395,384,47,826,0.292700213
New York,11548,2423,358,308,43,709,0.292612464
Greenvll-Spart-Ashevll-And,28723,11709,1319,1776,298,3393,0.289777095
Bangor,4473,10833,1213,1679,242,3134,0.289301209
Madison,53703,39039,1093,6674,3496,11263,0.288506365
Idaho Fals-Pocatllo(Jcksn),83440,53116,3765,8969,2507,15241,0.286938022
Boston (Manchester),2134,21723,261,2946,2987,6194,0.285135571
El Paso (Las Cruces),79968,443,53,58,15,126,0.284424379
Greensboro-H.Point-W.Salem,27403,25183,1891,4291,922,7104,0.282095064
Chicago,60603,1204,146,115,77,338,0.280730897
Cleveland-Akron (Canton),44304,5128,706,579,151,1436,0.280031201
"Columbus, OH",43022,4213,437,681,60,1178,0.279610729
Charlotte,28607,37085,3654,5759,916,10329,0.278522314
Denver,80521,37430,3808,4741,1857,10406,0.27801229
Cincinnati,45056,26829,2559,4305,573,7437,0.277200045
Detroit,48104,41765,1967,7406,2190,11563,0.276858614
Lexington,40508,23047,2218,3290,851,6359,0.275914436
Pittsburgh,15419,3551,426,414,138,978,0.275415376
Birmingham (Ann and Tusc),35401,38757,2991,6352,1307,10650,0.27478907
Dallas-Ft. Worth,76201,27476,1569,4092,1877,7538,0.274348522
Houston,77445,19864,2745,2205,496,5446,0.274164317
"Springfield, MO",65806,11911,836,1918,506,3260,0.273696583
Chicago,60604,870,97,80,61,238,0.273563218
Salt Lake City,84408,377,51,36,16,103,0.273209549
Burlington-Plattsburgh,5401,34713,2887,4657,1866,9410,0.271079999
Pittsburgh,26505,40567,3322,5204,2388,10914,0.269036409
Columbia-Jefferson City,65201,50081,3965,7334,2131,13430,0.268165572
Greenville-N.Bern-Washngtn,28543,4542,176,755,284,1215,0.267503303
Louisville,40208,16409,1081,2379,928,4388,0.267414224
Seattle-Tacoma,98105,50589,3302,7134,3066,13502,0.266895966
Buffalo,14744,2008,84,405,43,532,0.264940239
Spokane,99163,33629,2750,4478,1678,8906,0.264830949
Syracuse,13346,6330,688,902,79,1669,0.263665087
Lincoln & Hastings-Krny,68508,13771,1041,2050,536,3627,0.263379566
Wilkes Barre-Scranton-Hztn,18701,5020,502,696,120,1318,0.262549801
New York,11790,25227,3546,2117,958,6621,0.262456891
Omaha,68421,1027,126,127,16,269,0.261927945
Tucson (Sierra Vista),85719,44474,3390,5921,2301,11612,0.261096371
Greenvll-Spart-Ashevll-And,29631,17887,935,3152,537,4624,0.258511768
Lubbock,79401,8792,348,1562,359,2269,0.258075523
Providence-New Bedford,2903,14348,1447,1320,921,3688,0.257039309
Sioux Falls(Mitchell),57069,13629,1171,1649,674,3494,0.256365104
Savannah,31401,25867,1931,3135,1534,6600,0.255151351
Baton Rouge,70820,22830,895,3323,1591,5809,0.254445905
San Angelo,76908,1880,154,245,79,478,0.254255319
Madison,53726,4682,125,794,271,1190,0.254164887
Raleigh-Durham (Fayetvlle),27514,34240,3385,4004,1298,8687,0.253709112
Philadelphia,19122,30657,2302,3624,1837,7763,0.253221124
Boston (Manchester),2113,7126,43,180,1577,1800,0.252596127
Raleigh-Durham (Fayetvlle),27607,29276,2761,2868,1763,7392,0.25249351
Salt Lake City,84148,119,3,14,13,30,0.25210084
Baltimore,21204,24818,2596,2750,902,6248,0.25175276
"Rochester, NY",14454,10760,748,1742,218,2708,0.251672862
Atlanta,30313,9781,277,1780,402,2459,0.251405787
San Antonio,78234,7232,771,720,325,1816,0.251106195
Phoenix (Prescott),85281,73426,4183,8790,5418,18391,0.250469861
Fresno-Visalia,93246,8,0,1,1,2,0.25
Fresno-Visalia,95343,8,1,1,0,2,0.25
"Columbus, OH",45701,30554,1773,4632,1218,7623,0.249492701
Fargo,58405,405,43,48,10,101,0.249382716
"Washington, DC (Hagrstwn)",20006,169,2,7,33,42,0.24852071
Des Moines-Ames,50014,35790,2142,5366,1367,8875,0.247974294
Indianapolis,47408,25041,1817,3368,1021,6206,0.247833553
Atlanta,30605,44696,1643,6838,2579,11060,0.247449436
Pittsburgh,15232,12281,328,959,1742,3029,0.246641153
Pittsburgh,16057,15309,1562,1774,424,3760,0.245607159
Binghamton,13820,23421,1353,3840,540,5733,0.244780325
Huntsville-Decatur (Flor),35896,372,32,48,11,91,0.244623656
Richmond-Petersburg,23219,6044,55,541,881,1477,0.244374586
Lansing,48823,57472,2747,9209,2045,14001,0.243614282
Peoria-Bloomington,61606,6764,720,716,199,1635,0.241720875
Fairbanks,99775,472,27,59,28,114,0.241525424
Springfield-Holyoke,1002,32792,2443,4046,1428,7917,0.241430837
St. Louis,63108,23773,1394,2242,2102,5738,0.241366256
Miami-Ft. Lauderdale,33146,18528,704,3173,578,4455,0.240446891
Houston,77004,42205,3090,4956,2066,10112,0.239592465
San Francisco-Oak-San Jose,94709,11993,689,1365,803,2857,0.238222296
Champaign&Sprngfld-Decatur,61801,27990,2320,2812,1522,6654,0.23772776
Cincinnati,45207,7367,961,597,184,1742,0.236459889
Phoenix (Prescott),85309,793,77,104,6,187,0.235813367
Duluth-Superior,55812,10649,734,1346,428,2508,0.235515072
Indianapolis,47303,26498,2262,3188,788,6238,0.235413994
Chattanooga,37375,4068,340,560,57,957,0.235250737
"Columbus, GA (Opelika, AL)",36832,31129,1369,4418,1510,7297,0.234411642
Greensboro-H.Point-W.Salem,27244,17310,1829,1822,384,4035,0.233102253
Santabarbra-Sanmar-Sanluob,93117,52902,3041,7483,1798,12322,0.232921251
Wheeling-Steubenville,26032,979,94,110,22,226,0.230847804
Indianapolis,46989,4956,100,953,91,1144,0.230831316
Tampa-St. Pete (Sarasota),33606,23712,2269,2001,1201,5471,0.230727058
Terre Haute,47807,13739,1058,1676,434,3168,0.230584468
Hartford & New Haven,6268,10902,633,1565,315,2513,0.230508164
Waco-Temple-Bryan,76706,44423,3617,4952,1653,10222,0.230106026
Boston (Manchester),2482,12546,1217,1479,189,2885,0.22995377
Ft. Smith-Fay-Sprngdl-Rgrs,72701,51307,3999,5914,1812,11725,0.228526322
Salt Lake City,84102,18220,360,1886,1917,4163,0.228485181
"Washington, DC (Hagrstwn)",20037,12892,181,1238,1523,2942,0.228203537
Buffalo,14803,1083,113,115,19,247,0.228070175
Colorado Springs-Pueblo,80840,6466,439,910,125,1474,0.227961646
Norfolk-Portsmth-Newpt Nws,23508,20281,1646,2243,727,4616,0.227602189
Honolulu,96762,6045,259,614,500,1373,0.227129859
Milwaukee,53190,20553,1698,2519,447,4664,0.22692551
Pittsburgh,16214,8548,829,829,279,1937,0.226602714
Omaha,68131,15138,946,1210,1265,3421,0.225987581
Oklahoma City,73104,4007,138,199,567,904,0.225605191
Austin,78666,97388,6540,11574,3797,21911,0.224986651
Dallas-Ft. Worth,75428,10987,916,1190,363,2469,0.224720124
Charlottesville,22903,43429,2141,5241,2357,9739,0.224251076
Birmingham (Ann and Tusc),35205,19021,1069,1545,1634,4248,0.223332107
Los Angeles,90007,43628,1624,5165,2916,9705,0.222448886
Pittsburgh,15203,11022,75,784,1585,2444,0.221738341
Minneapolis-St. Paul,55454,8620,662,834,414,1910,0.221577726
Lexington,41844,1092,115,106,20,241,0.220695971
San Diego,92135,3022,153,407,105,665,0.220052945
Greensboro-H.Point-W.Salem,27401,23151,2144,2109,841,5094,0.220033692
Indianapolis,46204,9347,119,465,1461,2045,0.218786777
Norfolk-Portsmth-Newpt Nws,23709,32,1,5,1,7,0.21875
Johnstown-Altoona-St Colge,16801,42415,1401,6255,1619,9275,0.218672639
Knoxville,37724,3452,264,361,129,754,0.218424102
New York,10003,55283,3497,3698,4878,12073,0.218385399
Savannah,30458,49085,3050,5900,1751,10701,0.218009575
Baltimore,21210,13001,674,1660,500,2834,0.217983232
Hartford & New Haven,6518,19993,1782,1768,803,4353,0.217726204
Burlington-Plattsburgh,3755,10135,806,1016,383,2205,0.217562901
Cincinnati,45220,14624,523,1658,998,3179,0.217382385
Pittsburgh,15219,19528,1381,1949,895,4225,0.216356002
Philadelphia,19121,43478,2339,4840,2212,9391,0.215994296
Greenwood-Greenville,38761,2164,327,83,56,466,0.215341959
Albany-Schenectady-Troy,12203,36264,3543,2947,1302,7792,0.21486874
Harrisburg-Lncstr-Leb-York,17551,11163,1006,1135,255,2396,0.214637642
Roanoke-Lynchburg,24141,23231,1724,2554,708,4986,0.214627007
Kansas City,66251,14,0,1,2,3,0.214285714
Denver,80302,26986,814,3910,1055,5779,0.214148077
Oklahoma City,74075,25532,1776,2633,1058,5467,0.214123453
Salt Lake City,84604,43194,1980,5556,1698,9234,0.213779692
Boston (Manchester),2467,20957,907,3042,523,4472,0.213389321
Burlington-Plattsburgh,3264,6465,451,691,237,1379,0.213302398
Roanoke-Lynchburg,24011,948,7,30,165,202,0.213080169
Minneapolis-St. Paul,56374,10306,829,1166,199,2194,0.212885698
Montgomery-Selma,36081,16635,758,2098,682,3538,0.2126841
Austin,78751,17767,162,1292,2318,3772,0.212303709
St. Louis,65409,179,12,20,6,38,0.212290503
Des Moines-Ames,50309,10682,135,572,1558,2265,0.212038944
Wilmington,28403,39687,1236,5066,2107,8409,0.211882984
"Washington, DC (Hagrstwn)",20740,30632,1885,3338,1265,6488,0.211804649
Cleveland-Akron (Canton),44106,26564,1344,2629,1644,5617,0.211451589
Watertown,13617,11543,980,1163,297,2440,0.211383522
Topeka,66044,26786,1705,2895,1055,5655,0.211117748
Pittsburgh,15222,6922,198,724,537,1459,0.210777232
Minneapolis-St. Paul,55114,6292,103,568,654,1325,0.21058487
New York,10006,3774,45,221,528,794,0.210386857
Syracuse,14850,66817,3319,7608,3075,14002,0.209557448
Orlando-Daytona Bch-Melbrn,32817,41583,3068,3615,2020,8703,0.209292259
West Palm Beach-Ft. Pierce,33431,22292,2268,1922,468,4658,0.208953885
Omaha,68102,10270,302,853,990,2145,0.208860759
Peoria-Bloomington,61761,53449,3915,5446,1787,11148,0.208572658
Johnstown-Altoona-St Colge,15940,3587,305,404,39,748,0.208530806
Gainesville,32607,37677,1687,4292,1871,7850,0.208349922
"Washington, DC (Hagrstwn)",20007,29748,1823,2478,1894,6195,0.208249294
"Washington, DC (Hagrstwn)",20036,5604,35,376,755,1166,0.208065667
"Washington, DC (Hagrstwn)",21727,6858,771,516,139,1426,0.207932342
Boston (Manchester),2138,37696,1767,3615,2451,7833,0.20779393
Nashville,37203,25202,331,1306,3597,5234,0.20768193
Binghamton,13850,29924,3321,2318,569,6208,0.207458896
Denver,80045,1526,6,69,241,316,0.207077326
Milwaukee,53202,28104,473,1551,3794,5818,0.207016795
Topeka,66502,44575,2032,5138,2051,9221,0.206864835
St. Louis,63103,8773,369,816,629,1814,0.206770774
Atlanta,30601,25373,882,3149,1191,5222,0.205809325
Albuquerque-Santa Fe,88330,3892,171,426,204,801,0.205806783
Milwaukee,53211,34606,1811,3102,2202,7115,0.205600185
Philadelphia,19530,15468,1268,1616,296,3180,0.205585725
Santabarbra-Sanmar-Sanluob,93405,28210,1119,3879,800,5798,0.205529954
"Rochester, NY",14607,17002,90,821,2582,3493,0.205446418
New Orleans,70118,34795,1551,4161,1430,7142,0.205259376
Boston (Manchester),2135,45637,436,2140,6788,9364,0.20518439
Hartford & New Haven,6510,4779,74,313,593,980,0.205063821
Boston (Manchester),3242,6022,237,912,85,1234,0.204915311
Houston,77340,36768,2567,3649,1305,7521,0.204552872
Waco-Temple-Bryan,77801,16040,524,1598,1159,3281,0.204551122
Phoenix (Prescott),85017,45638,3941,3898,1463,9302,0.203821377
Philadelphia,19127,6913,49,328,1032,1409,0.203818892
Sioux City,68787,7094,478,643,323,1444,0.203552298
Springfield-Holyoke,1060,16689,1011,1531,855,3397,0.203547247
Waco-Temple-Bryan,76832,403,7,32,43,82,0.203473945
Sacramnto-Stkton-Modesto,95903,2359,129,198,152,479,0.203052141
New York,8901,56475,4101,5121,2159,11381,0.201522798
Indianapolis,46202,24344,1135,1648,2118,4901,0.201322708
Boston (Manchester),2111,9766,755,641,570,1966,0.20131067
Seattle-Tacoma,98278,1320,50,174,41,265,0.200757576
El Paso (Las Cruces),79916,2263,177,200,77,454,0.200618648
New York,10005,10185,170,387,1480,2037,0.2
Richmond-Petersburg,23298,20,0,3,1,4,0.2
Chicago,60088,13333,1033,1102,531,2666,0.199954999
Indianapolis,47906,71870,3862,7808,2698,14368,0.199916516
Johnstown-Altoona-St Colge,16803,25001,556,2821,1618,4995,0.199792008
Philadelphia,19107,17488,292,1099,2092,3483,0.199165142
"Charleston, SC",29401,9612,459,1090,365,1914,0.199126092
Dallas-Ft. Worth,76109,28452,1044,3168,1449,5661,0.198966681
Panama City,32403,171,19,13,2,34,0.198830409
Seattle-Tacoma,98225,51233,2800,5007,2365,10172,0.198543907
Roanoke-Lynchburg,24060,47252,1429,6118,1825,9372,0.198340811
Flint-Saginaw-Bay City,48858,43203,2718,4318,1532,8568,0.198319561
New York,12561,18147,733,2294,570,3597,0.198214581
Harrisonburg,22801,41124,1962,4658,1498,8118,0.197402976
Denver,80303,28408,1763,2584,1247,5594,0.196916362
Eureka,95521,21336,957,1985,1252,4194,0.196569179
Grand Rapids-Kalmzoo-B.Crk,49008,19911,1777,1446,690,3913,0.196524534
Milwaukee,53203,2256,10,111,322,443,0.196365248
Jacksonville,32212,1371,45,142,82,269,0.196207148
Raleigh-Durham (Fayetvlle),27605,6031,83,486,614,1183,0.196153208
Philadelphia,19102,6854,58,403,883,1344,0.196089875
Tampa-St. Pete (Sarasota),33576,6989,653,619,97,1369,0.195879239
Providence-New Bedford,2906,30659,1328,2813,1864,6005,0.195864183
Cleveland-Akron (Canton),44115,10346,211,778,1032,2021,0.195341195
Boston (Manchester),1984,5032,400,524,57,981,0.194952305
Wilkes Barre-Scranton-Hztn,18510,14309,1044,1319,421,2784,0.194562863
Cedar Rapids-Wtrlo-IWC&Dub,52240,36331,1315,4390,1361,7066,0.194489554
Boston (Manchester),1610,28853,1962,2423,1221,5606,0.194295221
Salt Lake City,84341,26085,1261,2602,1196,5059,0.193942879
South Bend-Elkhart,46590,5090,311,517,157,985,0.193516699
Kansas City,64112,9697,211,773,891,1875,0.193358771
Kansas City,64105,7309,27,251,1135,1413,0.1933233
Nashville,37228,3189,62,180,374,616,0.193164001
Grand Rapids-Kalmzoo-B.Crk,49006,24701,763,2686,1319,4768,0.193028622
Salt Lake City,84058,33363,1583,2744,2109,6436,0.192908312
New York,10001,34698,1313,2261,3114,6688,0.192748862
New York,10016,59847,738,3304,7469,11511,0.192340468
Tyler-Longview(Lfkn&Ncgd),75965,19288,1470,1530,707,3707,0.192192036
Philadelphia,8028,25292,2018,2087,749,4854,0.191918393
Paducah-Cape Girard-Harsbg,62901,21996,975,2267,979,4221,0.191898527
Dallas-Ft. Worth,75251,4175,55,251,495,801,0.191856287
Charlotte,28202,18489,399,1143,2004,3546,0.191789713
Cedar Rapids-Wtrlo-IWC&Dub,52246,23753,799,2260,1496,4555,0.191765251
Gainesville,32608,56744,1846,5720,3312,10878,0.191703088
New York,11568,4335,349,382,100,831,0.191695502
Kansas City,65305,2878,80,251,220,551,0.191452397
"Columbus, OH",45810,7847,365,834,302,1501,0.191283293
"Rochester, NY",14478,884,69,77,23,169,0.191176471
Cedar Rapids-Wtrlo-IWC&Dub,52245,26420,1161,2898,988,5047,0.191029523
Anchorage,99506,6625,159,585,518,1262,0.190490566
Boston (Manchester),1608,4643,211,326,346,883,0.190178764
Ottumwa-Kirksville,63501,21671,1284,2132,701,4117,0.189977389
"Columbus, OH",43215,23866,185,1325,3024,4534,0.189977374
Springfield-Holyoke,1075,18295,1261,1797,417,3475,0.189942607
Marquette,49931,9961,610,933,346,1889,0.189639594
San Antonio,78843,480,8,44,39,91,0.189583333
Dallas-Ft. Worth,76401,32433,2194,2703,1235,6132,0.189066691
"Columbus, OH",43202,20652,292,2005,1604,3901,0.188892117
Hartford & New Haven,6511,58135,2793,4452,3727,10972,0.188733121
Charlotte,28174,8967,697,766,227,1690,0.18846883
Burlington-Plattsburgh,3756,16,0,1,2,3,0.1875
Memphis,38131,16,1,1,1,3,0.1875
Wichita Falls & Lawton,73523,278,22,23,7,52,0.18705036
Meridian,39358,1556,160,85,46,291,0.187017995
"Charleston, SC",29403,24711,662,2279,1675,4616,0.186799401
Boston (Manchester),2139,40119,1216,2546,3718,7480,0.186445325
Oklahoma City,74074,33082,1403,3327,1434,6164,0.18632489
Spokane,83843,29966,1558,2678,1342,5578,0.186144297
Dallas-Ft. Worth,75201,18166,91,786,2503,3380,0.186061874
Meridian,39309,312,10,27,21,58,0.185897436
Dallas-Ft. Worth,76205,21069,677,1901,1334,3912,0.185675637
"Portland, OR",97201,19347,430,1663,1499,3592,0.18566186
Boise,83706,34993,2110,2597,1786,6493,0.185551396
San Diego,92115,63104,1954,6822,2932,11708,0.18553499
Syracuse,13408,3402,321,220,90,631,0.18547913
Knoxville,37998,216,15,18,7,40,0.185185185
Birmingham (Ann and Tusc),36265,22230,1599,1711,805,4115,0.185110211
New York,7764,8534,835,552,191,1578,0.184907429
Bismarck-Mnt-Dcknsn(Wlstn),58705,687,31,58,38,127,0.184861718
Mobile-Pensacola (Ft Walt),32511,1411,99,105,56,260,0.184266478
Boston (Manchester),2144,26359,689,1362,2806,4857,0.184263439
Houston,77054,25709,297,1325,3113,4735,0.184176747
"Rochester, NY",14623,26781,1713,2183,1031,4927,0.183973713
Austin,78741,54247,1291,3918,4742,9951,0.183438716
Dallas-Ft. Worth,75204,37953,382,1517,5061,6960,0.183384713
Roanoke-Lynchburg,24502,49333,2956,3865,2223,9044,0.183325563
Columbus-Tupelo-West Point,39759,43935,2131,3829,2094,8054,0.183316263
Quincy-Hannibal-Keokuk,61455,16727,632,1911,517,3060,0.182937765
Waco-Temple-Bryan,76701,1772,42,168,114,324,0.182844244
Colorado Springs-Pueblo,80902,7251,180,586,559,1325,0.182733416
Detroit,48202,18188,1156,1278,888,3322,0.1826479
Chicago,60115,41727,2173,3521,1925,7619,0.182591607
St. Louis,63105,17992,1471,1186,626,3283,0.182469987
Savannah,31315,5916,154,521,404,1079,0.182386748
"Jackson, MS",39203,5161,501,310,130,941,0.182329006
Raleigh-Durham (Fayetvlle),28307,12778,285,1091,953,2329,0.182266395
"Columbus, OH",43212,25431,349,1084,3193,4626,0.181903975
Rochestr-Mason City-Austin,55905,11,0,1,1,2,0.181818182
San Diego,92152,286,20,23,9,52,0.181818182
Eugene,97401,47119,1690,4754,2104,8548,0.181413018
Philadelphia,19352,10720,426,1310,208,1944,0.181343284
Norfolk-Portsmth-Newpt Nws,23511,13109,434,1431,509,2374,0.181096956
Baltimore,21201,18711,269,1126,1991,3386,0.18096307
Kansas City,64468,14079,803,1275,469,2547,0.180907735
Flint-Saginaw-Bay City,48604,10000,845,613,350,1808,0.1808
Portland-Auburn,4988,2456,182,193,69,444,0.180781759
Tyler-Longview(Lfkn&Ncgd),75961,16568,921,1555,519,2995,0.180770159
Hattiesburg-Laurel,39401,45589,2507,3687,2044,8238,0.180701485
Charlotte,28204,9873,121,504,1157,1782,0.180492252
Salt Lake City,84321,51391,2353,4211,2708,9272,0.180420696
Toledo,43402,32351,1101,3506,1228,5835,0.180365367
Salt Lake City,84627,6244,512,431,183,1126,0.18033312
Myrtle Beach-Florence,28372,13429,674,1211,535,2420,0.180207015
Eugene,97333,24786,921,2384,1160,4465,0.180142016
Savannah,31314,3673,131,376,154,661,0.179961884
Columbus-Tupelo-West Point,39710,167,4,15,11,30,0.179640719
San Antonio,78256,14594,452,1184,985,2621,0.179594354
Atlanta,30363,3185,15,180,377,572,0.179591837
Macon,31201,9489,446,799,459,1704,0.179576352
"Jackson, MS",39202,7797,291,584,525,1400,0.17955624
Mobile-Pensacola (Ft Walt),32544,1610,49,135,105,289,0.179503106
Seattle-Tacoma,98122,43669,1155,2443,4239,7837,0.179463693
Cleveland-Akron (Canton),44240,38869,1649,3679,1634,6962,0.179114461
Huntsville-Decatur (Flor),35816,14926,647,1243,783,2673,0.179083478
New York,10027,62057,2420,4988,3705,11113,0.1790773
Meridian,35470,5218,314,463,157,934,0.178995784
Charlotte,28203,20660,258,680,2757,3695,0.178848015
Savannah,31421,28,0,3,2,5,0.178571429
Boston (Manchester),1609,23982,1306,2089,884,4279,0.178425486
Chicago,60614,71580,1915,3046,7809,12770,0.178401788
Seattle-Tacoma,98314,1609,59,191,37,287,0.178371659
Denver,82070,20959,1206,1568,958,3732,0.17806193
Fairbanks,99702,2533,68,214,169,451,0.178049743
Albany-Schenectady-Troy,5257,3054,177,294,72,543,0.177799607
Boise,83648,3327,54,300,237,591,0.177637511
Memphis,38152,175,6,18,7,31,0.177142857
Greenville-N.Bern-Washngtn,27858,53210,3345,3943,2136,9424,0.177109566
Minneapolis-St. Paul,55402,706,2,29,94,125,0.177053824
Fargo,58203,16369,910,1289,694,2893,0.176736514
Cleveland-Akron (Canton),44311,7540,327,719,286,1332,0.176657825
Baton Rouge,70802,23923,1313,1798,1113,4224,0.176566484
Huntsville-Decatur (Flor),35898,17,2,1,0,3,0.176470588
Minneapolis-St. Paul,55408,35849,644,1823,3852,6319,0.17626712
Cleveland-Akron (Canton),44074,11807,418,1406,255,2079,0.176081985
Tampa-St. Pete (Sarasota),33613,38364,1453,3118,2176,6747,0.175868001
"Jackson, MS",39079,1911,191,104,41,336,0.175824176
Little Rock-Pine Bluff,71923,15484,1048,1120,552,2720,0.175665203
Buffalo,14063,12557,970,771,459,2200,0.175201083
New York,10012,22451,372,1260,2300,3932,0.175136965
La Crosse-Eau Claire,54601,50746,1560,5558,1765,8883,0.17504828
"Washington, DC (Hagrstwn)",20001,49666,765,3137,4791,8693,0.175029195
Dayton,45433,1497,77,100,85,262,0.1750167
Nashville,37204,14857,403,785,1405,2593,0.174530524
Sioux Falls(Mitchell),57006,26615,1652,2175,818,4645,0.174525643
Nashville,37208,21626,722,1361,1690,3773,0.174465921
Denver,80246,13321,176,735,1411,2322,0.174311238
Augusta-Aiken,30905,8390,433,705,324,1462,0.174255066
Denver,82072,15760,571,1475,696,2742,0.173984772
Eugene,97361,14122,667,1206,584,2457,0.173983855
Boston (Manchester),2114,15655,121,581,2021,2723,0.173938039
Tallahassee-Thomasville,32310,18101,1187,1405,555,3147,0.173857798
Raleigh-Durham (Fayetvlle),27606,51584,1479,4143,3338,8960,0.17369727
Burlington-Plattsburgh,5753,11154,729,994,214,1937,0.173659674
Kansas City,64111,18422,198,1085,1916,3199,0.173651069
Orlando-Daytona Bch-Melbrn,32821,31122,744,2250,2410,5404,0.173639226
Indianapolis,46208,23000,1404,1809,780,3993,0.173608696
Spokane,99004,23865,1028,2339,767,4134,0.173224387
Chico-Redding,95926,40262,2261,3126,1574,6961,0.172892554
Albuquerque-Santa Fe,87106,26390,1169,1960,1430,4559,0.172754831
Cleveland-Akron (Canton),44114,7874,129,604,627,1360,0.172720345
Omaha,68113,1031,29,86,63,178,0.172647915
Greenvll-Spart-Ashevll-And,29630,16545,594,1636,623,2853,0.172438803
Salt Lake City,84059,19522,478,1365,1519,3362,0.172215961
Duluth-Superior,55805,9387,228,858,530,1616,0.172152978
San Antonio,78249,59510,2833,4339,3072,10244,0.172139136
"Lafayette, IN",47901,3878,76,233,358,667,0.171995874
Phoenix (Prescott),85004,10333,372,728,676,1776,0.171876512
Hartford & New Haven,6226,17844,1049,1283,730,3062,0.171598296
Philadelphia,19711,50238,1987,4577,2052,8616,0.171503643
"Washington, DC (Hagrstwn)",22209,19564,161,707,2484,3352,0.171335105
Lansing,49283,4474,279,401,86,766,0.171211444
Des Moines-Ames,50311,15380,890,1153,590,2633,0.171196359
Paducah-Cape Girard-Harsbg,38237,15559,948,1159,552,2659,0.170897873
Chicago,60657,73177,632,2435,9436,12503,0.170859696
Norfolk-Portsmth-Newpt Nws,23460,1142,76,109,10,195,0.170753065
San Francisco-Oak-San Jose,94508,3023,169,254,93,516,0.170691366
Spokane,99202,23055,1594,1454,884,3932,0.170548688
La Crosse-Eau Claire,55987,33658,2076,2612,1049,5737,0.170449819
Elmira (Corning),16933,6889,481,476,216,1173,0.170271447
Richmond-Petersburg,23801,9648,689,555,397,1641,0.170087065
Los Angeles,93042,618,19,49,37,105,0.169902913
Wichita Falls & Lawton,73503,11647,741,722,515,1978,0.169829141
Buffalo,14213,27730,1531,1785,1390,4706,0.169707898
Watertown,13676,13774,899,1057,381,2337,0.169667489
Syracuse,13214,8458,687,515,233,1435,0.169661859
Salt Lake City,84101,11217,154,731,1018,1903,0.169653205
Atlanta,30312,27834,976,1592,2153,4721,0.169612704
Traverse City-Cadillac,49307,16735,802,1519,515,2836,0.169465193
Minneapolis-St. Paul,55057,26498,1494,2463,533,4490,0.169446751
Tulsa,74104,12809,643,983,543,2169,0.169334062
Bismarck-Mnt-Dcknsn(Wlstn),58704,4341,117,341,277,735,0.169315826
Atlanta,30329,30373,655,1768,2716,5139,0.169196326
Mankato,56001,52209,2515,4273,2042,8830,0.169127928
Binghamton,13753,5633,477,369,105,951,0.168826558
Dallas-Ft. Worth,75205,27940,959,2435,1322,4716,0.168790265
Spokane,99011,3034,70,202,240,512,0.16875412
Charlotte,28262,55209,1759,3791,3764,9314,0.168704378
Oklahoma City,73096,14358,750,1114,557,2421,0.168616799
Tallahassee-Thomasville,31699,671,31,73,9,113,0.168405365
San Diego,92122,44979,826,3707,3038,7571,0.168322995
Albany-Schenectady-Troy,12208,21350,695,1606,1291,3592,0.16824356
San Antonio,78235,2235,57,101,218,376,0.168232662
"Washington, DC (Hagrstwn)",20016,33815,1822,2461,1405,5688,0.168209375
Toledo,43606,25994,1816,1642,914,4372,0.16819266
Philadelphia,19103,29515,322,1379,3261,4962,0.168117906
Cincinnati,45209,9877,70,351,1239,1660,0.168067227
Lincoln & Hastings-Krny,68503,15439,515,1216,863,2594,0.168016063
New York,10010,30385,798,1796,2503,5097,0.167747244
Salt Lake City,84720,27264,1576,2155,842,4573,0.16773034
Greensboro-H.Point-W.Salem,27101,25048,1310,1615,1274,4199,0.167638135
Tallahassee-Thomasville,32301,30246,1131,2099,1840,5070,0.167625471
Philadelphia,19010,21392,1324,1666,594,3584,0.167539267
Los Angeles,92831,38764,1854,2434,2206,6494,0.167526571
Tucson (Sierra Vista),85708,2808,62,203,205,470,0.167378917
New York,6901,12937,401,763,999,2163,0.167194867
New Orleans,70125,16845,1150,873,793,2816,0.167171267
Des Moines-Ames,50140,2507,173,174,72,419,0.16713203
Dallas-Ft. Worth,76209,28876,1618,1732,1463,4813,0.16667821
Waco-Temple-Bryan,77845,81606,3959,6522,3117,13598,0.166629905
Raleigh-Durham (Fayetvlle),27531,643,48,57,2,107,0.166407465
Nashville,37209,47322,1187,2537,4148,7872,0.166349689
Hartford & New Haven,6515,18367,1328,1038,688,3054,0.166276474
Greenville-N.Bern-Washngtn,28544,3989,130,272,261,663,0.166207069
Wilkes Barre-Scranton-Hztn,17815,29630,1955,2214,755,4924,0.166182923
Norfolk-Portsmth-Newpt Nws,23504,22242,1464,1423,807,3694,0.166082187
Detroit,48105,41071,1229,3352,2237,6818,0.16600521
Sacramnto-Stkton-Modesto,94535,3996,112,306,245,663,0.165915916
New York,10996,7285,637,514,56,1207,0.16568291
Philadelphia,19129,12241,669,639,718,2026,0.165509354
Los Angeles,92612,33427,1006,2975,1551,5532,0.165494959
Yakima-Pasco-Rchlnd-Knnwck,98926,35763,1636,2951,1328,5915,0.165394402
Raleigh-Durham (Fayetvlle),27510,14475,327,827,1240,2394,0.165388601
Norfolk-Portsmth-Newpt Nws,23708,121,4,6,10,20,0.165289256
"Columbus, GA (Opelika, AL)",36830,52451,1744,4602,2321,8667,0.165239938
Denver,80203,24920,95,900,3113,4108,0.164847512
New York,10976,2524,223,159,34,416,0.16481775
Champaign&Sprngfld-Decatur,61920,20223,781,1778,773,3332,0.164762894
Los Angeles,92507,64014,2353,4622,3568,10543,0.164698347
Tampa-St. Pete (Sarasota),33801,40808,1738,3554,1422,6714,0.164526563
Corpus Christi,78419,225,2,18,17,37,0.164444444
Albany-Schenectady-Troy,1267,7833,517,638,133,1288,0.164432529
Raleigh-Durham (Fayetvlle),28308,524,17,44,25,86,0.164122137
Little Rock-Pine Bluff,72099,774,43,68,16,127,0.164082687
Norfolk-Portsmth-Newpt Nws,23517,5486,79,289,532,900,0.164053956
Chicago,60602,1982,29,117,179,325,0.163975782
Chicago,60606,2898,10,132,333,475,0.163906142
Lincoln & Hastings-Krny,68504,18294,646,1260,1092,2998,0.163878867
Kansas City,66046,21451,838,1857,817,3512,0.163721971
Monroe-El Dorado,71270,33973,1741,2436,1384,5561,0.163688812
Montgomery-Selma,36114,782,9,43,76,128,0.163682864
Denver,80216,18428,589,1084,1340,3013,0.163501194
Norfolk-Portsmth-Newpt Nws,23551,349,8,22,27,57,0.163323782
Boston (Manchester),2142,4985,35,275,504,814,0.16328987
Erie,16507,8914,549,548,358,1455,0.163226385
Topeka,66442,15770,408,1260,906,2574,0.163221306
"Washington, DC (Hagrstwn)",22401,28825,1394,2039,1264,4697,0.162948829
Birmingham (Ann and Tusc),35404,22362,727,2072,844,3643,0.162910294
Burlington-Plattsburgh,5656,3629,199,245,146,590,0.162579223
Abilene-Sweetwater,79601,26892,1597,1953,821,4371,0.162539045
Denver,69337,6287,373,412,236,1021,0.1623986
Watertown,13637,5348,162,416,290,868,0.162303665
Reno,89512,31795,1624,2028,1507,5159,0.162258217
"Washington, DC (Hagrstwn)",22201,40005,476,1381,4633,6490,0.162229721
Lubbock,79415,18555,664,1593,752,3009,0.162166532
Grand Rapids-Kalmzoo-B.Crk,49503,40793,975,2231,3409,6615,0.162160175
Waco-Temple-Bryan,76544,29051,911,2162,1634,4707,0.162025404
Montgomery-Selma,36106,16927,1307,720,714,2741,0.161930643
Madison,53818,15348,771,1286,428,2485,0.161910347
New York,10038,31063,1124,1689,2216,5029,0.16189679
Dallas-Ft. Worth,75206,41845,371,1773,4622,6766,0.161691958
Butte-Bozeman,59715,40901,2221,2897,1494,6612,0.161658639
Little Rock-Pine Bluff,72801,18867,1018,1237,795,3050,0.161657921
Kansas City,64093,28310,1430,2047,1096,4573,0.161533027
Amarillo,73939,1672,102,103,65,270,0.161483254
Little Rock-Pine Bluff,72034,51703,2705,3241,2396,8342,0.161344603
"Alexandria, LA",71459,9597,245,763,540,1548,0.161300406
New York,10018,10125,137,461,1033,1631,0.16108642
Green Bay-Appleton,54901,35498,1001,3491,1226,5718,0.161079497
Boston (Manchester),2116,22582,829,1312,1494,3635,0.160968913
Utica,12043,7742,237,818,191,1246,0.160940325
Wichita-Hutchinson Plus,67221,460,15,31,28,74,0.160869565
Burlington-Plattsburgh,5735,4125,260,291,112,663,0.160727273
New York,10009,60753,896,3200,5668,9764,0.160716343
Chicago,60607,34299,1182,1997,2333,5512,0.160704394
Wausau-Rhinelander,54481,27868,939,2401,1135,4475,0.160578441
Philadelphia,8215,16372,1117,1118,391,2626,0.160395798
Atlanta,30308,23770,208,950,2654,3812,0.160370215
Lubbock,79410,8773,216,759,431,1406,0.160264448
Phoenix (Prescott),85034,7971,172,456,649,1277,0.160205746
Salt Lake City,84753,25,2,1,1,4,0.16
New Orleans,70401,21919,1118,1334,1054,3506,0.159952553
Philadelphia,18015,34792,2109,2259,1192,5560,0.159806852
Memphis,38655,47865,1793,3469,2385,7647,0.15976183
Minneapolis-St. Paul,54022,24104,1422,1748,675,3845,0.159517093
Cleveland-Akron (Canton),44308,1022,67,70,26,163,0.159491194
"Rochester, NY",14445,8042,543,511,226,1280,0.159164387
Nashville,37130,65097,2995,4260,3103,10358,0.159116396
Rapid City,57706,2546,96,174,135,405,0.159073056
Colorado Springs-Pueblo,80903,16397,623,1153,831,2607,0.158992499
Minneapolis-St. Paul,56082,14463,920,1027,350,2297,0.158819056
"Tri-Cities, TN-VA",37604,42911,2118,2840,1848,6806,0.15860735
Albany-Schenectady-Troy,12308,15807,905,970,632,2507,0.15860062
Louisville,47243,6129,353,451,168,972,0.158590308
Syracuse,13202,6931,213,339,546,1098,0.158418699
Fargo,58205,202,5,15,12,32,0.158415842
Great Falls,59402,442,10,37,23,70,0.158371041
Boston (Manchester),2141,16611,196,720,1712,2628,0.158208416
Baltimore,21218,43491,2024,2558,2290,6872,0.158009703
"Charleston, SC",29404,2279,56,159,145,360,0.157964019
Oklahoma City,73145,2147,76,172,91,339,0.157894737
Denver,80631,52930,2735,3599,2021,8355,0.157849991
Milwaukee,53097,7186,529,494,110,1133,0.157667687
Montgomery-Selma,36115,222,2,12,21,35,0.157657658
San Diego,92136,7733,237,698,284,1219,0.157636105
Atlanta,30318,69519,2061,4243,4647,10951,0.157525281
"Rochester, NY",14420,20350,1177,1268,754,3199,0.157199017
Dallas-Ft. Worth,75236,16531,932,1041,625,2598,0.157159277
Watertown,13603,10830,259,807,635,1701,0.157063712
Boston (Manchester),2446,32566,616,2058,2438,5112,0.156973531
Fresno-Visalia,93710,30577,1139,2244,1412,4795,0.156817216
Nashville,42262,8825,232,552,599,1383,0.156713881
Kansas City,64147,332,14,15,23,52,0.156626506
Kansas City,64110,14707,593,1004,706,2303,0.156592099
Hartford & New Haven,6112,23080,1565,1368,678,3611,0.156455806
"Columbia, SC",29152,1868,33,128,131,292,0.156316916
Los Angeles,91711,38099,2309,2748,896,5953,0.15625082
Bowling Green,42101,68107,3640,4527,2466,10633,0.156121985
Anchorage,99505,4580,115,313,287,715,0.156113537
Richmond-Petersburg,23901,16954,1582,600,464,2646,0.156069364
Reno,89503,30621,1197,1907,1675,4779,0.156069364
Minneapolis-St. Paul,55104,49287,2098,3026,2565,7689,0.156004626
Providence-New Bedford,2908,42577,2109,2788,1744,6641,0.155976231
Providence-New Bedford,2841,1257,69,66,61,196,0.15592681
Denver,80202,21717,148,763,2474,3385,0.155868674
Chattanooga,37408,3845,96,205,298,599,0.155786736
Huntsville-Decatur (Flor),35630,34824,1714,2156,1553,5423,0.155725936
San Antonio,78257,13448,334,797,963,2094,0.155710886
Boston (Manchester),2452,15013,742,1111,484,2337,0.15566509
Chicago,60610,46202,552,2299,4341,7192,0.155664257
Grand Rapids-Kalmzoo-B.Crk,49007,11546,318,780,699,1797,0.155638316
Norfolk-Portsmth-Newpt Nws,23459,1170,42,96,44,182,0.155555556
Wichita-Hutchinson Plus,67601,24436,1277,1732,788,3797,0.155385497
Nashville,42223,21140,521,1589,1171,3281,0.155203406
Evansville,47712,24788,1433,1648,765,3846,0.155155721
Honolulu,96853,490,6,29,41,76,0.155102041
Eugene,97330,44578,1358,3810,1746,6914,0.155098928
"Rochester, NY",14620,25509,725,1480,1749,3954,0.155004116
Salt Lake City,84601,34787,1115,2347,1930,5392,0.155000431
Minneapolis-St. Paul,55403,18259,142,750,1938,2830,0.154992059
Wichita Falls & Lawton,76308,21325,947,1391,963,3301,0.154794842
Cheyenne-Scottsbluff,82005,1622,56,121,74,251,0.154747226
Boston (Manchester),2466,7656,443,577,163,1183,0.154519331
Boston (Manchester),2109,3619,80,113,366,559,0.154462559
San Antonio,78243,240,11,16,10,37,0.154166667
Cedar Rapids-Wtrlo-IWC&Dub,52142,1729,155,57,54,266,0.153846154
Indianapolis,47304,32343,1582,2257,1136,4975,0.153819992
Atlanta,30324,30675,440,1377,2901,4718,0.153806031
Grand Junction-Montrose,81501,24509,1275,1390,1097,3762,0.153494635
Albany-Schenectady-Troy,12211,13552,888,955,236,2079,0.153409091
Tallahassee-Thomasville,31602,37073,2115,2037,1534,5686,0.153373075
Baton Rouge,70808,32047,1217,2122,1576,4915,0.15336849
Atlanta,30309,32152,320,1296,3312,4928,0.153271958
Norfolk-Portsmth-Newpt Nws,27855,5553,332,407,112,851,0.153250495
Chicago,60201,41346,1730,2920,1685,6335,0.153219175
Atlanta,30606,49834,1541,3667,2426,7634,0.153188586
Fargo,58102,33150,1164,2747,1166,5077,0.153152338
Seattle-Tacoma,98433,20164,475,1447,1164,3086,0.153045031
Knoxville,37902,2608,31,182,186,399,0.152990798
Indianapolis,47401,41358,1501,3011,1815,6327,0.152981285
Abilene-Sweetwater,79607,2900,83,175,185,443,0.152758621
San Antonio,78215,4493,44,255,387,686,0.15268195
Quincy-Hannibal-Keokuk,63435,4279,243,302,108,653,0.152605749
"Washington, DC (Hagrstwn)",20005,12836,70,364,1521,1955,0.152306014
Atlanta,30117,40655,2207,2602,1383,6192,0.152305989
Oklahoma City,73106,15129,507,929,868,2304,0.152290303
Santabarbra-Sanmar-Sanluob,93437,3441,94,209,221,524,0.152281314
Pittsburgh,15701,31871,1850,1888,1111,4849,0.152144583
Baltimore,21231,16635,261,661,1608,2530,0.152088969
Dallas-Ft. Worth,75080,54868,3613,2915,1813,8341,0.152019392
Dothan,36362,4502,62,230,392,684,0.151932474
Springfield-Holyoke,1109,31348,1682,2016,1064,4762,0.151907618
Chicago,60605,35435,902,1667,2813,5382,0.151883731
Corpus Christi,78412,40761,1780,2525,1882,6187,0.151787248
Portland-Auburn,4938,10295,704,516,342,1562,0.151724138
Chicago,60613,51724,549,2087,5204,7840,0.151573738
Albany-Schenectady-Troy,12305,7030,166,512,387,1065,0.151493599
Paducah-Cape Girard-Harsbg,42071,29833,1567,1990,959,4516,0.151375993
Chattanooga,30750,3964,219,301,80,600,0.15136226
Fairbanks,99703,8141,173,575,484,1232,0.15133276
New York,10004,4238,51,169,421,641,0.15125059
Kansas City,64108,11427,198,600,929,1727,0.151133281
Pittsburgh,15224,9971,147,451,908,1506,0.15103801
Atlanta,30346,5426,74,239,506,819,0.150939919
Lexington,40502,30555,1863,1518,1230,4611,0.150908198
Joplin-Pittsburg,66762,25234,1122,1784,902,3808,0.150907506
St. Louis,63112,18804,452,1021,1364,2837,0.150872155
Syracuse,13026,1578,94,117,27,238,0.150823828
Lexington,40351,22008,1299,1382,632,3313,0.150536169
"Columbus, OH",43762,5430,299,363,155,817,0.150460405
Meridian,39327,4408,371,191,101,663,0.150408348
Minneapolis-St. Paul,55415,6777,111,302,605,1018,0.150213959
Raleigh-Durham (Fayetvlle),27706,20,1,1,1,3,0.15
Mobile-Pensacola (Ft Walt),32542,4298,122,255,267,644,0.149837134
Orlando-Daytona Bch-Melbrn,32114,37431,1752,2341,1515,5608,0.14982234
San Diego,92055,19303,408,1722,758,2888,0.14961405
"Washington, DC (Hagrstwn)",22203,29038,395,1019,2929,4343,0.149562642
Columbia-Jefferson City,65248,4982,306,291,148,745,0.149538338
"Portland, OR",97203,34017,1577,1850,1659,5086,0.149513479
New York,11237,45534,962,2068,3774,6804,0.149426802
Lubbock,79416,37458,1260,2142,2194,5596,0.149393988
Seattle-Tacoma,98119,28017,778,1294,2110,4182,0.149266517
Missoula,59801,31525,939,2014,1752,4705,0.14924663
Dallas-Ft. Worth,76013,35956,1592,2428,1346,5366,0.149237958
St. Louis,63110,18845,450,936,1426,2812,0.149217299
Oklahoma City,73069,28259,862,2130,1224,4216,0.149191408
"Springfield, MO",65807,60561,2082,4138,2809,9029,0.149089348
Youngstown,44510,1908,140,96,48,284,0.14884696
Oklahoma City,73131,6232,126,327,474,927,0.148748395
Los Angeles,90015,30803,582,1538,2459,4579,0.148654352
Los Angeles,92310,7885,195,532,445,1172,0.148636652
Honolulu,96860,3944,75,262,249,586,0.148580122
Boston (Manchester),2453,31613,1262,1865,1566,4693,0.148451586
Kansas City,64106,11378,205,510,974,1689,0.148444366
Minneapolis-St. Paul,56267,6624,363,407,213,983,0.148399758
Atlanta,30533,29578,1683,1903,800,4386,0.148285888
San Francisco-Oak-San Jose,95112,61626,2838,3014,3277,9129,0.148135527
Mobile-Pensacola (Ft Walt),32503,33862,1542,2274,1196,5012,0.148012521
Bluefield-Beckley-Oak Hill,24712,1975,101,137,54,292,0.147848101
Minneapolis-St. Paul,54751,26464,1228,1818,865,3911,0.147785671
Kansas City,64109,10967,238,552,830,1620,0.147715875
Minneapolis-St. Paul,55404,29887,911,1657,1842,4410,0.147555793
Syracuse,13045,27899,2122,1174,818,4114,0.147460482
Spokane,99204,7297,125,422,529,1076,0.147457859
Springfield-Holyoke,1375,3717,86,199,263,548,0.147430724
San Antonio,78229,31089,680,1573,2322,4575,0.147158159
Dallas-Ft. Worth,75226,4798,38,178,490,706,0.147144644
"Washington, DC (Hagrstwn)",22134,7763,157,573,412,1142,0.147108077
Cedar Rapids-Wtrlo-IWC&Dub,52314,6078,333,449,112,894,0.147087858
Harrisonburg,22812,9750,557,681,196,1434,0.147076923
Jacksonville,32224,42296,1730,2666,1819,6215,0.146940609
Dallas-Ft. Worth,75219,28109,236,917,2969,4122,0.146643424
Norfolk-Portsmth-Newpt Nws,23510,8547,141,318,794,1253,0.146601147
Wilkes Barre-Scranton-Hztn,17837,19267,1122,1369,333,2824,0.146571859
Oklahoma City,73134,7124,145,296,603,1044,0.146546884
Atlanta,30144,54518,1976,3349,2664,7989,0.146538758
"Jackson, MS",39201,724,8,26,72,106,0.14640884
Detroit,48201,15307,337,866,1037,2240,0.146338277
Sacramnto-Stkton-Modesto,95618,27532,929,1828,1266,4023,0.146120878
Philadelphia,8641,4353,136,253,247,636,0.146106134
Fargo,58204,1691,37,109,101,247,0.146067416
New York,7102,14290,933,532,620,2085,0.145906228
Shreveport,71110,1954,67,135,83,285,0.145854657
Tulsa,74469,2388,192,104,52,348,0.145728643
"Washington, DC (Hagrstwn)",20009,51746,417,1644,5472,7533,0.14557647
San Francisco-Oak-San Jose,94129,3410,74,185,237,496,0.145454545
Boston (Manchester),2127,37618,405,838,4227,5470,0.145409113
Atlanta,30339,35687,474,1614,3101,5189,0.145403088
Philadelphia,19382,58602,3430,3074,2014,8518,0.145353401
Baltimore,21010,172,16,8,1,25,0.145348837
St. Louis,62028,1026,58,72,19,149,0.145224172
Minneapolis-St. Paul,54701,42851,2606,2242,1364,6212,0.144967445
Buffalo,14228,23889,839,1719,904,3462,0.144920256
Greenvll-Spart-Ashevll-And,29303,28132,1399,1665,1011,4075,0.144852837
Roanoke-Lynchburg,24501,26842,1151,1583,1150,3884,0.144698607
San Diego,92121,4515,71,404,178,653,0.144629014
Lubbock,79407,25382,739,1542,1389,3670,0.144590655
"Columbia, SC",29115,28042,1543,1779,732,4054,0.144568861
New York,11221,84837,1793,3595,6872,12260,0.144512418
Boston (Manchester),2356,14857,878,990,279,2147,0.144511005
Syracuse,13126,35605,1987,2128,1027,5142,0.144417919
New York,12759,1863,73,138,58,269,0.144390768
Philadelphia,19041,6486,347,491,98,936,0.144310823
Chicago,60615,42985,955,2286,2962,6203,0.144306153
Minneapolis-St. Paul,56301,35205,1436,2228,1414,5078,0.144240875
Detroit,48197,68095,2521,3840,3460,9821,0.14422498
New York,11205,53046,2097,2690,2859,7646,0.144139049
Minneapolis-St. Paul,55405,15376,316,661,1238,2215,0.144055671
Nashville,37376,368,16,29,8,53,0.144021739
Fargo,58257,2160,104,144,63,311,0.143981481
Kansas City,66103,13283,298,719,895,1912,0.143943386
Sioux City,51041,7415,406,460,201,1067,0.143897505
Austin,78704,49188,1105,2117,3856,7078,0.143896885
Knoxville,37915,6020,161,403,302,866,0.143853821
Salt Lake City,84056,4040,104,241,236,581,0.143811881
Hartford & New Haven,6103,3478,17,130,353,500,0.143760782
Tampa-St. Pete (Sarasota),33602,23659,406,1197,1798,3401,0.143750793
Minneapolis-St. Paul,55108,15483,331,739,1155,2225,0.143706
Philadelphia,19123,20941,316,784,1908,3008,0.14364166
"Washington, DC (Hagrstwn)",20017,19221,604,1308,848,2760,0.143592945
Denver,80210,38273,1275,2173,2045,5493,0.143521543
Mobile-Pensacola (Ft Walt),32508,5653,168,440,203,811,0.143463648
Erie,16501,2607,60,215,99,374,0.143459916
Wichita-Hutchinson Plus,67202,2532,20,129,214,363,0.143364929
Houston,77010,1158,2,56,108,166,0.143350604
Boston (Manchester),2125,33648,840,1649,2334,4823,0.1433369
Boston (Manchester),3257,4322,272,281,66,619,0.143220731
Charlotte,28213,54187,2432,3212,2116,7760,0.14320778
Boston (Manchester),1854,29318,1072,2066,1060,4198,0.143188485
Hartford & New Haven,6320,27569,1198,1719,1029,3946,0.143131778
Philadelphia,19130,31664,300,1147,3082,4529,0.143033098
New York,11206,92081,2630,4372,6166,13168,0.143004529
"Washington, DC (Hagrstwn)",20071,7,0,0,1,1,0.142857143
"Washington, DC (Hagrstwn)",20530,7,0,0,1,1,0.142857143
Baton Rouge,70801,350,2,15,33,50,0.142857143
Corpus Christi,78360,21,1,1,1,3,0.142857143
Cincinnati,45202,19126,255,935,1542,2732,0.142842204
Albuquerque-Santa Fe,87116,3807,83,213,247,543,0.142631994
Los Angeles,93043,498,9,31,31,71,0.142570281
Chicago,60637,51638,2624,2555,2178,7357,0.142472598
New York,7079,18378,1200,991,427,2618,0.142452933
Amarillo,79015,23864,977,1479,943,3399,0.142432115
Raleigh-Durham (Fayetvlle),27701,29047,1124,1419,1594,4137,0.142424347
Atlanta,30310,28797,1418,1495,1187,4100,0.142375942
Wilkes Barre-Scranton-Hztn,17870,14838,835,973,304,2112,0.142337242
Cincinnati,41076,17290,769,1043,647,2459,0.142220937
Oklahoma City,73071,43378,1248,3044,1869,6161,0.142030522
Philadelphia,19902,148,6,13,2,21,0.141891892
Topeka,66801,27034,1286,1532,1014,3832,0.141747429
Little Rock-Pine Bluff,72202,9941,346,463,600,1409,0.141736244
"Portland, OR",97205,9567,100,472,783,1355,0.141632696
Tampa-St. Pete (Sarasota),33617,49795,1757,2963,2330,7050,0.14158048
Austin,78701,16276,259,984,1059,2302,0.141435242
"Washington, DC (Hagrstwn)",22202,31096,273,1155,2969,4397,0.141400823
New York,6824,35249,2396,1939,648,4983,0.141365713
Davenport-R.Island-Moline,52801,1946,19,130,126,275,0.141315519
Indianapolis,46953,22287,1099,1458,591,3148,0.141248261
Des Moines-Ames,50010,31862,796,2261,1443,4500,0.141234072
Tulsa,74136,32989,1271,1956,1431,4658,0.141198581
Ft. Smith-Fay-Sprngdl-Rgrs,72703,36140,958,2154,1987,5099,0.141090205
Nashville,38501,43907,1435,2840,1918,6193,0.141048124
Shreveport,75670,17024,858,1026,516,2400,0.140977444
Salt Lake City,84111,13219,227,729,906,1862,0.140857856
Dallas-Ft. Worth,76127,568,5,33,42,80,0.14084507
Topeka,66002,13086,692,826,325,1843,0.140837536
Tampa-St. Pete (Sarasota),33612,52203,2716,2781,1854,7351,0.140815662
Philadelphia,19081,10840,580,727,219,1526,0.140774908
Minneapolis-St. Paul,55105,25752,993,1565,1066,3624,0.140726934
Los Angeles,90045,42076,1719,2117,2081,5917,0.140626485
Los Angeles,91768,34389,2018,1569,1249,4836,0.140626363
Lexington,40390,7643,375,490,209,1074,0.140520738
Sioux City,68071,1872,93,97,73,263,0.140491453
Salt Lake City,84103,23957,452,1203,1710,3365,0.140459991
Buffalo,14214,20350,863,1104,891,2858,0.14044226
Norfolk-Portsmth-Newpt Nws,23507,6731,93,303,549,945,0.140395186
Boston (Manchester),3461,6554,396,352,171,919,0.140219713
Paducah-Cape Girard-Harsbg,63701,39907,1393,2757,1443,5593,0.140150851
New York,10570,14171,838,861,285,1984,0.140004234
Youngstown,44504,4573,300,219,121,640,0.139951892
El Paso (Las Cruces),79918,1945,81,98,93,272,0.139845758
Lexington,40504,25515,774,1839,954,3567,0.139800118
Oklahoma City,73072,48625,1883,3389,1525,6797,0.139784062
Tucson (Sierra Vista),85613,4329,106,238,261,605,0.13975514
Billings,59025,136,7,7,5,19,0.139705882
Pittsburgh,16142,6244,348,410,114,872,0.139654068
New York,7310,19138,134,599,1939,2672,0.139617515
Raleigh-Durham (Fayetvlle),27516,47752,1998,3317,1349,6664,0.139554364
Phoenix (Prescott),86434,774,48,29,31,108,0.139534884
Atlanta,30326,10490,71,488,904,1463,0.139466158
Augusta-Aiken,29042,4475,245,279,100,624,0.139441341
Chicago,60660,41153,1327,2125,2285,5737,0.139406605
Dallas-Ft. Worth,75235,20826,416,824,1663,2903,0.139393066
Atlanta,30314,19897,968,1081,724,2773,0.139367744
Greensboro-H.Point-W.Salem,27106,54235,2418,3172,1955,7545,0.139116806
Kansas City,64102,266,2,9,26,37,0.139097744
"Washington, DC (Hagrstwn)",20010,32066,463,1184,2812,4459,0.139056945
Miami-Ft. Lauderdale,33039,374,19,18,15,52,0.139037433
Seattle-Tacoma,98402,6387,90,305,493,888,0.13903241
Tampa-St. Pete (Sarasota),33716,20022,293,768,1720,2781,0.138897213
Seattle-Tacoma,98109,36682,272,1259,3564,5095,0.138896461
"Washington, DC (Hagrstwn)",20002,75765,1084,2959,6480,10523,0.138889989
Phoenix (Prescott),85282,55710,1246,2856,3633,7735,0.138844014
"Columbia, SC",29205,24043,778,1203,1357,3338,0.138834588
Lincoln & Hastings-Krny,68845,20646,879,1188,798,2865,0.1387678
Buffalo,14222,13133,173,601,1048,1822,0.138734486
Omaha,68106,22768,650,1272,1235,3157,0.138659522
Kansas City,64101,577,4,20,56,80,0.13864818
Colorado Springs-Pueblo,80913,10521,402,773,283,1458,0.138579983
Dallas-Ft. Worth,76011,25545,677,1234,1629,3540,0.138578978
St. Louis,62025,35900,1418,2449,1106,4973,0.138523677
Dallas-Ft. Worth,75001,16975,234,731,1386,2351,0.138497791
Dallas-Ft. Worth,75202,3488,27,173,283,483,0.138474771
St. Louis,62254,6402,239,447,200,886,0.138394252
New York,12601,45518,2314,2477,1506,6297,0.138340876
Austin,78722,6854,102,232,614,948,0.138313394
Sioux Falls(Mitchell),57341,217,12,11,7,30,0.138248848
Los Angeles,90028,34676,657,1592,2539,4788,0.13807821
Providence-New Bedford,2905,26499,1457,1170,1031,3658,0.138042945
Birmingham (Ann and Tusc),35209,27795,866,1497,1472,3835,0.137974456
Los Angeles,93524,116,3,5,8,16,0.137931034
Chattanooga,37402,5010,90,293,308,691,0.137924152
Amarillo,88130,17745,829,887,731,2447,0.137897999
Lansing,49076,4333,232,257,108,597,0.137779829
San Diego,92108,26615,261,1144,2262,3667,0.137779448
Richmond-Petersburg,23221,14778,178,405,1453,2036,0.137772364
Harlingen-Wslco-Brnsvl-Mca,78541,51613,2231,2551,2328,7110,0.137755992
St. Joseph,66035,1256,107,49,17,173,0.137738854
New York,8854,61762,2914,3556,2034,8504,0.137689842
Dallas-Ft. Worth,75247,879,15,35,71,121,0.137656428
Dayton,45324,40987,1450,2346,1844,5640,0.137604606
New York,7932,13351,601,910,326,1837,0.13759269
Wheeling-Steubenville,43952,17567,1129,774,514,2417,0.137587522
"Albany, GA",31704,189,4,13,9,26,0.137566138
Minneapolis-St. Paul,55413,14902,168,736,1144,2048,0.137431217
Shreveport,71753,15328,806,808,492,2106,0.137395616
Greensboro-H.Point-W.Salem,27262,24482,1234,1521,607,3362,0.137325382
Boston (Manchester),3101,3908,62,187,287,536,0.137154555
Lincoln & Hastings-Krny,68528,6490,186,251,453,890,0.137134052
Houston,77030,10881,188,467,836,1491,0.137027847
Billings,59016,1643,83,83,59,225,0.136944614
Ft. Smith-Fay-Sprngdl-Rgrs,72704,33184,848,1755,1940,4543,0.136903327
Baltimore,21202,21781,324,834,1821,2979,0.13677058
Raleigh-Durham (Fayetvlle),28301,17669,868,986,562,2416,0.136736657
Norfolk-Portsmth-Newpt Nws,23505,28562,685,1492,1727,3904,0.136685106
Birmingham (Ann and Tusc),35115,17553,804,981,613,2398,0.136614824
Tulsa,74103,1480,9,75,118,202,0.136486486
Denver,80218,18876,166,627,1783,2576,0.136469591
Atlanta,30336,2272,50,142,118,310,0.136443662
Houston,77046,843,6,39,70,115,0.136417556
Raleigh-Durham (Fayetvlle),27601,10461,224,567,636,1427,0.136411433
El Paso (Las Cruces),88001,33729,1177,1805,1619,4601,0.136410804
Los Angeles,90017,29822,626,1238,2203,4067,0.13637583
Mobile-Pensacola (Ft Walt),32512,22,1,1,1,3,0.136363636
Chico-Redding,95928,38298,1154,2680,1387,5221,0.136325657
Monroe-El Dorado,71203,38633,1768,2054,1437,5259,0.136127145
Chicago,60626,49551,1223,2647,2873,6743,0.136082017
Philadelphia,8638,25696,992,1714,789,3495,0.136013387
Miami-Ft. Lauderdale,33168,25263,1483,1172,777,3432,0.135850849
Little Rock-Pine Bluff,71601,13030,665,748,356,1769,0.135763622
Tallahassee-Thomasville,32303,50942,1496,2727,2693,6916,0.135762239
Burlington-Plattsburgh,5766,737,20,68,12,100,0.13568521
Houston,77090,40849,1326,2025,2185,5536,0.135523513
Fresno-Visalia,93660,4119,216,201,141,558,0.135469774
Toledo,43607,20027,591,1335,786,2712,0.135417187
New Orleans,70112,4970,61,208,404,673,0.135412475
Houston,77098,17032,231,682,1393,2306,0.135392203
Des Moines-Ames,50112,11658,644,689,245,1578,0.135357694
Oklahoma City,73102,2555,29,116,200,345,0.135029354
Chattanooga,37311,30334,1334,1636,1124,4094,0.134964067
Lexington,40475,65553,2762,3630,2455,8847,0.134959498
"Washington, DC (Hagrstwn)",22030,62212,2334,3019,3041,8394,0.134925738
Austin,78752,19197,450,893,1247,2590,0.134916914
Kansas City,66047,18026,472,1100,860,2432,0.134916232
Philadelphia,19604,29823,1438,1577,1006,4021,0.134828823
Harrisburg-Lncstr-Leb-York,17257,29669,1099,1850,1048,3997,0.134719741
Pittsburgh,15217,26344,853,1041,1653,3547,0.134641664
Lexington,40507,2187,40,141,113,294,0.134430727
Myrtle Beach-Florence,29526,58468,3297,3147,1413,7857,0.1343812
Macon,31098,2407,82,140,101,323,0.13419194
Rapid City,57764,313,17,12,13,42,0.134185304
Nashville,37210,17964,619,857,934,2410,0.134157203
St. Louis,63130,29244,858,1721,1343,3922,0.13411298
Corpus Christi,78363,28715,1122,1642,1085,3849,0.134041442
Savannah,31404,31383,1245,1730,1230,4205,0.13398974
St. Louis,63101,4269,67,156,349,572,0.133989225
Austin,78726,16845,523,772,962,2257,0.133986346
Omaha,68105,22764,679,1000,1371,3050,0.133983483
Detroit,48126,54444,2508,2610,2176,7294,0.133972522
Phoenix (Prescott),85008,59228,1988,2789,3156,7933,0.133940028
"Portland, OR",97227,5752,66,266,438,770,0.133866481
Baton Rouge,70721,643,25,38,23,86,0.133748056
Oklahoma City,73103,5204,73,174,449,696,0.133743274
Boston (Manchester),2143,27174,221,706,2707,3634,0.133730772
Sioux City,68067,935,53,36,36,125,0.13368984
San Diego,92109,44478,460,1515,3970,5945,0.133661586
Utica,13323,11533,607,724,209,1540,0.133529871
Lubbock,79414,17472,515,806,1012,2333,0.13352793
Buffalo,14201,13750,427,640,769,1836,0.133527273
Huntsville-Decatur (Flor),35811,33570,1892,1736,853,4481,0.133482276
Mobile-Pensacola (Ft Walt),36608,37650,1350,2089,1584,5023,0.133413015
Boston (Manchester),2118,29766,520,1215,2236,3971,0.133407243
San Francisco-Oak-San Jose,94118,38808,1138,1847,2192,5177,0.13340033
Boston (Manchester),2108,4393,127,189,270,586,0.133394036
Houston,77027,23578,314,972,1859,3145,0.133387056
Pittsburgh,15763,30,2,1,1,4,0.133333333
San Diego,92145,6747,211,583,105,899,0.133244405
San Diego,92110,28444,653,1580,1557,3790,0.133244269
Columbus-Tupelo-West Point,38843,12023,998,312,291,1601,0.133161441
Bismarck-Mnt-Dcknsn(Wlstn),58703,24204,811,1143,1269,3223,0.133159808
Memphis,38103,14641,107,497,1345,1949,0.133119322
Dallas-Ft. Worth,76010,54885,2404,2737,2164,7305,0.133096474
New York,10017,17423,145,539,1634,2318,0.13304253
"Lafayette, LA",70515,3624,133,179,170,482,0.133002208
Minneapolis-St. Paul,55416,34550,614,1285,2692,4591,0.132879884
Greenvll-Spart-Ashevll-And,29649,28091,1394,1246,1092,3732,0.132853939
Wichita-Hutchinson Plus,67456,4916,294,236,123,653,0.13283157
Providence-New Bedford,2909,46954,1762,2217,2252,6231,0.132704349
Buffalo,14209,7703,237,316,469,1022,0.132675581
"Portland, OR",97351,12336,527,537,572,1636,0.132619974
Albany-Schenectady-Troy,12210,11048,264,454,747,1465,0.132603186
Denver,81230,11257,470,607,414,1491,0.132450919
Albany-Schenectady-Troy,12207,2644,56,101,193,350,0.132375189
Minneapolis-St. Paul,55101,7951,84,353,615,1052,0.132310401
Orlando-Daytona Bch-Melbrn,32801,19088,402,749,1373,2524,0.132229673
Madison,53713,24075,670,1188,1325,3183,0.132211838
Memphis,38115,39568,1271,1800,2159,5230,0.132177517
Shreveport,71457,26663,1084,1449,990,3523,0.132130668
Richmond-Petersburg,23803,45300,2056,2320,1604,5980,0.13200883
San Antonio,78150,1038,50,66,21,137,0.131984586
Milwaukee,53212,27920,926,1097,1662,3685,0.131984241
Sioux City,68039,1220,70,45,46,161,0.131967213
San Antonio,78212,26707,1048,1524,952,3524,0.131950425
Hartford & New Haven,6106,38662,1655,2004,1441,5100,0.131912472
"Columbus, GA (Opelika, AL)",31901,7028,281,310,336,927,0.131900968
San Francisco-Oak-San Jose,95113,2504,17,85,228,330,0.131789137
New York,10458,76728,3474,3812,2824,10110,0.131764154
Seattle-Tacoma,98439,4845,121,256,261,638,0.131682147
Topeka,66536,4276,251,185,127,563,0.131665108
Oklahoma City,73717,6817,306,320,271,897,0.131582808
Miami-Ft. Lauderdale,33132,23795,191,951,1988,3130,0.13154024
Denver,80204,40068,928,1887,2453,5268,0.13147649
Phoenix (Prescott),85012,9664,158,454,658,1270,0.131415563
New York,7103,40233,2005,1768,1513,5286,0.131384684
Philadelphia,8102,8081,376,398,287,1061,0.131295632
Lubbock,79411,7153,212,380,347,939,0.131273592
Burlington-Plattsburgh,5404,8436,158,365,584,1107,0.131223329
Burlington-Plattsburgh,12970,564,31,32,11,74,0.131205674
Fresno-Visalia,95348,37547,1381,1879,1665,4925,0.131168935
Macon,31061,41788,2251,2149,1081,5481,0.131162056
Palm Springs,92254,12783,626,595,454,1675,0.131033404
Phoenix (Prescott),85035,51758,2168,2392,2221,6781,0.131013563
Austin,78702,29947,550,1214,2159,3923,0.130998097
Buffalo,14202,3619,36,154,284,474,0.130975408
Los Angeles,90804,38310,1040,1564,2413,5017,0.130957974
"Columbus, OH",43023,14677,808,914,200,1922,0.130953192
Dallas-Ft. Worth,76006,23958,536,1036,1565,3137,0.130937474
New York,10036,30594,381,1455,2169,4005,0.130908021
Grand Rapids-Kalmzoo-B.Crk,49504,41398,1044,2063,2310,5417,0.130851732
Knoxville,37909,16573,405,763,1000,2168,0.130815181
Los Angeles,90033,44185,1676,2201,1900,5777,0.130745728
Sioux Falls(Mitchell),57566,1415,83,57,45,185,0.130742049
Harrisburg-Lncstr-Leb-York,17101,2983,75,144,171,390,0.130740865
Portland-Auburn,4101,18285,274,790,1325,2389,0.130653541
Toledo,43451,1118,36,81,29,146,0.13059034
St. Louis,63140,314,9,20,12,41,0.130573248
Houston,77006,24556,314,973,1919,3206,0.130558723
Boston (Manchester),2445,22651,604,996,1357,2957,0.130546113
Albuquerque-Santa Fe,87117,789,23,62,18,103,0.130544994
Phoenix (Prescott),85054,11671,161,513,849,1523,0.130494388
Charlottesville,22723,23,1,1,1,3,0.130434783
Sioux City,51250,9798,531,494,253,1278,0.130434783
Cedar Rapids-Wtrlo-IWC&Dub,50613,40930,1167,2669,1499,5335,0.130344491
"Columbia, SC",29204,17823,666,1128,529,2323,0.130337205
Phoenix (Prescott),85033,56237,2655,2515,2156,7326,0.130270107
"Rochester, NY",14608,13589,420,700,650,1770,0.13025241
Jacksonville,32227,1697,50,107,64,221,0.130229817
Raleigh-Durham (Fayetvlle),27705,49625,1096,2263,3102,6461,0.130196474
Myrtle Beach-Florence,29506,19448,974,984,573,2531,0.130141917
"Washington, DC (Hagrstwn)",20762,2874,54,154,166,374,0.13013222
San Francisco-Oak-San Jose,94132,26269,808,1332,1273,3413,0.129925007
Harlingen-Wslco-Brnsvl-Mca,78574,66379,3305,2937,2382,8624,0.129920607
Lexington,40517,38899,1015,1788,2249,5052,0.129874804
Providence-New Bedford,2917,14553,1065,551,274,1890,0.12987013
Denver,80239,45512,1841,2037,2031,5909,0.12983389
"Washington, DC (Hagrstwn)",20670,1094,34,52,56,142,0.129798903
Memphis,38112,16333,707,790,623,2120,0.129798567
Albany-Schenectady-Troy,12180,56139,2185,2695,2396,7276,0.129606869
Oklahoma City,73105,6559,133,242,475,850,0.129592926
"Jackson, MS",39216,4060,65,203,258,526,0.12955665
"Jackson, MS",39056,28051,1250,1466,918,3634,0.129549749
Baltimore,21230,36759,614,1184,2963,4761,0.129519301
Atlanta,30510,8526,264,358,482,1104,0.129486277
"Portland, OR",97210,13348,213,511,1004,1728,0.129457597
Seattle-Tacoma,98102,26411,163,664,2591,3418,0.129415774
Houston,77032,13686,580,657,532,1769,0.129256174
Wichita-Hutchinson Plus,67220,14164,387,880,563,1830,0.129200791
Dallas-Ft. Worth,76059,4575,207,237,147,591,0.129180328
Denver,80526,44923,1246,2361,2195,5802,0.129154331
Bakersfield,93249,2563,140,107,84,331,0.129145533
South Bend-Elkhart,46617,10485,305,552,497,1354,0.129136862
South Bend-Elkhart,46613,11098,549,496,387,1432,0.129032258
Tulsa,74464,31848,1361,1594,1154,4109,0.129019091
Little Rock-Pine Bluff,71766,628,50,22,9,81,0.128980892
New York,10025,93044,2627,4565,4806,11998,0.128949744
San Francisco-Oak-San Jose,94705,12937,392,510,765,1667,0.128855221
Waco-Temple-Bryan,76543,30919,964,1382,1636,3982,0.128788124
Jonesboro,72401,63502,2570,3048,2558,8176,0.12875185
Los Angeles,92614,30734,746,1504,1707,3957,0.128749919
San Diego,92155,606,24,35,19,78,0.128712871
Chicago,60661,11761,52,284,1177,1513,0.128645523
Sacramnto-Stkton-Modesto,95825,36193,793,1724,2138,4655,0.128616031
"Jackson, TN",38340,12946,606,711,348,1665,0.128611154
Butte-Bozeman,59718,49584,1332,2436,2607,6375,0.1285697
Fresno-Visalia,95340,39556,2157,1586,1339,5082,0.128476085
Greenville-N.Bern-Washngtn,28546,49409,1541,2207,2598,6346,0.128438139
Fresno-Visalia,93219,9914,514,459,300,1273,0.128404277
Milwaukee,53140,30561,1313,1575,1035,3923,0.128366218
Wilkes Barre-Scranton-Hztn,18301,28736,1164,1616,908,3688,0.128340757
Des Moines-Ames,50314,12344,491,553,540,1584,0.128321452
Wichita-Hutchinson Plus,67208,18253,840,793,709,2342,0.128307675
Bakersfield,93250,15440,775,668,538,1981,0.128303109
Tucson (Sierra Vista),85701,5776,133,328,280,741,0.128289474
Burlington-Plattsburgh,5663,6533,387,310,141,838,0.128271851
Indianapolis,46222,38337,1610,1777,1529,4916,0.128231213
Cincinnati,45225,8150,280,341,424,1045,0.128220859
Fresno-Visalia,93628,78,3,3,4,10,0.128205128
Omaha,68132,13823,414,641,717,1772,0.128192144
Harlingen-Wslco-Brnsvl-Mca,78576,14735,793,637,458,1888,0.128130302
Dallas-Ft. Worth,75231,40764,1022,1829,2372,5223,0.12812776
"Washington, DC (Hagrstwn)",20008,29342,391,1173,2195,3759,0.128109877
Minneapolis-St. Paul,55401,12483,50,415,1134,1599,0.128094208
Sacramnto-Stkton-Modesto,95826,39543,1070,2105,1887,5062,0.128012543
Pittsburgh,15206,29318,547,1169,2037,3753,0.128010096
Greensboro-H.Point-W.Salem,24088,4862,173,336,112,621,0.127725216
Phoenix (Prescott),85202,43143,1110,1817,2579,5506,0.127622094
Boston (Manchester),2130,37313,510,1185,3065,4760,0.12756948
Pittsburgh,16127,15286,665,926,359,1950,0.127567709
Cedar Rapids-Wtrlo-IWC&Dub,52101,13174,686,754,240,1680,0.127523911
New York,10014,31540,333,1201,2488,4022,0.127520609
New York,6825,22490,1650,767,450,2867,0.12747888
Tyler-Longview(Lfkn&Ncgd),75701,36282,1609,1648,1368,4625,0.127473678
Huntsville-Decatur (Flor),35806,29873,814,1623,1369,3806,0.127406019
Cincinnati,45206,10955,194,446,755,1395,0.127339115
Philadelphia,18101,5492,137,250,312,699,0.127276038
Richmond-Petersburg,23226,19007,987,887,545,2419,0.127268901
Greenville-N.Bern-Washngtn,28545,5045,195,348,99,642,0.127254708
"Washington, DC (Hagrstwn)",25443,8071,401,440,186,1027,0.127245694
Salt Lake City,84057,36914,1250,1474,1971,4695,0.127187517
Salt Lake City,84116,36458,1160,1659,1818,4637,0.127187449
Nashville,37040,66650,2618,2902,2956,8476,0.127171793
Wilkes Barre-Scranton-Hztn,17745,18160,840,969,500,2309,0.127147577
Idaho Fals-Pocatllo(Jcksn),83448,2926,146,145,81,372,0.127136022
Cincinnati,45212,22112,491,1202,1118,2811,0.127125543
Burlington-Plattsburgh,12901,31969,1391,1688,985,4064,0.127123151
Evansville,47708,952,12,37,72,121,0.12710084
Fresno-Visalia,93646,10844,509,480,389,1378,0.12707488
Los Angeles,92867,44592,2503,1745,1418,5666,0.12706315
Indianapolis,47404,23982,693,1529,825,3047,0.127053624
New York,7043,12917,1025,415,201,1641,0.127041883
El Paso (Las Cruces),79902,19992,776,1016,746,2538,0.12695078
Raleigh-Durham (Fayetvlle),27546,22562,982,1197,685,2864,0.126939101
Atlanta,30165,44444,2031,2178,1427,5636,0.126811268
Boston (Manchester),2128,43680,988,1725,2824,5537,0.126762821
Chicago,60654,24665,90,679,2357,3126,0.126738293
Salt Lake City,84721,31384,1303,1322,1351,3976,0.126688759
Huntsville-Decatur (Flor),35805,23679,752,1196,1051,2999,0.126652308
Clarksburg-Weston,26351,2353,85,159,54,298,0.126646834
Austin,78756,9389,132,380,677,1189,0.126637555
Johnstown-Altoona-St Colge,16630,4613,226,225,133,584,0.126598743
Norfolk-Portsmth-Newpt Nws,23185,53675,1858,3656,1278,6792,0.126539357
New York,11216,63700,1008,2131,4919,8058,0.126499215
Lincoln & Hastings-Krny,69025,1091,66,35,37,138,0.126489459
Chicago,60064,15638,667,719,592,1978,0.126486763
Ft. Myers-Naples,33967,31160,901,1676,1364,3941,0.126476252
Phoenix (Prescott),85013,24359,437,1040,1603,3080,0.126441972
Baltimore,21217,30527,1111,1464,1284,3859,0.126412684
Syracuse,13310,633,39,27,14,80,0.126382306
Miami-Ft. Lauderdale,33314,31227,892,1408,1646,3946,0.126365005
Columbus-Tupelo-West Point,39701,12078,499,613,414,1526,0.126345421
Birmingham (Ann and Tusc),35204,10180,435,607,244,1286,0.12632613
Palm Springs,92236,44191,2096,1947,1539,5582,0.126315313
Orlando-Daytona Bch-Melbrn,32814,9123,197,340,615,1152,0.126274252
Laredo,78046,72183,3291,3087,2734,9112,0.126234709
Baton Rouge,70836,515,14,25,26,65,0.126213592
Des Moines-Ames,50169,3209,87,135,183,405,0.126207541
New York,10913,5144,238,268,143,649,0.126166407
Hartford & New Haven,6053,35651,1505,1594,1397,4496,0.12611147
Binghamton,13905,27416,694,1673,1090,3457,0.126094252
Fargo,56560,45983,1775,2347,1676,5798,0.126090077
New York,10031,51673,1078,2073,3362,6513,0.126042614
South Bend-Elkhart,49103,12164,434,644,455,1533,0.126027622
Houston,77073,50016,2088,2182,2030,6300,0.125959693
Buffalo,14208,12730,620,602,381,1603,0.125923016
Yakima-Pasco-Rchlnd-Knnwck,98932,5529,267,250,179,696,0.125881715
Providence-New Bedford,2840,23737,992,1132,864,2988,0.125879429
St. Louis,63102,3043,18,135,230,383,0.125862636
Tampa-St. Pete (Sarasota),33637,19168,510,835,1067,2412,0.125834725
Raleigh-Durham (Fayetvlle),27707,48448,1603,2020,2473,6096,0.125825627
Dallas-Ft. Worth,75287,55086,1229,2445,3257,6931,0.125821443
Tallahassee-Thomasville,31601,34253,1169,1825,1315,4309,0.1257992
Rapid City,57772,493,22,22,18,62,0.125760649
Milwaukee,53204,39736,1572,1643,1779,4994,0.125679485
Champaign&Sprngfld-Decatur,62522,15134,684,787,431,1902,0.125677283
Phoenix (Prescott),86005,17001,504,712,920,2136,0.125639668
Greenvll-Spart-Ashevll-And,28801,15563,479,763,713,1955,0.125618454
Boston (Manchester),2324,29511,1322,1546,839,3707,0.125614178
"Portland, OR",97214,28583,381,1040,2169,3590,0.125599132
Orlando-Daytona Bch-Melbrn,32828,68467,2508,2977,3113,8598,0.125578746
Los Angeles,92805,77828,2673,3499,3599,9771,0.125546076
Tampa-St. Pete (Sarasota),33559,14911,462,870,540,1872,0.1255449
Norfolk-Portsmth-Newpt Nws,23606,31250,880,1745,1298,3923,0.125536
Houston,77060,42579,1631,1866,1845,5342,0.125460908
Lansing,48912,17631,376,888,948,2212,0.125460836
Memphis,38111,39626,1311,1996,1663,4970,0.125422702
"Albany, GA",31705,28307,1451,1220,879,3550,0.125410676
"Jackson, MS",39154,8965,571,356,197,1124,0.125376464
Grand Rapids-Kalmzoo-B.Crk,49506,32973,1243,1497,1392,4132,0.125314651
Los Angeles,90815,41285,1975,1762,1436,5173,0.125299746
San Antonio,78224,23863,1135,1001,854,2990,0.125298579
Indianapolis,46227,62250,2370,2796,2633,7799,0.125285141
Lincoln & Hastings-Krny,68434,9387,443,492,241,1176,0.125279642
Atlanta,30260,27914,1168,1253,1076,3497,0.125277638
Omaha,68108,15937,597,703,696,1996,0.125243145
Los Angeles,90038,27573,492,1123,1838,3453,0.125231204
Minneapolis-St. Paul,54703,45300,1250,2860,1562,5672,0.125209713
Boston (Manchester),2145,27547,406,864,2179,3449,0.125204196
Houston,77507,807,22,39,40,101,0.125154895
Sacramnto-Stkton-Modesto,95819,21128,609,1494,541,2644,0.125141992
El Paso (Las Cruces),79908,2669,109,113,112,334,0.125140502
"Columbus, GA (Opelika, AL)",31905,13094,286,591,761,1638,0.125095464
"Portland, OR",97232,17221,236,595,1323,2154,0.125079844
Los Angeles,90011,98641,4175,4251,3909,12335,0.125049422
Bakersfield,93241,14499,718,620,475,1813,0.125043106
Burlington-Plattsburgh,5666,16,1,1,0,2,0.125
Montgomery-Selma,36130,24,1,1,1,3,0.125
Amarillo,79058,24,1,1,1,3,0.125
Cheyenne-Scottsbluff,82217,136,6,7,4,17,0.125
Phoenix (Prescott),85922,24,1,1,1,3,0.125
Albuquerque-Santa Fe,87729,72,1,3,5,9,0.125
Las Vegas,89115,68427,2687,2843,3023,8553,0.12499452
Louisville,40217,12881,198,626,786,1610,0.124990296
Baltimore,20755,8890,252,397,462,1111,0.124971879
Albuquerque-Santa Fe,87121,80249,3465,3499,3060,10024,0.124911214
Austin,78758,51101,1061,2074,3247,6382,0.124889924
Norfolk-Portsmth-Newpt Nws,23665,5662,191,251,265,707,0.124867538
Salt Lake City,84714,937,56,38,23,117,0.124866596
Cincinnati,45214,10244,379,487,413,1279,0.124853573
Austin,78744,55187,1865,2354,2670,6889,0.124830123
"Columbus, GA (Opelika, AL)",36276,2492,150,94,67,311,0.124799358
Sacramnto-Stkton-Modesto,95817,13570,304,691,698,1693,0.124760501
Detroit,48309,30935,1742,1485,632,3859,0.124745434
Phoenix (Prescott),85031,30745,1376,1306,1153,3835,0.124735729
Phoenix (Prescott),85210,39543,1204,1715,2012,4931,0.124699694
Rapid City,57752,1644,72,73,60,205,0.124695864
Tulsa,74120,5407,99,249,326,674,0.124653227
Baton Rouge,70807,15397,691,744,483,1918,0.124569721
Atlanta,30342,32140,930,1335,1738,4003,0.124548849
Harlingen-Wslco-Brnsvl-Mca,78542,89808,4239,3845,3099,11183,0.124521201
Salt Lake City,84107,40118,990,1675,2330,4995,0.124507702
Las Vegas,89086,9872,309,408,512,1229,0.124493517
Dallas-Ft. Worth,76155,7784,124,310,535,969,0.124486125
Fargo,58104,52613,1426,1849,3274,6549,0.12447494
"Jackson, MS",39204,14663,570,657,598,1825,0.124462934
Tampa-St. Pete (Sarasota),33711,21289,1266,876,506,2648,0.124383484
Los Angeles,90025,45902,492,1539,3677,5708,0.12435188
Duluth-Superior,55806,10273,266,477,534,1277,0.124306434
Dallas-Ft. Worth,76104,24698,902,1003,1165,3070,0.124301563
Savannah,31419,56628,1758,2456,2824,7038,0.124284806
Albany-Schenectady-Troy,12206,16151,546,808,653,2007,0.124264751
Los Angeles,92571,59972,2641,2579,2232,7452,0.124257987
Bakersfield,93203,20840,1030,856,703,2589,0.124232246
Cleveland-Akron (Canton),44113,22557,281,813,1708,2802,0.124218646
Los Angeles,90002,51913,2180,2219,2048,6447,0.124188546
Providence-New Bedford,2809,22158,1020,1085,646,2751,0.124153804
Dallas-Ft. Worth,75254,22746,521,925,1378,2824,0.124153697
Mobile-Pensacola (Ft Walt),36609,24942,636,1108,1352,3096,0.124127977
"Charleston, SC",29406,34550,1180,1481,1627,4288,0.124109986
Salt Lake City,84115,28765,643,1262,1665,3570,0.12410916
Salt Lake City,84104,23065,939,982,941,2862,0.12408411
"Rochester, NY",14456,19424,797,1087,526,2410,0.124073311
Phoenix (Prescott),85019,27196,1128,1164,1082,3374,0.124062362
Los Angeles,90003,70705,2970,2954,2843,8767,0.12399406
Cedar Rapids-Wtrlo-IWC&Dub,52241,23946,534,1097,1338,2969,0.123987305
Salt Lake City,84097,23514,810,959,1146,2915,0.123968699
Los Angeles,92866,15644,414,676,849,1939,0.123945283
Monterey-Salinas,93933,27614,1395,906,1121,3422,0.123922648
Indianapolis,46225,6674,228,271,328,827,0.123913695
Providence-New Bedford,2747,21958,959,1311,449,2719,0.123827307
Miami-Ft. Lauderdale,33181,20604,701,1001,849,2551,0.123810911
Kansas City,65340,16413,744,819,469,2032,0.123804301
Albuquerque-Santa Fe,87102,20375,554,1031,936,2521,0.123730061
Monterey-Salinas,95060,47879,1171,2593,2160,5924,0.123728566
Indianapolis,46250,18661,391,691,1226,2308,0.123680403
Memphis,38104,24677,538,1084,1430,3052,0.123677919
Harlingen-Wslco-Brnsvl-Mca,78557,13503,636,572,462,1670,0.12367622
Louisville,40204,14425,194,616,974,1784,0.123674177
New York,11211,64442,1168,2169,4631,7968,0.123646069
Los Angeles,92553,76737,3133,3282,3073,9488,0.123643093
Charlotte,29730,62208,2652,2904,2135,7691,0.123633616
New York,10013,30187,655,1608,1469,3732,0.123629377
Spokane,99218,16523,667,725,650,2042,0.123585305
Seattle-Tacoma,98121,23361,129,756,2002,2887,0.123582038
Knoxville,37760,14170,585,727,439,1751,0.123570924
Baltimore,21286,23729,787,1227,918,2932,0.123561886
New York,11101,54447,683,1763,4281,6727,0.123551344
Denver,80620,21441,752,1053,844,2649,0.123548342
Houston,77075,41875,1653,1834,1686,5173,0.123534328
Memphis,38126,6048,220,243,284,747,0.123511905
Phoenix (Prescott),85307,17280,593,751,790,2134,0.12349537
San Antonio,78251,58854,1845,2408,3014,7267,0.12347504
Hattiesburg-Laurel,39402,46439,1574,2175,1985,5734,0.123473804
Los Angeles,90036,39128,575,1312,2944,4831,0.123466571
Dallas-Ft. Worth,75237,21407,789,845,1009,2643,0.123464287
Phoenix (Prescott),85037,55777,2362,2290,2234,6886,0.123455905
"Rochester, NY",14618,22066,1152,1003,569,2724,0.123447838
Savannah,31313,43421,1358,1743,2258,5359,0.123419544
Salisbury,21801,31487,1480,1448,958,3886,0.123416013
Des Moines-Ames,50316,17123,764,829,520,2113,0.123401273
New Orleans,70301,47563,2380,1871,1618,5869,0.123394235
Jacksonville,32256,67597,1382,2787,4172,8341,0.12339305
Fargo,58201,43276,1149,2054,2136,5339,0.123370922
Houston,77502,36852,1550,1625,1371,4546,0.123358298
Harlingen-Wslco-Brnsvl-Mca,78573,44278,1979,1919,1561,5459,0.123289218
Grand Rapids-Kalmzoo-B.Crk,49546,35722,1465,1968,971,4404,0.12328537
Phoenix (Prescott),85043,41977,1835,1668,1672,5175,0.123281797
Phoenix (Prescott),85552,7596,312,358,266,936,0.123222749
Greenville-N.Bern-Washngtn,27834,55526,1655,2658,2529,6842,0.123221554
"Columbus, OH",43203,9465,248,381,537,1166,0.123190703
Philadelphia,18042,44961,1953,2232,1352,5537,0.123151175
Harrisburg-Lncstr-Leb-York,17003,12214,582,666,256,1504,0.123137383
New York,7424,28088,1264,1383,811,3458,0.123113073
Augusta-Aiken,30909,49586,1266,2119,2718,6103,0.123079095
Roanoke-Lynchburg,24016,9629,236,310,639,1185,0.123065739
San Antonio,78242,32676,1371,1406,1244,4021,0.123056678
Phoenix (Prescott),85003,14693,568,557,683,1808,0.123051793
"Albany, GA",31793,8981,282,502,321,1105,0.123037524
San Francisco-Oak-San Jose,94556,16991,958,808,324,2090,0.123006297
Birmingham (Ann and Tusc),35405,44291,1369,1986,2093,5448,0.123004674
Los Angeles,90813,50333,1798,2128,2265,6191,0.123000815
Los Angeles,90001,54433,2282,2261,2151,6694,0.122976871
Dallas-Ft. Worth,75211,69752,2920,3126,2530,8576,0.12294988
Macon,31030,18554,784,942,555,2281,0.12293845
Harlingen-Wslco-Brnsvl-Mca,78537,56195,2800,2361,1746,6907,0.122911291
Hartford & New Haven,6457,48543,1736,2392,1836,5964,0.122860145
Salt Lake City,84105,21846,578,903,1203,2684,0.12286002
Lincoln & Hastings-Krny,68521,37504,1251,1762,1594,4607,0.12284023
Harlingen-Wslco-Brnsvl-Mca,78599,34735,1647,1434,1184,4265,0.122786814
Youngstown,44502,9312,518,357,268,1143,0.122744845
Yakima-Pasco-Rchlnd-Knnwck,99324,9899,419,528,268,1215,0.122739671
Nashville,37213,326,7,10,23,40,0.122699387
Charlotte,28036,22456,1130,1249,376,2755,0.122684361
Tampa-St. Pete (Sarasota),33607,27706,604,1071,1724,3399,0.122681008
Phoenix (Prescott),85301,63642,2578,2713,2515,7806,0.122654851
New York,10019,50699,527,1943,3747,6217,0.122625693
Los Angeles,93552,42187,1765,1874,1534,5173,0.122620713
Phoenix (Prescott),85014,27436,553,1169,1642,3364,0.122612626
Sacramnto-Stkton-Modesto,95816,18059,218,680,1316,2214,0.122598151
New York,10507,6387,192,304,287,783,0.122592767
Fresno-Visalia,93223,9862,452,417,340,1209,0.122591766
Houston,77038,30502,1331,1291,1117,3739,0.122582126
Chicago,60484,6714,283,303,237,823,0.122579684
South Bend-Elkhart,46637,15795,308,903,725,1936,0.122570434
New York,11233,72839,1911,2944,4072,8927,0.12255797
Yakima-Pasco-Rchlnd-Knnwck,98944,22464,1103,973,677,2753,0.122551638
Norfolk-Portsmth-Newpt Nws,23461,661,39,31,11,81,0.122541604
Dallas-Ft. Worth,75212,28161,1104,1125,1221,3450,0.122509854
Fresno-Visalia,93726,40890,1425,1717,1867,5009,0.122499389
El Paso (Las Cruces),79836,7538,350,320,253,923,0.122446272
Lexington,40313,3047,85,136,152,373,0.122415491
Topeka,66619,3137,140,130,114,384,0.122409946
Los Angeles,90262,65920,2476,2781,2811,8068,0.122390777
"Columbus, GA (Opelika, AL)",31709,14895,597,618,608,1823,0.122390064
Dallas-Ft. Worth,75203,16596,531,665,835,2031,0.122378886
Indianapolis,46214,25941,781,1078,1315,3174,0.122354574
Salt Lake City,84047,37866,1014,1570,2048,4632,0.122326097
Indianapolis,47403,33303,813,1909,1351,4073,0.122301294
Charlotte,28206,17923,478,635,1079,2192,0.122300954
Wichita-Hutchinson Plus,67579,2936,127,166,66,359,0.122275204
"Columbus, OH",43217,2110,98,81,79,258,0.122274882
Rapid City,57770,7795,401,308,244,953,0.122257858
Albuquerque-Santa Fe,87728,319,6,11,22,39,0.122257053
Los Angeles,90201,91972,3701,3816,3724,11241,0.122221981
Grand Rapids-Kalmzoo-B.Crk,49544,9581,241,361,569,1171,0.122221063
Chicago,60914,28992,1175,1485,883,3543,0.122206126
Buffalo,14215,42466,1743,1835,1611,5189,0.122191871
Boston (Manchester),2140,23232,448,859,1531,2838,0.122159091
Cleveland-Akron (Canton),44627,7851,360,311,288,959,0.122150045
Los Angeles,92701,52081,2191,2175,1994,6360,0.122117471
Orlando-Daytona Bch-Melbrn,33896,27238,704,948,1674,3326,0.122108819
Colorado Springs-Pueblo,80910,32234,906,1284,1745,3935,0.122076069
New York,10029,77975,2138,3616,3763,9517,0.12205194
Austin,78742,1287,50,66,41,157,0.121989122
Bakersfield,93206,1919,93,79,62,234,0.12193851
Hartford & New Haven,6105,18719,416,800,1066,2282,0.121908222
Charlotte,28209,25750,451,1001,1687,3139,0.121902913
Orlando-Daytona Bch-Melbrn,32925,1370,51,63,53,167,0.12189781
Charlotte,28207,9869,466,503,234,1203,0.121896849
Bakersfield,93307,91228,4158,3756,3205,11119,0.12188144
Wichita Falls & Lawton,76311,5949,309,282,134,725,0.121869222
Chicago,60601,17537,91,584,1462,2137,0.121856646
Harlingen-Wslco-Brnsvl-Mca,78538,17464,813,728,586,2127,0.121793404
Birmingham (Ann and Tusc),35064,10072,459,497,270,1226,0.12172359
Oklahoma City,74804,22881,969,1159,657,2785,0.121716708
Orlando-Daytona Bch-Melbrn,32811,42550,1337,1843,1999,5179,0.121715629
Norfolk-Portsmth-Newpt Nws,23669,42020,1741,1955,1417,5113,0.121680152
Fresno-Visalia,93647,10812,485,469,361,1315,0.121624121
Bakersfield,93263,20427,932,871,681,2484,0.12160376
"Portland, OR",97209,24576,189,857,1942,2988,0.121582031
Lansing,48933,2772,42,104,191,337,0.121572872
Atlanta,30033,35396,674,1721,1907,4302,0.121539157
Raleigh-Durham (Fayetvlle),28310,10730,320,674,310,1304,0.121528425
Flint-Saginaw-Bay City,48502,1440,49,76,50,175,0.121527778
Los Angeles,91325,33586,979,1587,1515,4081,0.121508962
Chicago,60608,69046,1901,2845,3641,8387,0.121469745
San Francisco-Oak-San Jose,94928,48078,1415,1917,2508,5840,0.121469279
Erie,16502,15437,447,760,668,1875,0.121461424
Colorado Springs-Pueblo,80916,40303,1376,1710,1809,4895,0.121454979
New York,7430,25314,1156,1342,576,3074,0.121434779
Laredo,78043,44637,1959,1850,1611,5420,0.121423931
Pittsburgh,21532,13211,588,625,391,1604,0.121413973
Los Angeles,92868,26663,665,1151,1421,3237,0.121404193
Orlando-Daytona Bch-Melbrn,34714,31721,992,1373,1485,3850,0.121370701
Buffalo,14203,1961,24,68,146,238,0.12136665
Wichita-Hutchinson Plus,67207,29797,914,1319,1383,3616,0.121354499
Knoxville,37920,43694,1124,2461,1717,5302,0.121343892
Flint-Saginaw-Bay City,48801,12857,869,365,326,1560,0.121334681
Los Angeles,90034,55950,881,2051,3856,6788,0.121322609
Oklahoma City,73705,305,7,13,17,37,0.121311475
El Paso (Las Cruces),79934,30555,1134,1274,1298,3706,0.121289478
Boston (Manchester),1602,24125,985,1165,776,2926,0.121284974
Fresno-Visalia,93650,3290,124,134,141,399,0.121276596
Boston (Manchester),2481,17466,942,958,218,2118,0.12126417
Phoenix (Prescott),85303,37047,1552,1527,1413,4492,0.121251383
Philadelphia,19131,43027,1791,1636,1789,5216,0.121226207
Philadelphia,19146,43094,677,1394,3151,5222,0.121176962
Houston,77598,28746,653,1168,1662,3483,0.121164684
Los Angeles,91702,61188,2273,2806,2332,7411,0.12111852
Hartford & New Haven,6516,55932,2429,2449,1896,6774,0.121111349
Sioux Falls(Mitchell),57572,2601,132,102,81,315,0.121107266
El Paso (Las Cruces),79928,85947,3972,3405,3030,10407,0.121086251
Louisville,40121,7979,309,390,267,966,0.121067803
Los Angeles,92407,66705,2821,2784,2470,8075,0.121055393
El Paso (Las Cruces),79849,14573,647,621,496,1764,0.12104577
New York,11213,66327,1906,2617,3503,8026,0.121006528
Detroit,48212,42715,1622,1795,1750,5167,0.120964532
Salisbury,21853,13170,563,736,294,1593,0.12095672
New York,10011,48621,870,1619,3392,5881,0.120955966
Tampa-St. Pete (Sarasota),33621,1877,71,94,62,227,0.120937666
Phoenix (Prescott),85353,52672,2289,2065,2016,6370,0.12093712
Waco-Temple-Bryan,76549,57561,2137,2192,2632,6961,0.120932576
Houston,77081,46130,1554,1893,2131,5578,0.120919142
Tulsa,74146,16243,727,680,557,1964,0.120913624
San Antonio,78208,3756,106,165,183,454,0.120873269
San Francisco-Oak-San Jose,94703,20621,374,824,1294,2492,0.12084768
Kansas City,64153,6944,223,275,341,839,0.120823733
Phoenix (Prescott),85542,3121,143,134,100,377,0.120794617
Oklahoma City,74653,3561,181,144,105,430,0.120752598
Little Rock-Pine Bluff,72143,35488,1821,1293,1168,4282,0.120660505
Harrisburg-Lncstr-Leb-York,17325,30028,1408,1552,663,3623,0.120654056
Los Angeles,90723,51449,1964,2192,2051,6207,0.120643744
Los Angeles,92410,49722,2148,2050,1800,5998,0.120630707
Santabarbra-Sanmar-Sanluob,93458,59875,2562,2499,2161,7222,0.120617954
Louisville,40209,647,20,33,25,78,0.120556414
Fresno-Visalia,93245,39034,1379,1687,1639,4705,0.120535943
Greenvll-Spart-Ashevll-And,29617,33456,1432,1673,927,4032,0.120516499
Los Angeles,91601,41539,643,1601,2762,5006,0.120513253
Cedar Rapids-Wtrlo-IWC&Dub,52401,2407,38,114,138,290,0.120481928
Los Angeles,90265,15829,674,898,335,1907,0.120475077
Los Angeles,90802,40798,591,1584,2740,4915,0.120471592
Milwaukee,53205,9688,392,397,378,1167,0.120458299
Salt Lake City,84770,48914,2102,2194,1596,5892,0.120456311
Cedar Rapids-Wtrlo-IWC&Dub,52402,41511,1480,2047,1473,5000,0.120450001
Denver,81101,15861,652,723,535,1910,0.120421159
Salt Lake City,84630,299,13,13,10,36,0.120401338
Cheyenne-Scottsbluff,82221,515,22,26,14,62,0.12038835
Los Angeles,90059,42532,1738,1772,1609,5119,0.120356438
Greenvll-Spart-Ashevll-And,29639,1695,91,79,34,204,0.120353982
Pittsburgh,15201,13712,132,526,992,1650,0.120332555
Raleigh-Durham (Fayetvlle),27603,58283,1656,2830,2527,7013,0.120326682
Denver,80237,24600,356,891,1713,2960,0.120325203
Houston,77034,35575,1345,1483,1452,4280,0.120309206
Philadelphia,18034,9735,505,489,177,1171,0.120287622
Cedar Rapids-Wtrlo-IWC&Dub,50677,13036,605,692,271,1568,0.120282295
Denver,80235,8748,190,367,495,1052,0.120256059
San Francisco-Oak-San Jose,95050,40050,1469,1753,1594,4816,0.120249688
New Orleans,70130,14263,230,476,1009,1715,0.120241183
Wichita-Hutchinson Plus,67701,6538,305,240,241,786,0.120220251
Jacksonville,31547,2446,60,150,84,294,0.120196239
"Springfield, MO",65802,50264,1769,2453,1819,6041,0.120185421
Roanoke-Lynchburg,24450,18006,800,897,467,2164,0.120182162
Charleston-Huntington,45685,1348,66,62,34,162,0.120178042
Harlingen-Wslco-Brnsvl-Mca,78570,36025,1739,1467,1123,4329,0.120166551
El Paso (Las Cruces),79906,8232,203,381,405,989,0.120140914
Raleigh-Durham (Fayetvlle),28314,53522,1483,2027,2920,6430,0.120137514
Monterey-Salinas,93926,9373,403,394,329,1126,0.120132295
Wilkes Barre-Scranton-Hztn,17752,6087,165,210,356,731,0.120091999
Greenvll-Spart-Ashevll-And,29601,14906,266,599,925,1790,0.120085871
Harlingen-Wslco-Brnsvl-Mca,78577,81992,3613,3295,2938,9846,0.120084886
New York,6604,27895,987,1317,1045,3349,0.120057358
Los Angeles,90058,4198,175,171,158,504,0.12005717
San Diego,92113,46148,1879,1819,1841,5539,0.12002687
Savannah,29912,25,1,1,1,3,0.12
Chicago,60301,3400,47,132,229,408,0.12
Denver,80205,37048,572,1292,2581,4445,0.119979486
Dallas-Ft. Worth,76106,37463,1637,1517,1340,4494,0.119958359
Boston (Manchester),1840,7370,182,327,375,884,0.119945726
El Paso (Las Cruces),88063,12083,514,497,438,1449,0.11992055
Cleveland-Akron (Canton),44107,49370,974,1926,3020,5920,0.119910877
Wichita-Hutchinson Plus,67851,2719,137,110,79,326,0.119897021
Los Angeles,90005,42413,977,1701,2407,5085,0.119892486
Idaho Fals-Pocatllo(Jcksn),83450,1293,59,53,43,155,0.119876257
Paducah-Cape Girard-Harsbg,38201,10203,349,627,247,1223,0.119866706
Oklahoma City,73114,18504,605,756,857,2218,0.119865975
Wichita-Hutchinson Plus,67117,1794,75,104,36,215,0.119843924
Columbus-Tupelo-West Point,39745,726,52,21,14,87,0.119834711
"Lafayette, LA",70506,40851,1139,1738,2018,4895,0.119825708
Bismarck-Mnt-Dcknsn(Wlstn),57658,676,31,31,19,81,0.119822485
Salt Lake City,84403,37372,1298,1544,1636,4478,0.119822327
Richmond-Petersburg,23223,53476,1350,2061,2996,6407,0.119810756
Topeka,66607,10250,339,438,451,1228,0.119804878
Sioux Falls(Mitchell),57339,960,48,35,32,115,0.119791667
Syracuse,13204,18883,582,692,988,2262,0.119790288
Yakima-Pasco-Rchlnd-Knnwck,98935,3708,178,152,114,444,0.1197411
Roanoke-Lynchburg,24416,8686,379,392,269,1040,0.119732904
Atlanta,30093,54625,1892,2322,2326,6540,0.1197254
Richmond-Petersburg,23230,11060,135,320,869,1324,0.119710669
Los Angeles,92411,26748,1177,1094,931,3202,0.119709885
"Tri-Cities, TN-VA",24361,5455,256,285,112,653,0.119706691
Miami-Ft. Lauderdale,33035,21223,870,886,784,2540,0.119681478
Nashville,37201,2699,10,73,240,323,0.119673953
Fresno-Visalia,93702,44586,1974,1816,1545,5335,0.119656394
New York,7940,16982,838,832,362,2032,0.119656106
Fresno-Visalia,93256,6798,323,286,204,813,0.119593998
Atlanta,30060,38851,1520,1751,1375,4646,0.119585081
Dallas-Ft. Worth,75180,27539,1236,1152,904,3292,0.119539562
Rapid City,57714,929,38,40,33,111,0.119483315
Jacksonville,32277,31545,1080,1379,1310,3769,0.119480108
Phoenix (Prescott),85251,40169,605,1463,2731,4799,0.119470238
Los Angeles,90221,48960,1916,2000,1933,5849,0.119464869
Houston,77021,28973,808,1301,1352,3461,0.119456045
Fresno-Visalia,93235,4546,210,182,151,543,0.119445667
Chicago,60611,38028,240,1226,3076,4542,0.119438309
Laredo,78041,49567,2021,2163,1736,5920,0.119434301
Springfield-Holyoke,1119,13397,596,629,375,1600,0.119429723
New York,10032,56435,1224,2327,3189,6740,0.119429432
Little Rock-Pine Bluff,72211,24204,592,919,1379,2890,0.119401752
Houston,77007,51593,444,1686,4030,6160,0.119396042
Salisbury,21804,40414,1265,1991,1567,4823,0.119339833
New York,10044,11749,170,355,877,1402,0.119329305
Harlingen-Wslco-Brnsvl-Mca,78595,6345,285,254,218,757,0.119306541
Houston,77014,35235,1294,1450,1459,4203,0.119284802
Boston (Manchester),2119,27694,818,1109,1375,3302,0.119231603
Phoenix (Prescott),85323,50302,2126,1975,1896,5997,0.119219912
Boston (Manchester),3102,33483,950,1488,1553,3991,0.119194815
Dallas-Ft. Worth,75224,32427,1277,1441,1147,3865,0.119190798
Boston (Manchester),2210,7669,36,244,634,914,0.119181119
Seattle-Tacoma,98403,8081,160,334,469,963,0.11916842
Rapid City,57716,621,31,25,18,74,0.119162641
Tucson (Sierra Vista),85705,58001,1673,2857,2381,6911,0.119153118
Dallas-Ft. Worth,76014,35084,1373,1488,1319,4180,0.119142629
St. Louis,63104,19288,390,733,1175,2298,0.119141435
Salt Lake City,84062,47538,2122,1786,1755,5663,0.119125752
Dallas-Ft. Worth,76110,29996,1067,1332,1174,3573,0.119115882
Seattle-Tacoma,98406,22894,933,1074,720,2727,0.119114178
Great Falls,59521,3393,139,140,125,404,0.119068671
Houston,77086,28875,1218,1172,1048,3438,0.119064935
"Rochester, NY",14613,14488,537,629,559,1725,0.119064053
Ft. Smith-Fay-Sprngdl-Rgrs,72761,26432,1146,1114,887,3147,0.11906023
Atlanta,30306,25436,448,868,1712,3028,0.119043875
Los Angeles,92707,53550,1851,2268,2255,6374,0.119028945
Harrisonburg,22802,29105,1028,1348,1088,3464,0.119017351
Dallas-Ft. Worth,75051,38540,1660,1528,1398,4586,0.118993254
Waco-Temple-Bryan,76711,9707,320,430,405,1155,0.118986299
Salt Lake City,84003,62670,2935,2491,2029,7455,0.118956438
Missoula,59802,21085,524,887,1097,2508,0.118947119
Houston,77504,25415,918,1092,1013,3023,0.118945505
Idaho Fals-Pocatllo(Jcksn),83201,41103,1548,1794,1544,4886,0.118872102
Houston,77042,43653,1017,1919,2252,5188,0.118846356
Evansville,62862,345,7,29,5,41,0.11884058
Los Angeles,92582,23000,1001,918,814,2733,0.118826087
Harlingen-Wslco-Brnsvl-Mca,78589,39936,1813,1626,1305,4744,0.118790064
Madison,53705,25838,436,975,1658,3069,0.118778543
Wichita-Hutchinson Plus,67059,1044,52,46,26,124,0.118773946
Seattle-Tacoma,98101,17764,98,569,1442,2109,0.118723261
Erie,16504,15399,551,823,454,1828,0.118709007
Seattle-Tacoma,98409,29637,806,1212,1500,3518,0.118702973
Los Angeles,90061,28636,1099,1164,1136,3399,0.118696745
Lansing,48910,33936,840,1570,1618,4028,0.118694012
Memphis,38829,17757,929,684,494,2107,0.118657431
Richmond-Petersburg,23224,41930,1188,1363,2424,4975,0.118650131
Houston,77015,57388,2330,2337,2141,6808,0.118631073
Portland-Auburn,4005,25273,1030,1062,906,2998,0.118624619
"Washington, DC (Hagrstwn)",20024,18840,224,644,1366,2234,0.118577495
Boise,83705,27323,596,1065,1578,3239,0.118544816
Chicago,60804,81102,3365,3323,2924,9612,0.118517423
Miami-Ft. Lauderdale,33137,29419,385,1286,1815,3486,0.11849485
Los Angeles,92335,95748,3753,3965,3626,11344,0.118477671
Norfolk-Portsmth-Newpt Nws,23603,3478,116,129,167,412,0.118458884
Baton Rouge,70816,43012,1263,1691,2141,5095,0.118455315
New York,10952,47843,2270,1908,1489,5667,0.11844993
Ft. Wayne,46815,27916,1241,1107,958,3306,0.118426709
Rapid City,57794,980,49,39,28,116,0.118367347
Waco-Temple-Bryan,76541,19955,571,790,1000,2361,0.118316211
Dallas-Ft. Worth,76115,20327,863,830,712,2405,0.118315541
Harlingen-Wslco-Brnsvl-Mca,78521,91731,3969,3753,3131,10853,0.118313329
Greensboro-H.Point-W.Salem,27409,18800,493,726,1005,2224,0.118297872
Duluth-Superior,55811,28019,934,1633,747,3314,0.118276884
Chicago,60629,109225,4395,4507,4016,12918,0.118269627
Atlanta,30501,32045,1178,1376,1235,3789,0.118239975
Charlotte,28217,35873,1087,1383,1771,4241,0.118222619
Fresno-Visalia,93267,5329,229,222,179,630,0.118221055
Memphis,38610,3130,145,143,82,370,0.118210863
"Washington, DC (Hagrstwn)",20003,40366,413,1167,3191,4771,0.118193529
Providence-New Bedford,2882,13098,243,904,401,1548,0.118185983
Salt Lake City,84621,220,9,9,8,26,0.118181818
Houston,77049,40770,1601,1611,1606,4818,0.118175129
Milwaukee,53218,37810,1605,1524,1336,4465,0.118090452
Memphis,38668,15028,825,523,426,1774,0.118046314
Raleigh-Durham (Fayetvlle),28386,5363,236,218,179,633,0.118030953
Dallas-Ft. Worth,75217,80570,3615,3241,2652,9508,0.118009185
Fresno-Visalia,93638,50660,2330,2005,1642,5977,0.117982629
Atlanta,30350,35277,770,1510,1882,4162,0.117980554
Philadelphia,19611,11614,424,542,404,1370,0.117961081
Evansville,47713,10174,313,456,431,1200,0.11794771
Paducah-Cape Girard-Harsbg,63703,8997,243,407,411,1061,0.117928198
Nashville,37042,94028,3096,3285,4707,11088,0.117922321
Los Angeles,90063,48685,1917,1896,1928,5741,0.117921331
Los Angeles,92376,86015,3438,3475,3229,10142,0.117909667
Memphis,38128,42134,1557,1703,1708,4968,0.117909527
Tampa-St. Pete (Sarasota),34234,21078,700,1129,656,2485,0.117895436
Greenwood-Greenville,38732,16714,809,547,614,1970,0.117865263
El Paso (Las Cruces),79904,31353,1064,1354,1276,3694,0.117819666
Houston,77039,28156,1245,1140,932,3317,0.117807927
Spokane,99349,8281,409,346,220,975,0.117739403
Los Angeles,92316,31387,1252,1272,1171,3695,0.117723898
Paducah-Cape Girard-Harsbg,62902,4842,114,259,197,570,0.11771995
Salt Lake City,84004,10458,576,431,224,1231,0.117708931
Austin,78724,33800,1417,1323,1236,3976,0.117633136
Los Angeles,93535,80736,3342,3415,2740,9497,0.117630301
Minneapolis-St. Paul,55411,31092,1292,1226,1139,3657,0.11761868
San Diego,92105,64890,2237,2647,2748,7632,0.117614424
St. Louis,63106,8664,373,344,302,1019,0.117613112
El Paso (Las Cruces),88048,4226,164,193,140,497,0.117605301
Savannah,31405,37316,1081,1879,1428,4388,0.11759031
New Orleans,70122,35912,1291,1775,1156,4222,0.117565159
Los Angeles,90304,24745,908,945,1056,2909,0.117559103
Yuma-El Centro,92249,6916,306,277,230,813,0.117553499
Chicago,60612,34046,905,1370,1727,4002,0.117546848
Philadelphia,19013,34077,1450,1412,1143,4005,0.117527951
Philadelphia,19901,37265,1271,1724,1384,4379,0.117509728
New York,12779,2928,108,139,97,344,0.117486339
Boston (Manchester),1915,42875,1673,2067,1297,5037,0.11748105
Dallas-Ft. Worth,75062,48649,1842,1915,1957,5714,0.117453596
New York,12583,2197,55,158,45,258,0.117432863
St. Joseph,64507,14238,588,585,499,1672,0.117432224
Fresno-Visalia,93701,10952,429,424,433,1286,0.117421476
Dallas-Ft. Worth,76132,25899,629,1048,1364,3041,0.117417661
Houston,77067,30842,1228,1256,1137,3621,0.117404838
Columbia-Jefferson City,63382,4259,109,150,241,500,0.11739845
Orlando-Daytona Bch-Melbrn,32839,61117,1708,2294,3173,7175,0.117397778
Los Angeles,90222,31367,1231,1228,1223,3682,0.117384512
"Washington, DC (Hagrstwn)",20782,36258,925,1397,1934,4256,0.117380992
New York,6606,50464,2033,2152,1738,5923,0.117370799
Denver,80226,33315,1100,1466,1344,3910,0.117364551
New Orleans,70126,30410,1279,1254,1036,3569,0.11736271
Laredo,78045,67608,2849,2711,2374,7934,0.117352976
Fargo,58327,392,29,12,5,46,0.117346939
Albany-Schenectady-Troy,12202,10176,387,392,415,1194,0.117334906
Boston (Manchester),2493,11929,622,616,161,1399,0.117277224
Monterey-Salinas,93905,63996,2780,2526,2199,7505,0.117272955
Topeka,66604,23059,836,1030,838,2704,0.117264409
Ft. Myers-Naples,33916,27912,870,1126,1277,3273,0.117261393
Miami-Ft. Lauderdale,33130,35921,577,1355,2280,4212,0.117257315
Chicago,60632,87487,3470,3574,3213,10257,0.117240276
Harlingen-Wslco-Brnsvl-Mca,78582,44981,1977,1810,1486,5273,0.117227274
Ft. Wayne,46803,10178,383,393,417,1193,0.117213598
"Rochester, NY",14611,17394,618,822,598,2038,0.117166839
Montgomery-Selma,36104,7785,344,248,320,912,0.117148362
Santabarbra-Sanmar-Sanluob,93101,30033,705,1190,1623,3518,0.117137815
Greenville-N.Bern-Washngtn,28532,21166,639,1007,833,2479,0.117121799
Detroit,48209,25821,1030,1070,924,3024,0.117113977
Los Angeles,90270,25097,958,997,984,2939,0.11710563
Rochestr-Mason City-Austin,55904,30274,888,1261,1396,3545,0.117097179
Indianapolis,46224,38570,1253,1581,1682,4516,0.117085818
Austin,78728,26968,540,1028,1589,3157,0.117064669
Fresno-Visalia,93618,32543,1467,1298,1044,3809,0.11704514
Orlando-Daytona Bch-Melbrn,32765,67311,2405,3250,2223,7878,0.11703882
Dallas-Ft. Worth,75253,26445,1228,1040,827,3095,0.117035356
Yakima-Pasco-Rchlnd-Knnwck,98938,2102,98,83,65,246,0.117031399
Los Angeles,93550,79844,3270,3154,2920,9344,0.117028205
Greenvll-Spart-Ashevll-And,29607,49579,1320,1997,2484,5801,0.117005184
Harlingen-Wslco-Brnsvl-Mca,78526,55212,2292,2214,1953,6459,0.116985438
Salt Lake City,84106,38203,905,1433,2131,4469,0.116980342
Boston (Manchester),1612,4984,238,252,93,583,0.116974318
Harrisburg-Lncstr-Leb-York,17033,16698,641,719,593,1953,0.116960115
Dallas-Ft. Worth,76107,32005,636,1087,2020,3743,0.116950476
Hattiesburg-Laurel,39437,14009,779,469,390,1638,0.116924834
Binghamton,13901,20689,594,1249,576,2419,0.116922036
Augusta-Aiken,30901,16561,755,602,579,1936,0.116901153
Rapid City,57574,77,3,3,3,9,0.116883117
Colorado Springs-Pueblo,80929,3388,104,119,173,396,0.116883117
Dallas-Ft. Worth,75181,27686,1209,1122,905,3236,0.116882179
Norfolk-Portsmth-Newpt Nws,23604,4911,109,215,250,574,0.116880472
West Palm Beach-Ft. Pierce,33409,32770,928,1342,1560,3830,0.116875191
Paducah-Cape Girard-Harsbg,62903,1968,55,104,71,230,0.116869919
Chicago,60647,83094,1371,2728,5611,9710,0.116855609
Houston,77587,15781,645,650,549,1844,0.116849376
Chicago,60642,20865,195,650,1593,2438,0.116846393
Charlotte,28208,40372,1241,1577,1898,4716,0.116813633
Phoenix (Prescott),85040,35644,1362,1389,1412,4163,0.11679385
Boston (Manchester),1702,41084,1337,1915,1546,4798,0.116785123
Oklahoma City,73139,18848,572,795,834,2201,0.116776316
Savannah,29906,26882,816,1263,1060,3139,0.116769586
Tucson (Sierra Vista),85706,54306,2192,2198,1950,6340,0.116745848
Los Angeles,92392,64664,2721,2663,2165,7549,0.116741928
Atlanta,30168,27176,979,1084,1109,3172,0.116720636
Las Vegas,89156,30846,1225,1220,1155,3600,0.116708812
Sioux City,51244,60,4,2,1,7,0.116666667
Marquette,49930,7046,232,347,243,822,0.116661936
Salt Lake City,84096,74767,3328,2585,2809,8722,0.116655744
Anchorage,99508,34170,1149,1392,1445,3986,0.116652034
Houston,77506,34473,1478,1378,1165,4021,0.11664201
Harlingen-Wslco-Brnsvl-Mca,78586,49967,2283,2025,1520,5828,0.11663698
Savannah,31415,10565,483,406,343,1232,0.116611453
Paducah-Cape Girard-Harsbg,62963,506,21,21,17,59,0.116600791
Los Angeles,91766,68554,2446,2745,2802,7993,0.116594218
Los Angeles,92505,51581,1840,2056,2116,6012,0.116554545
Honolulu,96786,44292,1050,2182,1930,5162,0.116544748
Minneapolis-St. Paul,56304,16844,455,796,712,1963,0.116540014
Kansas City,66214,14152,361,497,791,1649,0.116520633
Harlingen-Wslco-Brnsvl-Mca,78539,39403,1283,1617,1691,4591,0.116513971
Lubbock,79360,19174,840,787,607,2234,0.116511943
Fresno-Visalia,93247,18439,836,718,594,2148,0.116492218
San Diego,92173,29836,1150,1195,1130,3475,0.116470036
Springfield-Holyoke,1103,3023,56,134,162,352,0.116440622
Houston,77530,34411,1438,1375,1193,4006,0.116416262
Dallas-Ft. Worth,75082,29315,677,1045,1690,3412,0.116390926
Detroit,48210,26437,1178,1021,878,3077,0.116389908
Seattle-Tacoma,98444,37568,1268,1676,1428,4372,0.116375639
Joplin-Pittsburg,64801,36104,1318,1507,1376,4201,0.116358298
Houston,77005,27969,1310,1372,572,3254,0.116343094
Oklahoma City,73149,7306,238,282,330,850,0.116342732
Evansville,47714,32518,1154,1384,1245,3783,0.116335568
Las Vegas,89030,55084,2255,2269,1884,6408,0.116331421
San Antonio,78240,57211,1228,2122,3305,6655,0.116323784
Los Angeles,92551,35087,1366,1465,1250,4081,0.116310884
Houston,77547,9365,412,364,313,1089,0.116284036
Yuma-El Centro,85350,19547,863,813,597,2273,0.116283829
Savannah,30445,2881,137,122,76,335,0.11627907
Dallas-Ft. Worth,75057,14888,499,577,655,1731,0.116268135
"Albany, GA",31707,23388,898,969,852,2719,0.1162562
Bismarck-Mnt-Dcknsn(Wlstn),59255,3544,184,138,90,412,0.116252822
Dallas-Ft. Worth,75234,37542,983,1508,1873,4364,0.116243141
San Francisco-Oak-San Jose,94158,10929,117,359,794,1270,0.116204593
Fresno-Visalia,93272,3477,165,129,110,404,0.11619212
"Columbus, OH",43228,59910,1839,2222,2899,6960,0.116174261
Billings,59050,1541,79,59,41,179,0.116158339
Philadelphia,19144,43321,1308,1800,1924,5032,0.116156137
Los Angeles,92277,29590,709,1589,1139,3437,0.116154106
Fresno-Visalia,93648,15705,706,609,509,1824,0.116141356
Los Angeles,92301,40115,1758,1512,1389,4659,0.116141094
"Columbia, SC",29033,13055,315,506,695,1516,0.11612409
Albuquerque-Santa Fe,87421,887,48,35,20,103,0.116121759
Phoenix (Prescott),85392,40396,1444,1576,1670,4690,0.116100604
Davenport-R.Island-Moline,61201,36488,1496,1653,1087,4236,0.116092962
Ft. Myers-Naples,34142,37055,1654,1584,1063,4301,0.116070706
Providence-New Bedford,2907,29518,1093,1194,1139,3426,0.116064774
Waco-Temple-Bryan,76704,8461,277,334,371,982,0.116061931
Los Angeles,92337,36083,1406,1425,1356,4187,0.116038023
Kansas City,66049,33033,905,1295,1633,3833,0.11603548
Fresno-Visalia,93668,1043,40,46,35,121,0.116011505
Los Angeles,90023,44275,1670,1805,1661,5136,0.116002259
Rapid City,57783,17905,662,825,590,2077,0.116001117
Ft. Myers-Naples,33973,14121,568,550,520,1638,0.115997451
"Portland, OR",97116,29978,1240,1244,993,3477,0.115985056
Dallas-Ft. Worth,76105,23271,1059,934,706,2699,0.115981264
Grand Rapids-Kalmzoo-B.Crk,49512,19581,548,823,900,2271,0.115979776
Birmingham (Ann and Tusc),35243,22841,551,795,1302,2648,0.115931877
Dallas-Ft. Worth,75240,28826,900,1180,1261,3341,0.11590231
Waco-Temple-Bryan,76513,47378,2105,2151,1235,5491,0.115897674
Fresno-Visalia,93630,22005,981,865,704,2550,0.115882754
Cedar Rapids-Wtrlo-IWC&Dub,52001,43242,1437,1863,1711,5011,0.115882707
Yakima-Pasco-Rchlnd-Knnwck,98948,13895,620,534,456,1610,0.115869018
Chicago,60623,88820,3555,3497,3237,10289,0.115841027
Denver,80211,39757,505,1241,2859,4605,0.115828659
Chicago,60187,29411,1250,1410,746,3406,0.115807011
Boston (Manchester),2155,60151,1578,2133,3253,6964,0.115775299
Harlingen-Wslco-Brnsvl-Mca,78566,25075,1121,1014,768,2903,0.115772682
Los Angeles,92374,45739,1908,1841,1546,5295,0.115765539
Cincinnati,45208,19799,407,681,1204,2292,0.115763422
Dallas-Ft. Worth,75246,2488,41,104,143,288,0.115755627
Fresno-Visalia,95341,37951,1678,1519,1191,4388,0.115622777
San Diego,92111,49591,1463,2024,2246,5733,0.115605654
Waco-Temple-Bryan,76542,57897,2064,2280,2348,6692,0.115584573
Dallas-Ft. Worth,75227,60754,2370,2426,2226,7022,0.115580867
Dallas-Ft. Worth,75067,70778,2073,2901,3198,8172,0.115459606
Fresno-Visalia,93257,81192,3518,3234,2622,9374,0.115454725
Salt Lake City,84401,50081,1675,1915,2191,5781,0.115432999
Albany-Schenectady-Troy,12183,2911,68,123,145,336,0.115424253
Utica,13333,26,1,1,1,3,0.115384615
Shreveport,71452,26,1,1,1,3,0.115384615
Oklahoma City,73770,26,1,1,1,3,0.115384615
Anchorage,99503,13321,310,571,656,1537,0.115381728
Harrisburg-Lncstr-Leb-York,17401,18480,681,738,713,2132,0.115367965
Topeka,66441,26559,770,991,1303,3064,0.115365789
Marquette,49855,32763,759,1727,1293,3779,0.115343528
Waco-Temple-Bryan,77802,26703,681,1176,1223,3080,0.115342845
Burlington-Plattsburgh,5446,17784,703,865,483,2051,0.115328385
Greenwood-Greenville,38754,1249,64,52,28,144,0.115292234
Sacramnto-Stkton-Modesto,95206,70050,3018,2790,2267,8075,0.115274804
Grand Rapids-Kalmzoo-B.Crk,49423,48035,1909,2258,1370,5537,0.115270116
Houston,77019,28279,455,933,1871,3259,0.115244528
Houston,77065,37053,1136,1571,1563,4270,0.115240331
New York,11432,65050,2629,2616,2251,7496,0.115234435
Corpus Christi,78406,2482,123,106,57,286,0.115229654
Orlando-Daytona Bch-Melbrn,32792,52818,1348,2224,2514,6086,0.11522587
Davenport-R.Island-Moline,52803,22069,750,1024,768,2542,0.115184195
Kansas City,64137,9640,191,365,554,1110,0.115145228
Cincinnati,45203,2536,64,81,147,292,0.115141956
Santabarbra-Sanmar-Sanluob,93108,12368,555,640,229,1424,0.115135834
Tyler-Longview(Lfkn&Ncgd),75702,26865,1145,1045,903,3093,0.115131212
Baltimore,21402,973,40,44,28,112,0.115107914
New York,10030,28696,712,1071,1520,3303,0.11510315
New York,10454,39486,1398,1586,1560,4544,0.115078762
Monterey-Salinas,93925,1434,65,60,40,165,0.115062762
"Washington, DC (Hagrstwn)",20653,25804,879,1066,1024,2969,0.115059681
Salt Lake City,84108,20662,579,869,929,2377,0.115042106
Bakersfield,93304,51017,2078,1937,1854,5869,0.115040085
Las Vegas,89119,50547,1422,2246,2146,5814,0.115021663
Memphis,38617,1478,54,54,62,170,0.115020298
Cleveland-Akron (Canton),44118,38143,1409,1468,1509,4386,0.114988333
"Portland, OR",97301,57657,2257,2245,2126,6628,0.114955686
Birmingham (Ann and Tusc),35213,14232,328,442,866,1636,0.11495222
Davenport-R.Island-Moline,61462,10570,485,464,266,1215,0.114947966
Omaha,68107,31249,1353,1226,1013,3592,0.114947678
Cheyenne-Scottsbluff,82244,496,21,23,13,57,0.114919355
"Jackson, MS",39157,26177,879,1017,1112,3008,0.114910036
West Palm Beach-Ft. Pierce,34947,14848,511,605,590,1706,0.114897629
Los Angeles,93033,78010,3240,3041,2682,8963,0.114895526
Dallas-Ft. Worth,75150,64968,2362,2599,2502,7463,0.114871937
Tampa-St. Pete (Sarasota),33616,18499,385,647,1093,2125,0.114871074
Salt Lake City,84308,296,15,11,8,34,0.114864865
Dallas-Ft. Worth,76102,15053,149,581,999,1729,0.114860825
Sioux Falls(Mitchell),57107,13576,470,465,624,1559,0.114835003
Little Rock-Pine Bluff,72032,35708,1256,1533,1311,4100,0.114820208
Atlanta,30305,32949,600,1034,2149,3783,0.114813803
Dallas-Ft. Worth,75050,43168,1449,1731,1775,4955,0.114784099
Wichita-Hutchinson Plus,67213,21011,772,819,820,2411,0.114749417
Tulsa,74119,3948,55,150,248,453,0.114741641
Chattanooga,37404,13274,437,481,605,1523,0.114735573
Chicago,60085,70772,2632,2850,2633,8115,0.114663991
Kansas City,64158,6672,222,273,270,765,0.114658273
San Francisco-Oak-San Jose,94105,15999,124,585,1125,1834,0.114632165
Milwaukee,53144,26370,922,1108,991,3021,0.114562002
Salt Lake City,84119,55151,1845,2209,2264,6318,0.114558213
Wilkes Barre-Scranton-Hztn,18509,13583,505,542,509,1556,0.114554958
Phoenix (Prescott),85041,69639,2946,2661,2370,7977,0.114547883
Detroit,48120,7901,290,315,300,905,0.114542463
Salt Lake City,84044,32940,1310,1200,1263,3773,0.114541591
Boston (Manchester),1970,45464,1445,1965,1797,5207,0.114530178
Indianapolis,46254,39986,1320,1588,1670,4578,0.114490072
New York,7522,22439,752,876,941,2569,0.114488168
Hartford & New Haven,6119,15085,361,584,782,1727,0.114484587
Des Moines-Ames,50266,40657,978,1446,2230,4654,0.114469833
Denver,80223,23037,533,862,1242,2637,0.11446803
Fresno-Visalia,95303,734,29,32,23,84,0.114441417
Milwaukee,53215,58802,2530,2338,1860,6728,0.114417877
Philadelphia,18018,33354,1100,1478,1238,3816,0.114409066
Dallas-Ft. Worth,76018,27761,1028,1096,1052,3176,0.114405101
Wichita-Hutchinson Plus,67901,20595,881,819,656,2356,0.114396698
Atlanta,30067,47469,1280,1981,2168,5429,0.114369378
Atlanta,30340,30441,962,1257,1262,3481,0.114352354
Fresno-Visalia,95374,1749,85,68,47,200,0.114351058
Marquette,49921,446,11,19,21,51,0.114349776
Salt Lake City,84042,11780,531,459,357,1347,0.11434635
Grand Rapids-Kalmzoo-B.Crk,49519,28541,786,1010,1467,3263,0.114326758
New York,11207,100751,2993,3927,4597,11517,0.11431152
Laredo,78040,37304,1557,1442,1265,4264,0.114304096
El Paso (Las Cruces),79925,38637,1220,1618,1578,4416,0.114294588
Cedar Rapids-Wtrlo-IWC&Dub,52404,44305,1585,1842,1635,5062,0.11425347
Santabarbra-Sanmar-Sanluob,93109,12070,416,585,378,1379,0.114250207
Detroit,48226,6495,38,178,526,742,0.114241724
Austin,78753,57583,1603,2170,2805,6578,0.114235104
El Paso (Las Cruces),79927,44361,1908,1695,1464,5067,0.114221952
San Francisco-Oak-San Jose,94621,35014,1322,1346,1330,3998,0.114182898
San Diego,92058,32273,846,1577,1262,3685,0.114182134
Minneapolis-St. Paul,55130,18472,736,687,686,2109,0.114172802
Orlando-Daytona Bch-Melbrn,34747,35661,963,1350,1758,4071,0.114158324
Phoenix (Prescott),85201,47023,1496,1857,2015,5368,0.114156902
El Paso (Las Cruces),88002,841,17,37,42,96,0.114149822
Salt Lake City,84070,31655,967,1105,1541,3613,0.114136787
Las Vegas,89110,71983,2880,2808,2527,8215,0.114124168
Oklahoma City,73128,6390,208,251,270,729,0.114084507
Monterey-Salinas,95012,11589,459,460,403,1322,0.114073691
New York,7108,30166,1036,1145,1260,3441,0.114068819
Los Angeles,92555,45842,1715,1823,1691,5229,0.114065704
Houston,77545,30362,1243,1157,1063,3463,0.114057045
Chattanooga,37405,18133,348,619,1101,2068,0.114046214
Bakersfield,93305,38936,1592,1504,1344,4440,0.114033285
Pittsburgh,15417,8331,356,380,214,950,0.114031929
New Orleans,70115,31240,671,1214,1677,3562,0.114020487
Dallas-Ft. Worth,75052,105348,3875,4095,4041,12011,0.114012606
Orlando-Daytona Bch-Melbrn,34734,4070,129,143,192,464,0.114004914
Charlotte,28137,3342,144,164,73,381,0.114003591
Boston (Manchester),3431,24065,869,1106,768,2743,0.113982963
Los Angeles,92405,30920,1091,1187,1245,3523,0.113939198
Atlanta,30504,28125,942,1106,1156,3204,0.11392
Houston,77093,47333,2077,1826,1489,5392,0.113916295
Greensboro-H.Point-W.Salem,27407,49326,1432,2036,2151,5619,0.113915582
Sioux Falls(Mitchell),57652,562,23,23,18,64,0.113879004
Waco-Temple-Bryan,76504,26783,802,1010,1238,3050,0.113878206
New York,10455,40978,1446,1604,1616,4666,0.113865977
St. Louis,63141,21605,918,902,640,2460,0.113862532
Dallas-Ft. Worth,75034,56105,1769,2089,2530,6388,0.113857945
Santabarbra-Sanmar-Sanluob,93401,31480,695,1476,1413,3584,0.113850064
Houston,77477,37137,1201,1490,1537,4228,0.113848722
San Angelo,76904,38473,1285,1626,1468,4379,0.113820082
Green Bay-Appleton,54302,31216,1090,1260,1203,3553,0.113819836
Dallas-Ft. Worth,76120,20102,580,758,950,2288,0.11381952
Columbia-Jefferson City,65203,62392,1923,2756,2422,7101,0.113812668
Dallas-Ft. Worth,75249,14964,580,577,546,1703,0.113806469
Spokane,99207,33452,917,1469,1421,3807,0.113804855
Los Angeles,93036,49691,1773,1924,1957,5654,0.11378318
Houston,77037,18712,799,735,595,2129,0.113777255
Los Angeles,90744,50621,1981,1967,1811,5759,0.113767014
Chicago,46327,10812,423,433,374,1230,0.113762486
Los Angeles,90022,61917,2351,2403,2289,7043,0.113749051
Philadelphia,8105,26941,1100,1007,957,3064,0.113730003
Fresno-Visalia,93725,26906,1104,1047,909,3060,0.11372928
"Washington, DC (Hagrstwn)",20910,46615,882,1670,2749,5301,0.11371876
Oklahoma City,73159,34788,1237,1344,1375,3956,0.113717374
Fargo,58075,9614,379,410,304,1093,0.113688371
Seattle-Tacoma,98103,55470,765,1587,3954,6306,0.113683072
Wichita-Hutchinson Plus,67210,9493,343,367,369,1079,0.113662699
Cleveland-Akron (Canton),44017,17906,729,827,479,2035,0.113649056
Charlotte,28212,39194,1255,1520,1679,4454,0.113639843
Los Angeles,90037,61047,2151,2376,2409,6936,0.113617377
Cleveland-Akron (Canton),44234,3952,176,196,77,449,0.11361336
Eureka,95546,3644,167,138,109,414,0.113611416
New York,10456,91206,3276,3592,3494,10362,0.113610947
"Washington, DC (Hagrstwn)",22601,29970,1110,1139,1155,3404,0.113580247
Denver,80229,54253,1830,2104,2228,6162,0.113578973
Denver,80231,36867,791,1400,1996,4187,0.113570402
Ft. Wayne,46772,3760,181,143,103,427,0.11356383
Los Angeles,91764,58118,1992,2228,2380,6600,0.113562063
New York,7206,30301,1193,1166,1082,3441,0.113560609
Dallas-Ft. Worth,76002,37393,1513,1425,1308,4246,0.113550665
Wichita-Hutchinson Plus,67063,3602,168,189,52,409,0.113548029
Kansas City,64124,12322,446,490,463,1399,0.113536764
Los Angeles,90280,90974,3270,3578,3480,10328,0.113526942
Milwaukee,53210,24699,999,988,817,2804,0.113526863
Houston,77521,70879,2642,2638,2766,8046,0.113517403
Yuma-El Centro,92274,20606,910,807,622,2339,0.113510628
Sacramnto-Stkton-Modesto,95205,40379,1750,1627,1206,4583,0.113499591
Laredo,78344,326,13,15,9,37,0.113496933
Los Angeles,92703,67168,2458,2749,2416,7623,0.113491544
Salt Lake City,84081,55097,2539,1973,1741,6253,0.113490753
Minneapolis-St. Paul,56601,35395,1279,1502,1236,4017,0.113490606
Providence-New Bedford,2766,19120,801,933,435,2169,0.113441423
Billings,59022,2195,100,87,62,249,0.113439636
Boston (Manchester),2121,27575,1001,1079,1048,3128,0.113436083
Seattle-Tacoma,98337,8376,177,412,361,950,0.113419293
Raleigh-Durham (Fayetvlle),27610,82035,3143,3252,2908,9303,0.113402816
Lincoln & Hastings-Krny,68531,97,3,5,3,11,0.113402062
Los Angeles,92278,485,8,29,18,55,0.113402062
Salt Lake City,84120,50181,1949,1925,1816,5690,0.11338953
Oklahoma City,73127,27916,1086,1072,1007,3165,0.113375842
Paducah-Cape Girard-Harsbg,62887,247,7,16,5,28,0.113360324
Orlando-Daytona Bch-Melbrn,32835,47300,1267,1982,2112,5361,0.113340381
Denver,81648,2647,149,88,63,300,0.113335852
"Washington, DC (Hagrstwn)",22448,750,21,34,30,85,0.113333333
Atlanta,30507,29807,1159,1193,1025,3377,0.113295535
Roanoke-Lynchburg,24521,10629,547,425,232,1204,0.113275002
Fresno-Visalia,93270,5703,233,234,179,646,0.113273716
Chicago,46320,13702,498,548,506,1552,0.113268136
Wilmington,28480,2490,56,157,69,282,0.113253012
Cincinnati,45229,12354,395,548,456,1399,0.113242674
Monterey-Salinas,93955,31836,1420,971,1214,3605,0.113236588
South Bend-Elkhart,46545,26193,757,998,1211,2966,0.113236361
St. Louis,63144,9045,159,334,531,1024,0.113211719
Los Angeles,92364,106,4,5,3,12,0.113207547
Seattle-Tacoma,98315,5654,110,286,244,640,0.113194199
Fresno-Visalia,93635,52362,2302,2056,1569,5927,0.113192773
Peoria-Bloomington,61701,34658,1135,1447,1341,3923,0.113191759
Los Angeles,92401,1520,56,56,60,172,0.113157895
Los Angeles,91303,29861,880,1113,1386,3379,0.11315763
Salt Lake City,84645,2934,144,112,76,332,0.113156101
New York,7055,68539,2836,2712,2207,7755,0.113147259
Phoenix (Prescott),85305,18641,618,638,853,2109,0.113137707
Rapid City,57577,893,36,35,30,101,0.113101904
Watertown,13616,2458,55,106,117,278,0.113100081
Los Angeles,90255,66302,2378,2636,2484,7498,0.113088595
Monterey-Salinas,93927,21015,944,757,675,2376,0.113062099
Detroit,48340,25411,768,1004,1101,2873,0.113061273
Hartford & New Haven,6120,13471,520,559,444,1523,0.113057679
"Rochester, NY",14604,2919,27,150,153,330,0.113052415
Oklahoma City,73129,19393,829,750,613,2192,0.113030475
Detroit,48216,5804,136,223,297,656,0.1130255
Minneapolis-St. Paul,55116,25519,817,1086,981,2884,0.113013833
Portland-Auburn,4102,18485,360,685,1044,2089,0.113010549
Portland-Auburn,4084,7522,343,341,166,850,0.113001861
Sioux Falls(Mitchell),57555,3797,175,135,119,429,0.112983935
Denver,80249,43859,1622,1543,1790,4955,0.112975672
Sacramnto-Stkton-Modesto,95351,47801,2038,1805,1557,5400,0.112968348
Fresno-Visalia,93202,2807,125,102,90,317,0.112931956
St. Louis,63143,9953,184,355,585,1124,0.112930775
Albuquerque-Santa Fe,87323,4277,182,174,127,483,0.112929624
Lansing,49242,14957,611,698,380,1689,0.112923715
Atlanta,30021,24704,842,968,979,2789,0.112896697
Las Vegas,89142,37311,1332,1461,1419,4212,0.11288896
Buffalo,14216,23557,431,838,1390,2659,0.112875154
Norfolk-Portsmth-Newpt Nws,23666,53618,1368,2019,2665,6052,0.112872543
Yakima-Pasco-Rchlnd-Knnwck,98930,15593,708,584,468,1760,0.11287116
"Portland, OR",97305,46469,1673,1806,1766,5245,0.112870946
Ft. Wayne,46808,20042,642,762,858,2262,0.112862988
Dallas-Ft. Worth,76137,60902,1988,2211,2674,6873,0.112853437
Fairbanks,99701,18431,497,757,826,2080,0.112853345
Seattle-Tacoma,98499,33346,943,1262,1558,3763,0.112847118
Chicago,60506,49682,1840,1935,1831,5606,0.112837647
Nashville,37013,111093,3541,4160,4833,12534,0.11282439
Wichita-Hutchinson Plus,67101,6427,268,242,215,725,0.112805352
Fresno-Visalia,93610,23392,739,878,1021,2638,0.112773598
Dallas-Ft. Worth,75172,6580,268,232,242,742,0.112765957
Charleston-Huntington,25287,1419,29,41,90,160,0.112755462
Harrisburg-Lncstr-Leb-York,17403,41266,1634,1859,1159,4652,0.112732031
Phoenix (Prescott),85335,36468,1503,1291,1317,4111,0.112728968
Las Vegas,89081,45685,1589,1598,1963,5150,0.112728467
Dallas-Ft. Worth,75038,35628,785,1328,1903,4016,0.112720332
Waco-Temple-Bryan,76877,4579,107,185,224,516,0.11268836
Baltimore,21205,14527,469,551,617,1637,0.112686721
Fresno-Visalia,93706,39992,1662,1521,1323,4506,0.112672535
Sherman-Ada,74701,26626,943,982,1075,3000,0.112671825
Monterey-Salinas,95019,6453,279,255,193,727,0.112660778
St. Louis,62225,5113,109,224,243,576,0.112654019
Harlingen-Wslco-Brnsvl-Mca,78520,66248,2755,2545,2163,7463,0.112652457
Columbia-Jefferson City,65401,32345,1096,1545,1002,3643,0.112629464
Fresno-Visalia,93703,34907,1378,1292,1261,3931,0.112613516
New York,6608,14448,511,583,533,1627,0.112610742
Dallas-Ft. Worth,75134,21591,861,841,729,2431,0.11259321
"Columbus, OH",43222,3935,131,139,173,443,0.112579416
Lincoln & Hastings-Krny,68502,24961,736,980,1094,2810,0.112575618
El Paso (Las Cruces),79938,95871,3945,3518,3329,10792,0.11256793
Greenvll-Spart-Ashevll-And,29325,14294,590,623,396,1609,0.112564712
Fresno-Visalia,93239,1377,60,50,45,155,0.112563544
San Diego,92104,44714,656,1655,2722,5033,0.112559825
Casper-Riverton,82510,1155,50,45,35,130,0.112554113
Houston,77084,113489,3933,4293,4547,12773,0.112548353
San Francisco-Oak-San Jose,94117,37603,601,994,2637,4232,0.112544212
New Orleans,70113,8859,229,314,454,997,0.112540919
San Antonio,78245,104294,3890,3837,4009,11736,0.112528046
"Washington, DC (Hagrstwn)",20374,1413,12,51,96,159,0.112526539
Louisville,40155,1031,31,34,51,116,0.112512124
Houston,77076,32185,1309,1184,1128,3621,0.112505826
"Columbus, GA (Opelika, AL)",31909,40186,1349,1479,1693,4521,0.112501866
Salt Lake City,84063,409,20,12,14,46,0.112469438
Los Angeles,92802,41221,1364,1605,1667,4636,0.112466946
El Paso (Las Cruces),88021,16565,660,661,542,1863,0.112466043
New York,10460,59405,2132,2233,2316,6681,0.112465281
Denver,80011,54577,1886,2167,2085,6138,0.112464958
Charlotte,28216,59471,2002,2151,2535,6688,0.112458173
Los Angeles,91331,96086,3502,3763,3540,10805,0.112451346
Minneapolis-St. Paul,55106,57886,2176,2188,2145,6509,0.112445151
Rockford,61104,16551,579,656,626,1861,0.112440336
Los Angeles,90716,14010,511,522,542,1575,0.1124197
Seattle-Tacoma,98813,2553,127,89,71,287,0.112416765
Lincoln & Hastings-Krny,68514,258,8,12,9,29,0.112403101
"Columbus, OH",43219,32314,1094,1265,1273,3632,0.112397103
San Antonio,78227,44363,1702,1737,1547,4986,0.112390956
Springfield-Holyoke,1105,11354,385,438,453,1276,0.112383301
Mobile-Pensacola (Ft Walt),32514,41045,1058,1759,1795,4612,0.112364478
Austin,78735,21761,517,890,1038,2445,0.112356969
Jacksonville,32246,60098,1510,2169,3073,6752,0.112349829
Sioux City,51106,29011,1128,1087,1044,3259,0.1123367
Los Angeles,91402,71210,2533,2771,2695,7999,0.112329729
Houston,77066,37640,1346,1519,1362,4227,0.112300744
Los Angeles,90044,90414,3432,3421,3298,10151,0.112272436
Ft. Smith-Fay-Sprngdl-Rgrs,72764,65845,2663,2439,2290,7392,0.112263649
Boston (Manchester),1420,42555,1593,1687,1496,4776,0.11223123
Lake Charles,70607,30386,996,1162,1252,3410,0.112222734
Los Angeles,93523,3235,65,122,176,363,0.112210201
Little Rock-Pine Bluff,72209,31210,1200,1193,1109,3502,0.112207626
Indianapolis,46135,20299,738,1109,430,2277,0.112173013
Denver,80010,43398,1554,1705,1609,4868,0.112171068
Phoenix (Prescott),86022,1783,78,60,62,200,0.112170499
New York,10801,43582,1484,1839,1564,4887,0.11213345
Waco-Temple-Bryan,77803,32533,1313,1162,1173,3648,0.112132296
Dayton,45431,26710,701,968,1326,2995,0.112130288
Monterey-Salinas,93906,67129,2577,2572,2378,7527,0.112127397
Ft. Wayne,46767,8767,346,342,295,983,0.112125014
Chattanooga,37415,25226,490,967,1371,2828,0.112106557
"Jackson, MS",39191,8172,454,267,195,916,0.112090064
Dallas-Ft. Worth,75039,26587,322,730,1928,2980,0.112084853
New York,10453,79053,2790,3011,3059,8860,0.112076708
Houston,77025,31313,651,1217,1641,3509,0.112062083
Harlingen-Wslco-Brnsvl-Mca,78560,5346,216,210,173,599,0.11204639
Tampa-St. Pete (Sarasota),33647,75444,2416,2854,3182,8452,0.112030115
El Paso (Las Cruces),79912,78613,2409,3035,3363,8807,0.112029817
Chicago,60639,85425,3162,3292,3116,9570,0.112028095
Kansas City,66006,8590,404,383,175,962,0.111990687
Norfolk-Portsmth-Newpt Nws,23462,69283,1969,2672,3118,7759,0.111989954
New York,11249,41986,1016,1363,2323,4702,0.111989711
Los Angeles,90805,91571,3235,3453,3567,10255,0.111989604
Fresno-Visalia,93615,5448,250,192,168,610,0.111967695
New York,11219,95495,3404,3947,3341,10692,0.111963977
"Rochester, NY",14605,12148,407,498,455,1360,0.111952585
Grand Junction-Montrose,81520,13615,501,505,518,1524,0.111935365
Sioux Falls(Mitchell),57105,22942,796,933,839,2568,0.111934443
Phoenix (Prescott),85015,41285,1306,1586,1729,4621,0.111929272
Memphis,38141,21766,899,806,731,2436,0.11191767
El Paso (Las Cruces),79936,104101,3668,4034,3948,11650,0.111910548
Chicago,60622,53806,635,1367,4019,6021,0.111902018
Los Angeles,90220,48498,1830,1857,1740,5427,0.111901522
Denver,80305,16599,462,745,650,1857,0.111874209
Ft. Wayne,46802,10844,252,412,549,1213,0.111859093
Ft. Wayne,46571,5856,269,203,183,655,0.111851093
Chicago,60609,60703,2342,2388,2059,6789,0.111839613
Los Angeles,91763,37485,1330,1422,1440,4192,0.111831399
Fresno-Visalia,93609,5723,256,205,179,640,0.11182946
San Diego,92069,48701,1691,1824,1930,5445,0.111804686
Atlanta,30045,43586,1756,1559,1558,4873,0.111801955
New York,8701,146017,6044,5432,4847,16323,0.111788353
Green Bay-Appleton,54311,38172,1424,1621,1222,4267,0.111783506
Los Angeles,92324,57004,2062,2172,2138,6372,0.111781629
"Portland, OR",97239,19012,259,565,1301,2125,0.111771513
Fresno-Visalia,93621,510,18,18,21,57,0.111764706
Wichita-Hutchinson Plus,67214,16241,608,629,578,1815,0.111754202
Los Angeles,92309,349,13,15,11,39,0.111747851
New York,10459,50498,1777,2002,1864,5643,0.111747
Milwaukee,53186,32172,1012,1334,1249,3595,0.111743131
Springfield-Holyoke,1107,10856,426,438,349,1213,0.111735446
Greensboro-H.Point-W.Salem,27405,55203,2108,2201,1858,6167,0.111714943
Cincinnati,45226,5783,113,234,299,646,0.111706727
Salt Lake City,84511,4861,203,185,155,543,0.11170541
New York,8904,14986,382,492,800,1674,0.111704257
New York,10457,75924,2690,2888,2902,8480,0.111690638
Oklahoma City,73110,33316,1138,1214,1369,3721,0.111688078
Houston,77083,73415,2700,2808,2691,8199,0.111680174
"Columbus, OH",45764,7988,280,358,254,892,0.111667501
Portland-Auburn,4901,26773,963,1267,759,2989,0.111642326
Pittsburgh,15211,10892,123,332,761,1216,0.111641572
Shreveport,71104,12973,375,487,586,1448,0.111616434
Des Moines-Ames,50023,46940,1712,1702,1824,5238,0.111589263
Los Angeles,92415,2796,114,94,104,312,0.111587983
Santabarbra-Sanmar-Sanluob,93434,8487,387,313,247,947,0.11158242
Cincinnati,45205,18867,768,694,643,2105,0.111570467
Los Angeles,92344,25025,1059,973,760,2792,0.111568432
Los Angeles,91767,50002,1643,2055,1880,5578,0.111555538
Chicago,46323,22056,774,874,812,2460,0.111534276
New York,10950,67798,2938,2567,2056,7561,0.111522464
Syracuse,13035,8151,365,381,163,909,0.111520059
Chicago,60505,55145,2280,2087,1782,6149,0.11150603
Bangor,4468,9094,232,407,375,1014,0.111502089
San Francisco-Oak-San Jose,94706,20872,960,659,708,2327,0.111489076
Dallas-Ft. Worth,76140,32804,1388,1210,1059,3657,0.111480307
Houston,77053,31319,1288,1180,1023,3491,0.111465883
Houston,77058,17928,395,684,919,1998,0.111445783
Springfield-Holyoke,1108,27287,983,1020,1038,3041,0.11144501
Harlingen-Wslco-Brnsvl-Mca,78516,35977,1511,1374,1124,4009,0.111432304
Memphis,38118,38619,1491,1427,1385,4303,0.111421839
Dallas-Ft. Worth,75208,30509,800,1130,1469,3399,0.111409748
New York,10303,28092,988,1076,1065,3129,0.111384024
Chicago,60624,35968,1334,1344,1328,4006,0.111376779
Austin,78656,2748,129,112,65,306,0.111353712
Salt Lake City,84041,59303,2315,2051,2237,6603,0.11134344
Green Bay-Appleton,54971,10852,523,436,249,1208,0.111315886
Los Angeles,92404,64699,2392,2382,2428,7202,0.111315476
San Diego,92106,21284,783,936,650,2369,0.111304266
Los Angeles,92570,60542,2321,2312,2105,6738,0.111294638
Dallas-Ft. Worth,75243,59511,1556,2392,2675,6623,0.11129035
Wichita-Hutchinson Plus,67218,22734,714,876,940,2530,0.111287059
Denver,80021,38631,750,1228,2321,4299,0.111283684
Austin,78719,2004,86,73,64,223,0.111277445
Sioux City,50588,13167,598,500,367,1465,0.111263006
San Diego,92102,39918,1082,1502,1857,4441,0.111253069
Lexington,40403,28997,1116,1253,857,3226,0.111252888
San Francisco-Oak-San Jose,94603,34763,1292,1325,1250,3867,0.111238961
Philadelphia,8104,21450,859,810,717,2386,0.111235431
Austin,78617,32096,1352,1224,994,3570,0.111228814
Grand Rapids-Kalmzoo-B.Crk,49001,21893,756,821,858,2435,0.111222765
Baltimore,21117,61262,2145,2457,2211,6813,0.111210865
"Columbus, OH",43240,8930,195,253,545,993,0.111198208
Fargo,58103,49147,1103,1930,2432,5465,0.111197021
Oklahoma City,73108,14327,579,528,486,1593,0.111188665
New York,10128,59074,1142,2022,3404,6568,0.111182585
San Antonio,78244,39444,1493,1405,1487,4385,0.111170267
Sherman-Ada,75090,26461,1070,1003,868,2941,0.111144704
Los Angeles,92509,79812,2975,3142,2752,8869,0.111123641
Harrisburg-Lncstr-Leb-York,17232,27,1,1,1,3,0.111111111
Phoenix (Prescott),85009,49691,1906,1942,1673,5521,0.111106639
Yuma-El Centro,92231,38533,1466,1536,1279,4281,0.111099577
Waco-Temple-Bryan,77807,14096,452,502,612,1566,0.111095346
Dallas-Ft. Worth,76111,24108,919,908,851,2678,0.111083458
Houston,77449,141966,5413,5200,5157,15770,0.111082935
Boston (Manchester),3104,34101,946,1386,1456,3788,0.111081786
Ft. Smith-Fay-Sprngdl-Rgrs,72904,21936,861,824,751,2436,0.111050328
"Columbus, OH",43209,27442,1084,1217,746,3047,0.111034181
Portland-Auburn,4038,18573,897,772,393,2062,0.111021375
Detroit,48326,22266,406,894,1172,2472,0.111021288
Raleigh-Durham (Fayetvlle),28311,36955,1145,1340,1617,4102,0.110999865
Salt Lake City,84128,30992,1263,1078,1098,3439,0.11096412
Honolulu,96822,42232,1256,1891,1539,4686,0.110958515
Harrisburg-Lncstr-Leb-York,17013,38727,1439,1795,1063,4297,0.11095618
Denver,80206,26058,318,928,1645,2891,0.110944815
Los Angeles,92801,61799,2000,2297,2559,6856,0.110940306
New York,10028,49021,861,1466,3111,5438,0.11093205
Charlotte,28273,48317,1384,1703,2272,5359,0.110913343
New York,10002,71492,1357,2625,3947,7929,0.110907514
Monterey-Salinas,93930,16176,714,593,487,1794,0.110905045
New York,7107,40965,1463,1541,1539,4543,0.110899548
Fresno-Visalia,93616,2083,77,87,67,231,0.110897744
Montgomery-Selma,36116,43290,1427,1523,1850,4800,0.110880111
Baltimore,21239,27170,797,1042,1173,3012,0.110857563
Philadelphia,19904,39312,1300,1718,1340,4358,0.110856736
San Francisco-Oak-San Jose,95126,39098,954,1482,1898,4334,0.11084966
Philadelphia,19087,34056,2070,1031,674,3775,0.11084684
San Antonio,78238,24918,743,898,1121,2762,0.110843567
Los Angeles,92704,79382,2744,3075,2979,8798,0.110831171
Houston,77061,24390,833,889,980,2702,0.110783108
Cincinnati,45232,7935,292,317,270,879,0.110775047
Billings,59031,650,29,25,18,72,0.110769231
Amarillo,79013,2203,78,88,78,244,0.110758057
Houston,77085,18005,692,711,591,1994,0.110747015
Burlington-Plattsburgh,5061,1806,80,93,27,200,0.110741971
Ft. Myers-Naples,33976,20219,817,719,703,2239,0.110737425
Sacramnto-Stkton-Modesto,95987,6277,269,235,191,695,0.110721682
Great Falls,59417,7750,329,298,231,858,0.110709677
San Diego,92037,41915,909,1954,1777,4640,0.110700227
Kansas City,66219,14310,320,466,798,1584,0.110691824
St. Louis,63138,18378,612,680,742,2034,0.110675808
San Francisco-Oak-San Jose,94027,7256,360,309,134,803,0.110667034
Ft. Wayne,46806,26640,1096,1008,844,2948,0.110660661
Philadelphia,19139,42401,1235,1494,1963,4692,0.110657768
New York,11201,68430,1433,2440,3699,7572,0.110653222
Salt Lake City,84339,6218,307,238,143,688,0.11064651
Tallahassee-Thomasville,31605,24693,853,800,1079,2732,0.110638643
Dallas-Ft. Worth,75149,60108,2420,2306,1923,6649,0.110617555
Indianapolis,46203,38650,1171,1264,1840,4275,0.110608021
Sacramnto-Stkton-Modesto,95210,41246,1574,1527,1461,4562,0.110604665
San Francisco-Oak-San Jose,94109,53491,416,1543,3957,5916,0.110598045
Los Angeles,93030,57745,2190,2172,2024,6386,0.110589661
Peoria-Bloomington,61602,850,20,30,44,94,0.110588235
San Antonio,78219,18827,730,682,670,2082,0.110585861
Buffalo,14211,26776,992,991,978,2961,0.110584105
Dallas-Ft. Worth,75244,15654,366,604,761,1731,0.110578766
Boise,83605,42623,1655,1550,1508,4713,0.110574103
Minneapolis-St. Paul,56258,15411,523,665,516,1704,0.110570372
Savannah,31407,23072,687,798,1066,2551,0.110566921
Fresno-Visalia,95334,17385,642,703,577,1922,0.110555076
Bakersfield,93306,75276,3098,2763,2461,8322,0.110553164
Little Rock-Pine Bluff,72199,199,6,8,8,22,0.110552764
Hartford & New Haven,6519,17035,617,641,625,1883,0.110537129
Cincinnati,45223,13544,355,590,552,1497,0.110528647
Orlando-Daytona Bch-Melbrn,32808,52324,1838,1941,2004,5783,0.110522896
Erie,16412,9012,275,415,306,996,0.110519308
Los Angeles,92606,24062,612,944,1103,2659,0.110506192
Fresno-Visalia,93274,81619,3309,3045,2665,9019,0.110501231
Houston,77029,17188,667,667,565,1899,0.110484059
Cleveland-Akron (Canton),44606,8020,348,283,255,886,0.110473815
Jacksonville,32204,9062,104,318,579,1001,0.110461267
Phoenix (Prescott),85339,58954,2420,2078,2014,6512,0.110459002
El Paso (Las Cruces),79924,59850,2148,2214,2247,6609,0.110426065
Chicago,60475,9790,300,343,438,1081,0.110418795
Dallas-Ft. Worth,75233,15061,532,600,531,1663,0.110417635
Memphis,38637,28367,1063,1045,1024,3132,0.110409983
Kansas City,64161,616,21,26,21,68,0.11038961
Bakersfield,93251,154,7,5,5,17,0.11038961
Dallas-Ft. Worth,75220,39667,1377,1584,1417,4378,0.11036882
Nashville,37211,83079,2202,2849,4118,9169,0.110364833
Memphis,38125,39913,1289,1538,1577,4404,0.110339989
Houston,77503,23990,915,859,873,2647,0.110337641
Denver,80260,34516,1298,1307,1203,3808,0.110325646
Lubbock,79413,21201,688,780,871,2339,0.110324985
Casper-Riverton,82514,1260,61,51,27,139,0.11031746
Fresno-Visalia,93656,6247,278,230,181,689,0.110292941
Minneapolis-St. Paul,55103,13474,467,529,490,1486,0.110286478
Memphis,38673,1070,28,42,48,118,0.110280374
Los Angeles,92706,33059,1114,1299,1232,3645,0.110257419
Portland-Auburn,4240,37839,1586,1466,1120,4172,0.110256614
Phoenix (Prescott),85051,45541,1595,1711,1715,5021,0.1102523
Boston (Manchester),2458,13127,365,655,427,1447,0.110230822
Kansas City,66102,29802,1228,1091,966,3285,0.110227502
Los Angeles,92557,55961,1936,2153,2079,6168,0.110219617
Seattle-Tacoma,98104,18629,157,640,1256,2053,0.11020452
St. Louis,62090,735,25,24,32,81,0.110204082
Cincinnati,45204,5073,175,179,205,559,0.110191208
Orlando-Daytona Bch-Melbrn,34758,46034,1730,1746,1596,5072,0.110179433
El Paso (Las Cruces),79835,12790,474,475,460,1409,0.110164191
Champaign&Sprngfld-Decatur,62703,27518,1004,1181,846,3031,0.110146086
Kansas City,65336,6083,188,194,288,670,0.110143022
Sioux Falls(Mitchell),57548,1489,59,59,46,164,0.110141034
Orlando-Daytona Bch-Melbrn,32789,27603,1054,1128,858,3040,0.110132957
Philadelphia,19124,66874,2477,2486,2402,7365,0.110132488
Dallas-Ft. Worth,75061,53744,1911,2033,1974,5918,0.110114617
Phoenix (Prescott),85283,42618,1021,1401,2270,4692,0.110094326
Fargo,58357,863,36,34,25,95,0.110081112
Lincoln & Hastings-Krny,68505,17206,497,592,805,1894,0.11007788
Houston,77017,30535,1125,1147,1089,3361,0.110070411
Greenvll-Spart-Ashevll-And,29306,17835,654,666,643,1963,0.11006448
Philadelphia,18102,52926,1867,1979,1979,5825,0.110059328
Ft. Wayne,46805,21881,597,824,987,2408,0.110049815
Sacramnto-Stkton-Modesto,95307,46271,1887,1777,1428,5092,0.11004733
New York,10472,68590,2406,2589,2553,7548,0.110045196
Atlanta,30248,32714,1330,1189,1081,3600,0.110044629
Salt Lake City,84026,936,55,18,30,103,0.110042735
Tulsa,74115,24474,1022,909,762,2693,0.110035139
New York,11208,99269,3363,3811,3749,10923,0.110034351
Albany-Schenectady-Troy,12307,7625,278,280,281,839,0.110032787
San Francisco-Oak-San Jose,94801,33711,1272,1270,1167,3709,0.110023434
Philadelphia,19801,16979,494,615,759,1868,0.110018258
Biloxi-Gulfport,39581,11644,396,455,430,1281,0.110013741
Sacramnto-Stkton-Modesto,95382,39292,1374,1408,1540,4322,0.109996946
Salt Lake City,84663,36787,1504,1204,1338,4046,0.109984505
St. Louis,63118,24080,702,887,1059,2648,0.109966777
Dothan,36079,9349,256,320,452,1028,0.109958284
Springfield-Holyoke,1085,41372,1622,1750,1177,4549,0.109953592
Fresno-Visalia,95315,12615,521,474,392,1387,0.109948474
Sacramnto-Stkton-Modesto,95832,11242,462,401,373,1236,0.10994485
Houston,77045,34559,1366,1301,1132,3799,0.109927949
Des Moines-Ames,50257,1119,54,41,28,123,0.109919571
Sioux City,51103,17169,655,694,538,1887,0.109907391
Los Angeles,92394,43903,1780,1591,1454,4825,0.109901373
Bismarck-Mnt-Dcknsn(Wlstn),58757,1010,49,35,27,111,0.10990099
Orlando-Daytona Bch-Melbrn,32948,6779,286,247,212,745,0.109898215
Fresno-Visalia,93637,42185,1702,1529,1405,4636,0.109896883
Philadelphia,8629,13104,466,498,476,1440,0.10989011
"Springfield, MO",65473,15662,424,794,503,1721,0.109883795
San Antonio,78230,41009,1010,1499,1997,4506,0.109878319
Oklahoma City,73142,17378,457,676,776,1909,0.109851536
Detroit,48127,40173,1417,1496,1500,4413,0.109849899
Boston (Manchester),1841,53530,1869,2057,1954,5880,0.109844947
Albuquerque-Santa Fe,88256,2012,83,83,55,221,0.109840954
Amarillo,79029,16663,659,636,535,1830,0.109824161
Nashville,37217,33699,941,1261,1498,3700,0.109795543
Wichita-Hutchinson Plus,67846,34916,1397,1230,1206,3833,0.109777752
Atlanta,30054,13482,560,544,376,1480,0.109775998
Dallas-Ft. Worth,75041,31410,1241,1187,1020,3448,0.109773957
Orlando-Daytona Bch-Melbrn,32714,38388,1047,1483,1684,4214,0.109773888
Atlanta,30291,25498,937,940,922,2799,0.109773316
Los Angeles,90806,40588,1308,1464,1683,4455,0.109761506
Fresno-Visalia,93662,30696,1211,1177,981,3369,0.109753714
Kansas City,66105,2779,112,111,82,305,0.109751709
Sacramnto-Stkton-Modesto,95838,42004,1603,1529,1478,4610,0.109751452
Bismarck-Mnt-Dcknsn(Wlstn),58504,30050,1115,1184,999,3298,0.109750416
Joplin-Pittsburg,64772,12711,444,532,419,1395,0.109747463
Atlanta,30122,24193,759,919,977,2655,0.109742487
Wichita-Hutchinson Plus,67226,21606,592,847,932,2371,0.109738036
New York,11798,17461,637,649,630,1916,0.109730256
Grand Rapids-Kalmzoo-B.Crk,49507,37757,1364,1437,1342,4143,0.109727997
Atlanta,30253,69962,2585,2500,2591,7676,0.109716703
Chattanooga,30721,53803,2106,2030,1766,5902,0.109696485
Dallas-Ft. Worth,75042,38696,1457,1484,1303,4244,0.109675419
Miami-Ft. Lauderdale,33034,25578,990,940,875,2805,0.109664555
Seattle-Tacoma,98204,47308,1330,1813,2044,5187,0.109643189
Madison,53510,1587,64,65,45,174,0.109640832
Boston (Manchester),3609,830,17,43,31,91,0.109638554
Odessa-Midland,79764,26893,1007,1011,930,2948,0.109619604
Chicago,60165,3941,160,142,130,432,0.109616849
Yakima-Pasco-Rchlnd-Knnwck,98947,3193,147,124,79,350,0.109614782
Detroit,48205,33500,1255,1225,1192,3672,0.10961194
Harlingen-Wslco-Brnsvl-Mca,78503,24783,988,936,792,2716,0.109591252
Shreveport,71973,1086,44,45,30,119,0.109576427
Atlanta,30066,63185,2249,2783,1891,6923,0.109567144
Bakersfield,93309,60594,1961,2139,2539,6639,0.109565303
Atlanta,30575,1570,57,58,57,172,0.10955414
Cleveland-Akron (Canton),44691,45165,1274,2471,1203,4948,0.109553858
San Antonio,78226,6134,227,239,206,672,0.109553309
El Paso (Las Cruces),79935,17289,573,634,687,1894,0.109549424
St. Louis,63121,22723,780,928,781,2489,0.109536593
Greenvll-Spart-Ashevll-And,29301,37287,1316,1300,1468,4084,0.10952879
San Antonio,78218,39991,1259,1448,1673,4380,0.109524643
New York,12538,13705,573,532,396,1501,0.109522072
Las Vegas,89183,46064,1384,1703,1958,5045,0.109521535
Louisville,40206,21038,338,771,1195,2304,0.109516114
Houston,77099,49552,1772,1875,1779,5426,0.10950113
Wichita-Hutchinson Plus,67843,137,6,5,4,15,0.109489051
Los Angeles,93534,43222,1516,1574,1642,4732,0.109481283
Los Angeles,91324,28300,709,947,1442,3098,0.109469965
Los Angeles,90032,43093,1420,1678,1619,4717,0.109460933
Cleveland-Akron (Canton),44102,42038,1106,1594,1901,4601,0.109448594
Toledo,45817,6414,280,279,143,702,0.109448082
Nashville,37128,82310,2693,2841,3474,9008,0.109439922
Boston (Manchester),1843,28339,1005,1028,1068,3101,0.109425174
Detroit,48393,19576,442,744,956,2142,0.109419698
Albany-Schenectady-Troy,1247,15162,536,696,427,1659,0.109418283
Omaha,68127,22108,516,730,1173,2419,0.109417405
Kansas City,66202,17404,309,625,970,1904,0.109400138
Cleveland-Akron (Canton),43804,3757,143,137,131,411,0.109395795
Fresno-Visalia,93654,31153,1290,1163,955,3408,0.109395564
Providence-New Bedford,2863,22489,810,850,800,2460,0.109386811
Waco-Temple-Bryan,76707,16520,535,603,669,1807,0.109382567
Honolulu,96863,4242,49,270,145,464,0.109382367
Phoenix (Prescott),85016,38591,720,1401,2100,4221,0.109377834
Fresno-Visalia,93622,10268,434,389,300,1123,0.109368913
Jonesboro,72417,6821,262,193,291,746,0.109368128
Salt Lake City,84083,1335,46,48,52,146,0.109363296
Salt Lake City,84088,37766,1372,1344,1413,4129,0.109331144
Chicago,60110,37675,1499,1406,1214,4119,0.109329794
Oklahoma City,73119,30571,1297,1132,913,3342,0.10931929
El Paso (Las Cruces),87937,3211,118,129,104,351,0.109311741
"Washington, DC (Hagrstwn)",20109,46729,1448,1588,2072,5108,0.109311134
Buffalo,16701,16540,712,694,402,1808,0.109310762
"Portland, OR",97202,43173,1055,1475,2189,4719,0.109304426
Atlanta,30044,94995,3526,3447,3409,10382,0.109289963
Lubbock,79412,14851,547,559,517,1623,0.10928557
Sioux City,51105,9901,387,346,349,1082,0.109281891
Harlingen-Wslco-Brnsvl-Mca,78559,12833,537,451,414,1402,0.109249591
Sacramnto-Stkton-Modesto,95811,12550,95,397,879,1371,0.109243028
Albuquerque-Santa Fe,88340,4010,183,128,127,438,0.109226933
Oklahoma City,73034,49579,1856,2080,1479,5415,0.109219629
New York,6607,9056,327,329,333,989,0.109209364
New York,10452,73841,2566,2814,2683,8063,0.109194079
Milwaukee,53208,28619,949,1099,1077,3125,0.109193193
Butte-Bozeman,59725,8398,323,364,230,917,0.109192665
Macon,31210,35564,1224,1374,1285,3883,0.109183444
Amarillo,79103,10369,399,411,322,1132,0.109171569
Los Angeles,91708,19306,585,661,861,2107,0.109137056
Minneapolis-St. Paul,55429,28772,965,1108,1067,3140,0.10913388
El Paso (Las Cruces),88072,2465,95,104,70,269,0.109127789
Harlingen-Wslco-Brnsvl-Mca,78584,19675,779,738,630,2147,0.109123253
Sacramnto-Stkton-Modesto,95363,30709,1254,1175,922,3351,0.109121105
Buffalo,14226,30288,961,1228,1116,3305,0.109119123
Bismarck-Mnt-Dcknsn(Wlstn),59213,889,43,33,21,97,0.109111361
Fargo,58436,1659,68,69,44,181,0.109101869
Nashville,37219,1769,9,62,122,193,0.109101187
Raleigh-Durham (Fayetvlle),27612,41497,790,1418,2319,4527,0.109092224
"Portland, OR",97310,880,41,46,9,96,0.109090909
New York,7104,53836,1839,2002,2032,5873,0.109090571
Los Angeles,92806,38781,1042,1469,1719,4230,0.109074031
Little Rock-Pine Bluff,72012,13762,603,481,417,1501,0.109068449
St. Louis,63134,12607,425,477,473,1375,0.109066392
Albuquerque-Santa Fe,87801,10068,347,416,335,1098,0.109058403
Kansas City,64126,6566,257,237,222,716,0.109046604
Los Angeles,93591,7438,282,269,260,811,0.109034687
Salisbury,21826,5549,203,182,220,605,0.109028654
Watertown,13602,5054,152,222,177,551,0.109022556
Tucson (Sierra Vista),85757,24081,994,826,805,2625,0.109007101
Los Angeles,92832,26230,696,879,1284,2859,0.108997331
Oklahoma City,73092,578,24,20,19,63,0.10899654
New York,11102,37359,621,1205,2246,4072,0.108996493
Rapid City,57719,11918,426,389,484,1299,0.108994798
Chicago,60501,10891,403,422,362,1187,0.108989074
Yakima-Pasco-Rchlnd-Knnwck,98901,33071,1241,1200,1163,3604,0.108977654
Greenvll-Spart-Ashevll-And,29621,46985,1907,1856,1357,5120,0.108970948
Jonesboro,72404,29947,948,1136,1179,3263,0.108959161
Fresno-Visalia,93612,38740,1199,1438,1583,4220,0.108931337
Amarillo,79045,18352,770,658,571,1999,0.108925458
Yakima-Pasco-Rchlnd-Knnwck,98951,14121,595,510,433,1538,0.108915799
Indianapolis,46231,11312,398,439,395,1232,0.108910891
New York,7030,61758,871,1553,4302,6726,0.108908967
Salt Lake City,84123,38915,1208,1432,1598,4238,0.108904022
Sacramnto-Stkton-Modesto,95328,4417,188,155,138,481,0.108897442
Indianapolis,46235,35486,1379,1266,1219,3864,0.108888012
Jacksonville,32211,37288,1281,1458,1321,4060,0.108882214
Reno,89431,40393,1250,1466,1682,4398,0.108880252
Spokane,98857,3876,167,139,116,422,0.108875129
Harrisburg-Lncstr-Leb-York,17603,66962,2184,2610,2496,7290,0.108867716
Detroit,48108,26886,659,1070,1198,2927,0.108867068
Sioux Falls(Mitchell),57625,1231,50,47,37,134,0.10885459
Atlanta,30071,27304,1066,982,924,2972,0.10884852
"Springfield, MO",65613,18807,751,689,607,2047,0.108842452
Los Angeles,92590,4888,160,179,193,532,0.108837971
Fresno-Visalia,93608,928,38,39,24,101,0.108836207
Tucson (Sierra Vista),85746,43632,1547,1623,1578,4748,0.108819215
San Antonio,78222,24887,976,903,829,2708,0.108811829
Indianapolis,46241,33536,1270,1198,1181,3649,0.108808445
Houston,77063,36519,708,1347,1918,3973,0.108792683
Buffalo,14207,26188,897,1007,945,2849,0.108790286
Denver,80525,57956,1446,2336,2523,6305,0.108789426
Chicago,60087,26538,920,990,977,2887,0.108787399
Houston,77031,17136,550,652,662,1864,0.108776844
Cleveland-Akron (Canton),44307,6803,205,248,287,740,0.10877554
Waco-Temple-Bryan,76522,43146,1499,1576,1618,4693,0.108770222
Chicago,60636,32602,1198,1177,1171,3546,0.108766333
"Columbia, SC",29108,20099,598,1049,539,2186,0.10876163
San Diego,92083,38407,1233,1481,1463,4177,0.108756216
Twin Falls,83346,1508,70,60,34,164,0.108753316
Omaha,68114,18603,426,723,874,2023,0.108745901
Oklahoma City,73109,19725,786,750,609,2145,0.108745247
Waco-Temple-Bryan,76661,8028,213,264,396,873,0.108744395
Sacramnto-Stkton-Modesto,95823,82194,3111,2991,2836,8938,0.108742731
Salt Lake City,84332,9288,405,351,254,1010,0.108742463
Philadelphia,19133,24014,855,919,837,2611,0.108728242
Houston,77082,58090,1637,2108,2571,6316,0.108727836
New York,10075,27106,482,797,1668,2947,0.108721316
Fresno-Visalia,95388,13604,558,506,415,1479,0.108718024
Fresno-Visalia,93286,10026,405,382,303,1090,0.108717335
Seattle-Tacoma,98115,56578,1264,1705,3181,6150,0.108699495
Atlanta,30058,61025,2087,2170,2376,6633,0.108693159
Raleigh-Durham (Fayetvlle),28303,32400,837,1199,1485,3521,0.10867284
Abilene-Sweetwater,79605,29336,974,1112,1102,3188,0.108671939
"Rochester, NY",14527,13070,557,507,356,1420,0.108645754
Salt Lake City,84075,37646,1802,1229,1059,4090,0.108643681
Sacramnto-Stkton-Modesto,95824,30847,1188,1117,1046,3351,0.10863293
Tulsa,74133,50298,1483,1818,2163,5464,0.10863255
Philadelphia,19118,9445,314,400,312,1026,0.108628904
Los Angeles,92567,10421,402,371,359,1132,0.108626811
Sherman-Ada,73460,5036,201,221,125,547,0.108617951
Minneapolis-St. Paul,55102,21774,365,825,1175,2365,0.10861578
Nashville,37206,28299,498,946,1629,3073,0.10859041
Los Angeles,91340,34580,1164,1307,1284,3755,0.10858878
Milwaukee,53206,22454,883,799,756,2438,0.108577536
New York,10977,75874,3185,2853,2200,8238,0.108574742
New York,11212,88732,3044,3288,3301,9633,0.108562863
"Portland, OR",97132,33007,1308,1207,1068,3583,0.108552731
Salt Lake City,84118,40776,1607,1452,1367,4426,0.108544242
Wichita-Hutchinson Plus,67801,30690,1247,1102,982,3331,0.108536983
Raleigh-Durham (Fayetvlle),28390,24399,819,828,1001,2648,0.108529038
Yakima-Pasco-Rchlnd-Knnwck,99344,19470,850,704,559,2113,0.108525937
Los Angeles,90062,31201,1032,1167,1187,3386,0.108522163
Omaha,68111,25658,1016,929,839,2784,0.10850417
Norfolk-Portsmth-Newpt Nws,23607,23836,815,933,838,2586,0.108491358
Phoenix (Prescott),85204,65254,2229,2378,2472,7079,0.108483771
Chicago,60586,47862,1837,1827,1528,5192,0.108478542
Boston (Manchester),1605,30587,988,1163,1167,3318,0.108477458
Houston,77078,14538,586,515,476,1577,0.108474343
Orlando-Daytona Bch-Melbrn,32837,56585,1939,2071,2128,6138,0.108473977
New York,11225,55996,1148,1771,3155,6074,0.108472034
Wilkes Barre-Scranton-Hztn,18503,1973,50,91,73,214,0.108464268
Denver,80524,41555,1085,1745,1677,4507,0.108458669
Chicago,60827,24324,911,845,882,2638,0.108452557
Philadelphia,19143,64566,1857,2172,2973,7002,0.10844717
Memphis,38671,36885,1217,1335,1448,4000,0.108445167
Houston,77306,17336,703,637,540,1880,0.108444855
Houston,77072,54177,1886,2134,1855,5875,0.108440851
Phoenix (Prescott),86321,2066,75,74,75,224,0.108422072
Greensboro-H.Point-W.Salem,27406,61711,2062,2456,2172,6690,0.10840855
Boston (Manchester),2150,40414,1187,1432,1762,4381,0.108403029
Detroit,48122,12685,427,480,468,1375,0.108395743
Kansas City,64139,2565,85,114,79,278,0.108382066
Phoenix (Prescott),85304,28688,1128,1103,878,3109,0.108372839
Miami-Ft. Lauderdale,33136,18474,421,670,911,2002,0.108368518
"Columbia, SC",29210,39643,888,1345,2063,4296,0.108367177
Nashville,37215,25599,737,1064,973,2774,0.108363608
New York,10468,73083,2273,2655,2991,7919,0.108356252
Fresno-Visalia,93640,15163,626,563,454,1643,0.108355866
Philadelphia,19602,19632,654,728,745,2127,0.108343521
Los Angeles,92655,7984,252,302,311,865,0.108341683
Houston,77089,56973,2041,2068,2063,6172,0.108332017
New York,11238,56555,826,1701,3599,6126,0.108319335
Baltimore,21620,12852,496,590,306,1392,0.108309991
Richmond-Petersburg,23294,19648,438,638,1052,2128,0.108306189
Memphis,38107,15329,475,567,618,1660,0.108291474
Shreveport,75602,21831,876,845,643,2364,0.108286382
Champaign&Sprngfld-Decatur,62701,1376,19,52,78,149,0.108284884
"Columbus, OH",43232,45236,1516,1659,1723,4898,0.108276594
Birmingham (Ann and Tusc),36205,979,45,30,31,106,0.108273749
Kansas City,64030,26286,789,954,1103,2846,0.108270562
Toledo,44883,28599,1180,1146,770,3096,0.108255533
St. Louis,62201,4684,162,185,160,507,0.10824082
Los Angeles,92501,22340,689,827,902,2418,0.108236347
Boston (Manchester),2124,49449,1571,1812,1968,5351,0.108212502
Birmingham (Ann and Tusc),35216,35489,977,1343,1520,3840,0.108202542
Albuquerque-Santa Fe,88203,29651,1231,1044,933,3208,0.108191967
Idaho Fals-Pocatllo(Jcksn),83435,647,30,23,17,70,0.108191654
Harlingen-Wslco-Brnsvl-Mca,78504,58725,2166,2163,2024,6353,0.108182205
New Orleans,39470,12831,631,422,335,1388,0.108175512
Salt Lake City,84651,31247,1340,1061,979,3380,0.108170384
Baltimore,21228,54137,2086,2375,1395,5856,0.108170013
Houston,77012,18150,697,666,600,1963,0.10815427
Dallas-Ft. Worth,76119,51832,2069,1882,1654,5605,0.10813783
Minneapolis-St. Paul,55430,24092,829,866,910,2605,0.108127179
Dayton,45402,10932,311,360,511,1182,0.108122942
Sacramnto-Stkton-Modesto,95360,13940,591,512,404,1507,0.108106169
Salt Lake City,84054,21928,801,700,869,2370,0.108080992
Austin,78754,31746,853,1076,1502,3431,0.108076608
New York,10039,23327,616,819,1086,2521,0.108072191
Dallas-Ft. Worth,75252,27242,529,1001,1414,2944,0.108068424
Fresno-Visalia,93705,39569,1454,1428,1394,4276,0.108064394
Reno,89502,48177,1375,1809,2022,5206,0.108059863
New York,11717,60569,2178,2258,2109,6545,0.108058578
Dallas-Ft. Worth,76040,32316,993,1235,1264,3492,0.108057928
Birmingham (Ann and Tusc),35211,23880,554,1089,937,2580,0.108040201
Yuma-El Centro,92227,28039,1177,1000,852,3029,0.108028104
Sioux Falls(Mitchell),57356,2296,92,82,74,248,0.108013937
Memphis,38016,47986,1439,1704,2040,5183,0.10801067
Yakima-Pasco-Rchlnd-Knnwck,99336,53193,1779,1948,2018,5745,0.108002933
New York,10473,58506,1920,2292,2106,6318,0.107988924
Reno,89433,23051,854,857,778,2489,0.107977962
New York,7201,30268,1092,1123,1053,3268,0.107968812
Tulsa,74132,10773,302,413,448,1163,0.107955073
New York,7501,38051,1287,1371,1449,4107,0.107934088
Los Angeles,90029,33729,658,1094,1888,3640,0.107919001
"Portland, OR",97006,46559,1133,1582,2309,5024,0.107906098
Denver,81635,6813,239,238,258,735,0.10788199
"Columbus, OH",43054,27614,871,967,1141,2979,0.107880061
Amarillo,79111,1613,62,54,58,174,0.107873528
Houston,77023,26834,782,998,1114,2894,0.107848252
Philadelphia,8648,31890,1220,1267,952,3439,0.107839448
Yakima-Pasco-Rchlnd-Knnwck,97850,17389,547,584,744,1875,0.107826787
Houston,77064,46901,1554,1759,1744,5057,0.107822861
Dallas-Ft. Worth,75040,64296,2259,2395,2278,6932,0.107813861
Houston,77013,16791,585,617,608,1810,0.107795843
Amarillo,79104,6764,277,236,216,729,0.107776464
Atlanta,30274,35892,1203,1309,1356,3868,0.107767748
Salt Lake City,84660,49980,2286,1627,1473,5386,0.107763105
"Springfield, MO",65457,232,9,10,6,25,0.107758621
Dallas-Ft. Worth,76164,15776,590,562,548,1700,0.107758621
Green Bay-Appleton,54911,26597,987,1131,748,2866,0.107756514
Wichita-Hutchinson Plus,67203,30128,831,1007,1408,3246,0.107740308
Monroe-El Dorado,71202,27470,1064,979,916,2959,0.10771751
Twin Falls,83344,1244,63,46,25,134,0.107717042
New York,10474,11809,430,423,419,1272,0.107714455
Philadelphia,19141,31493,927,1278,1187,3392,0.107706474
Los Angeles,90638,47027,1633,1949,1483,5065,0.107704085
Bismarck-Mnt-Dcknsn(Wlstn),58329,2637,145,77,62,284,0.107698142
"Springfield, MO",65584,10985,387,351,445,1183,0.107692308
Chicago,60305,11645,409,533,312,1254,0.107685702
New York,7504,13103,423,491,497,1411,0.107685263
Atlanta,30043,91755,3181,3458,3241,9880,0.107678056
New York,7502,16514,570,634,574,1778,0.107666223
Oklahoma City,73135,22859,704,788,969,2461,0.107660003
Bakersfield,93313,62559,2362,2210,2163,6735,0.10765837
Fresno-Visalia,93242,3084,131,111,90,332,0.107652399
Houston,77338,47217,1707,1675,1701,5083,0.107651905
Davenport-R.Island-Moline,52804,26292,875,1064,891,2830,0.107637304
Huntsville-Decatur (Flor),35950,22437,915,799,701,2415,0.107634711
Boston (Manchester),2122,23478,619,817,1091,2527,0.107632677
Yuma-El Centro,85364,75130,2692,2835,2559,8086,0.10762678
Phoenix (Prescott),86004,38950,1200,1414,1578,4192,0.10762516
Atlanta,30319,44202,808,1568,2381,4757,0.107619565
Tyler-Longview(Lfkn&Ncgd),75703,44704,1237,1677,1897,4811,0.107619005
Harrisburg-Lncstr-Leb-York,17104,20697,724,728,775,2227,0.107600135
Orlando-Daytona Bch-Melbrn,32807,37028,1030,1331,1623,3984,0.107594253
Greenwood-Greenville,38941,3839,116,147,150,413,0.107580099
Los Angeles,91706,70534,2398,2578,2612,7588,0.107579323
Chicago,60428,10719,400,444,309,1153,0.107566004
Norfolk-Portsmth-Newpt Nws,23523,7177,287,257,228,772,0.107565835
Memphis,38664,3375,106,124,133,363,0.107555556
Dallas-Ft. Worth,75228,66813,2222,2383,2581,7186,0.107553919
Odessa-Midland,79741,437,18,16,13,47,0.107551487
Cleveland-Akron (Canton),44104,19628,687,627,797,2111,0.107550438
Atlanta,30349,82906,2850,2926,3140,8916,0.107543483
Yuma-El Centro,92281,2055,86,80,55,221,0.107542579
Los Angeles,90020,39782,752,1316,2210,4278,0.107536072
Austin,78640,82726,2980,2851,3065,8896,0.10753572
New York,11433,38560,1242,1434,1470,4146,0.107520747
Tulsa,74110,14965,566,556,487,1609,0.107517541
Birmingham (Ann and Tusc),35215,45819,1706,1620,1600,4926,0.107509985
Tucson (Sierra Vista),85716,33191,618,1204,1746,3568,0.107499021
Charlotte,28152,26030,1023,1036,739,2798,0.107491356
Dallas-Ft. Worth,75116,20104,814,774,573,2161,0.107491047
New York,11226,102315,2469,3533,4995,10997,0.107481796
Houston,77044,60220,2561,2025,1886,6472,0.1074726
Chicago,60651,60053,2086,2119,2249,6454,0.107471733
Chicago,60099,31702,1173,1126,1108,3407,0.10746956
Seattle-Tacoma,98229,34402,971,1567,1159,3697,0.107464682
"Washington, DC (Hagrstwn)",20667,456,16,17,16,49,0.10745614
Philadelphia,19066,6431,245,340,106,691,0.107448297
Hartford & New Haven,6704,27840,986,1009,996,2991,0.107435345
Dallas-Ft. Worth,76015,17038,517,621,692,1830,0.107406973
Denver,80219,60333,2271,2135,2074,6480,0.107403908
Los Angeles,90040,11072,397,385,407,1189,0.107388006
Ft. Wayne,46543,4042,180,130,124,434,0.107372588
Philadelphia,19601,35505,1174,1332,1306,3812,0.10736516
Oklahoma City,73122,13264,455,534,435,1424,0.107358263
Louisville,42728,16369,658,683,416,1757,0.10733704
Houston,77520,35813,1289,1339,1216,3844,0.107335325
Fargo,56716,8816,368,335,243,946,0.1073049
Ft. Myers-Naples,33971,29189,1172,1044,916,3132,0.107300695
"Albany, GA",31645,5154,195,184,174,553,0.107295305
Los Angeles,90303,23022,799,841,830,2470,0.10728868
Chicago,60640,69067,837,2263,4309,7409,0.107272648
Wichita-Hutchinson Plus,67005,15736,658,561,469,1688,0.107269954
Dallas-Ft. Worth,75060,47220,1806,1761,1498,5065,0.107263871
South Bend-Elkhart,46565,9295,375,322,300,997,0.107261969
Miami-Ft. Lauderdale,33065,57971,2049,2296,1873,6218,0.107260527
Hartford & New Haven,6114,25630,860,961,928,2749,0.107257121
Los Angeles,92504,56771,1928,2255,1906,6089,0.107255465
Phoenix (Prescott),85029,46930,1466,1679,1888,5033,0.107244833
New York,11024,8505,350,371,191,912,0.107231041
Tampa-St. Pete (Sarasota),33534,18934,758,658,614,2030,0.107214535
Los Angeles,92503,90968,3241,3287,3224,9752,0.107202533
"Rochester, NY",14621,31271,1145,1073,1134,3352,0.107191967
Philadelphia,19142,28175,1044,1006,970,3020,0.107187223
Honolulu,96731,3667,161,131,101,393,0.107172075
Chicago,46383,42693,1514,1729,1332,4575,0.107160424
Los Angeles,92780,53792,1703,2009,2052,5764,0.10715348
Ft. Smith-Fay-Sprngdl-Rgrs,72903,24713,728,965,955,2648,0.107150083
New York,10985,28,1,1,1,3,0.107142857
Wilkes Barre-Scranton-Hztn,17822,28,1,1,1,3,0.107142857
Greenvll-Spart-Ashevll-And,29609,34832,1208,1306,1218,3732,0.107142857
Des Moines-Ames,50839,28,1,1,1,3,0.107142857
Evansville,62820,196,5,13,3,21,0.107142857
Baton Rouge,70780,924,43,31,25,99,0.107142857
Memphis,72428,28,1,1,1,3,0.107142857
Savannah,31316,14367,599,505,435,1539,0.107120484
Chicago,60625,72416,1810,2637,3310,7757,0.107117212
Fresno-Visalia,93266,1391,55,48,46,149,0.107117182
Phoenix (Prescott),85257,31505,526,1079,1769,3374,0.107094112
San Antonio,78852,57586,2253,2163,1751,6167,0.107092002
Orlando-Daytona Bch-Melbrn,34741,60876,1950,2215,2354,6519,0.107086537
Wichita Falls & Lawton,76302,11897,358,402,514,1274,0.10708582
Sacramnto-Stkton-Modesto,95815,27904,918,957,1113,2988,0.107081422
Albuquerque-Santa Fe,87026,2204,90,71,75,236,0.10707804
Beaumont-Port Arthur,77708,12218,383,424,501,1308,0.107055165
Yakima-Pasco-Rchlnd-Knnwck,99301,91721,3789,3190,2840,9819,0.10705291
"Portland, OR",97003,30064,828,990,1400,3218,0.107038318
Chicago,60469,5372,195,204,176,575,0.107036485
Philadelphia,19128,37021,528,1169,2265,3962,0.10702034
Phoenix (Prescott),85021,41480,1236,1584,1619,4439,0.107015429
Las Vegas,89101,41164,1272,1520,1613,4405,0.10701098
Milwaukee,53224,19710,720,693,696,2109,0.107001522
"Charleston, SC",29420,24984,869,965,839,2673,0.106988473
Chicago,60160,23369,837,818,845,2500,0.106979332
Los Angeles,90241,41412,1319,1497,1614,4430,0.106973824
Sioux Falls(Mitchell),57633,2496,100,97,70,267,0.106971154
Norfolk-Portsmth-Newpt Nws,23513,29406,840,976,1329,3145,0.106950962
Baltimore,20763,2403,81,90,86,257,0.106949646
Kansas City,64123,10503,393,397,333,1123,0.106921832
Denver,80221,42302,1545,1464,1514,4523,0.106921659
Atlanta,30535,8446,348,348,207,903,0.106914516
Chicago,60446,40669,1461,1471,1416,4348,0.106911898
Greenvll-Spart-Ashevll-And,29638,2956,125,119,72,316,0.106901218
Indianapolis,46205,28597,658,1007,1392,3057,0.106899325
Miami-Ft. Lauderdale,33131,27961,293,819,1877,2989,0.106898895
Phoenix (Prescott),85302,42031,1255,1496,1742,4493,0.10689729
Sacramnto-Stkton-Modesto,95833,42668,1204,1461,1896,4561,0.106895097
"Washington, DC (Hagrstwn)",20737,23226,847,864,771,2482,0.106862998
Atlanta,30662,9500,382,379,254,1015,0.106842105
Boston (Manchester),1571,11925,468,501,305,1274,0.106834382
San Francisco-Oak-San Jose,94130,3351,64,120,174,358,0.106833781
"Tri-Cities, TN-VA",37745,20210,910,714,535,2159,0.106828303
New York,11691,64811,2195,2396,2331,6922,0.106802858
Milwaukee,53226,19663,589,787,724,2100,0.106799573
Indianapolis,46260,33559,898,1266,1420,3584,0.106796984
Monroe-El Dorado,71201,21510,686,744,867,2297,0.106787541
Philadelphia,19023,22110,820,807,734,2361,0.106784261
Idaho Fals-Pocatllo(Jcksn),83204,18740,545,690,766,2001,0.106776948
Victoria,77901,40454,1476,1419,1424,4319,0.106763237
Sacramnto-Stkton-Modesto,95814,14219,141,489,888,1518,0.106758562
Chicago,60040,4656,178,179,140,497,0.106743986
Atlanta,30236,51696,1704,1912,1902,5518,0.1067394
Dallas-Ft. Worth,76114,28951,931,1055,1104,3090,0.106732065
New York,11553,26759,911,1056,889,2856,0.106730446
Indianapolis,47305,3861,101,149,162,412,0.106708107
Buffalo,14804,1284,56,50,31,137,0.106697819
Amarillo,73949,1031,40,39,31,110,0.106692532
Hartford & New Haven,6706,14650,547,526,490,1563,0.10668942
"Rochester, NY",14586,14332,431,603,495,1529,0.106684343
Fresno-Visalia,95365,1856,83,65,50,198,0.106681034
Atlanta,30238,42043,1517,1498,1469,4484,0.106652713
Utica,13501,40094,1526,1427,1323,4276,0.106649374
Lubbock,79343,1369,58,47,41,146,0.106647188
Atlanta,30566,11196,365,391,438,1194,0.10664523
Los Angeles,92345,86027,3348,3112,2713,9173,0.106629314
Shreveport,75569,3170,103,111,124,338,0.106624606
Phoenix (Prescott),85225,76212,2359,2629,3138,8126,0.106623629
San Francisco-Oak-San Jose,95116,51115,1670,1893,1887,5450,0.106622322
Dallas-Ft. Worth,76210,47045,1633,1883,1500,5016,0.10662132
Fargo,58072,7766,326,290,212,828,0.106618594
Hartford & New Haven,6051,30110,1026,1048,1136,3210,0.1066091
Lansing,48915,9335,280,332,383,995,0.106588109
Roanoke-Lynchburg,24504,9458,251,364,393,1008,0.106576443
Norfolk-Portsmth-Newpt Nws,23704,20033,517,774,844,2135,0.106574153
Bakersfield,93268,18551,715,624,638,1977,0.106571074
Albuquerque-Santa Fe,88242,8361,366,305,220,891,0.1065662
San Francisco-Oak-San Jose,94608,34152,447,1109,2083,3639,0.106553057
"Jackson, MS",39272,12924,442,472,463,1377,0.106545961
San Antonio,78073,10945,415,402,349,1166,0.106532663
Harlingen-Wslco-Brnsvl-Mca,78596,40883,1544,1464,1347,4355,0.106523494
Tampa-St. Pete (Sarasota),33619,44481,1327,1585,1826,4738,0.106517389
Amarillo,79102,8741,272,318,341,931,0.106509553
Albuquerque-Santa Fe,87301,40016,1549,1447,1266,4262,0.106507397
Dallas-Ft. Worth,76208,30890,1036,1102,1152,3290,0.10650696
Denver,81301,32036,899,1532,981,3412,0.106505182
St. Louis,63301,53128,1856,2165,1637,5658,0.106497515
Odessa-Midland,79762,39542,1403,1386,1422,4211,0.10649436
New York,7513,12574,418,452,469,1339,0.106489582
"Columbia, SC",29209,36727,1235,1263,1413,3911,0.106488415
Baton Rouge,70814,14040,488,537,470,1495,0.106481481
New York,18371,911,35,33,29,97,0.1064764
Charlotte,28144,26682,998,1099,744,2841,0.106476276
Albuquerque-Santa Fe,87417,5570,225,199,169,593,0.106463196
El Paso (Las Cruces),88081,17848,735,657,508,1900,0.106454505
Dallas-Ft. Worth,75104,50684,1858,1829,1708,5395,0.106443848
Tulsa,74134,25225,944,877,864,2685,0.106442022
Lexington,40347,3279,162,123,64,349,0.106434889
Houston,77301,41276,1482,1457,1454,4393,0.106429887
Kansas City,66211,5882,132,225,269,626,0.106426386
Albuquerque-Santa Fe,88240,44061,1710,1516,1463,4689,0.106420644
Evansville,47715,28914,755,1030,1292,3077,0.106419036
Philadelphia,19147,40896,574,1200,2578,4352,0.106416275
Philadelphia,19022,3712,151,132,112,395,0.106411638
Boston (Manchester),1851,32666,920,1316,1240,3476,0.106410335
Tyler-Longview(Lfkn&Ncgd),75707,18948,591,808,617,2016,0.106396453
Chicago,60406,22755,770,827,824,2421,0.106394199
Ft. Wayne,47326,2049,91,70,57,218,0.106393363
Palm Springs,92201,66719,2557,2397,2144,7098,0.106386487
Norfolk-Portsmth-Newpt Nws,23502,20643,578,773,845,2196,0.106379887
Harrisburg-Lncstr-Leb-York,17102,8254,142,295,441,878,0.106372668
Knoxville,37923,31776,775,1162,1443,3380,0.106369587
Indianapolis,46220,35954,717,1051,2056,3824,0.106358124
Great Falls,59524,818,31,30,26,87,0.106356968
Wichita-Hutchinson Plus,67211,19999,636,706,785,2127,0.106355318
Medford-Klamath Falls,97520,26882,950,1236,673,2859,0.106353694
Monroe-El Dorado,71326,978,37,40,27,104,0.106339468
Atlanta,30228,57826,2127,2027,1995,6149,0.10633625
New York,7514,19636,676,695,717,2088,0.106335303
Springfield-Holyoke,1013,22665,803,871,736,2410,0.106331348
Dallas-Ft. Worth,76112,42249,1345,1582,1565,4492,0.106322043
Albuquerque-Santa Fe,87528,3687,150,135,107,392,0.106319501
Cleveland-Akron (Canton),44076,5249,210,190,158,558,0.106305963
Harlingen-Wslco-Brnsvl-Mca,78572,82783,3226,3067,2507,8800,0.106302019
Chicago,60616,58071,1292,2162,2719,6173,0.106300908
Peoria-Bloomington,61775,254,11,9,7,27,0.106299213
"Portland, OR",97005,28017,692,1003,1283,2978,0.106292608
San Francisco-Oak-San Jose,94063,38078,996,1430,1621,4047,0.106281843
Corpus Christi,78413,36386,1096,1360,1411,3867,0.10627714
Memphis,38134,40473,1241,1447,1613,4301,0.106268376
San Antonio,78002,9222,356,344,280,980,0.106267621
Atlanta,30345,25484,677,868,1163,2708,0.106262753
Dallas-Ft. Worth,76116,51873,1455,1762,2295,5512,0.106259518
Erie,16503,14625,521,536,497,1554,0.10625641
Nashville,37086,39994,1506,1363,1380,4249,0.106240936
Salt Lake City,84405,35007,1201,1200,1317,3718,0.10620733
Augusta-Aiken,30904,23983,645,845,1057,2547,0.106200225
Dallas-Ft. Worth,75074,54023,1724,2017,1996,5737,0.106195509
Amarillo,79087,678,25,30,17,72,0.10619469
Orlando-Daytona Bch-Melbrn,32825,64282,1812,2263,2751,6826,0.106188358
Omaha,51442,9587,401,368,249,1018,0.106185459
"Jackson, MS",39212,27396,924,1022,963,2909,0.106183384
Baltimore,21211,16726,175,622,979,1776,0.106181992
Tampa-St. Pete (Sarasota),33805,29318,951,1107,1055,3113,0.106180503
Orlando-Daytona Bch-Melbrn,32803,23611,332,698,1477,2507,0.106179323
Los Angeles,91605,51021,1491,1849,2077,5417,0.106171968
Dallas-Ft. Worth,76134,26864,1041,928,883,2852,0.106164384
Odessa-Midland,79765,29100,928,892,1269,3089,0.106151203
Macon,30204,13154,564,453,379,1396,0.106127414
Salt Lake City,84655,19544,833,622,619,2074,0.106119525
San Antonio,78213,38636,1215,1450,1435,4100,0.106118646
South Bend-Elkhart,46616,5918,193,227,208,628,0.106116931
Memphis,72370,7690,290,283,243,816,0.106111834
Miami-Ft. Lauderdale,33068,52758,1845,1922,1831,5598,0.106107131
Los Angeles,91744,76621,2564,2775,2791,8130,0.106106681
"Lafayette, IN",47904,16635,421,608,736,1765,0.106101593
Kansas City,64116,19011,385,686,946,2017,0.10609647
Albany-Schenectady-Troy,12866,40728,1416,1752,1153,4321,0.106094088
Las Vegas,89108,76561,2494,2671,2957,8122,0.106085344
Cleveland-Akron (Canton),44099,2894,119,100,88,307,0.106081548
Atlanta,30297,30431,1141,1046,1041,3228,0.106076041
Atlanta,30341,36087,844,1308,1675,3827,0.10604927
Lexington,40503,26253,670,1268,846,2784,0.106045023
Peoria-Bloomington,61603,16277,577,634,515,1726,0.106039196
New York,10026,33243,764,1097,1664,3525,0.106037361
Atlanta,30273,17995,641,637,630,1908,0.106029453
Oklahoma City,73003,23344,747,829,899,2475,0.106022961
Milwaukee,53225,23637,871,815,820,2506,0.106020223
Savannah,29935,3688,96,140,155,391,0.106019523
San Antonio,78264,16321,651,600,479,1730,0.105998407
Cleveland-Akron (Canton),44703,7953,273,308,262,843,0.105997737
Houston,77074,41200,1427,1532,1408,4367,0.105995146
Miami-Ft. Lauderdale,33032,67441,2475,2350,2323,7148,0.105988938
Memphis,38127,39620,1426,1371,1402,4199,0.105981827
Houston,77088,56136,2147,1970,1832,5949,0.105974776
Albuquerque-Santa Fe,87567,1038,44,35,31,110,0.105973025
Houston,77035,34340,1120,1283,1236,3639,0.105969715
Sacramnto-Stkton-Modesto,95368,13741,537,520,399,1456,0.105960265
Tampa-St. Pete (Sarasota),33614,48086,1219,1758,2118,5095,0.105955996
Odessa-Midland,79830,8032,298,331,222,851,0.105951195
Denver,80301,26598,600,989,1229,2818,0.105947816
San Diego,92123,30622,543,1002,1699,3244,0.105936908
Duluth-Superior,54880,30388,968,1095,1156,3219,0.105929972
Baltimore,21649,1605,67,56,47,170,0.105919003
Las Vegas,89014,40202,1091,1506,1661,4258,0.105915129
"Portland, OR",98684,36757,1129,1299,1465,3893,0.105911799
Los Angeles,92408,13446,435,480,509,1424,0.105905102
Austin,78616,14806,649,518,401,1568,0.105903012
Houston,77498,51089,1741,1853,1816,5410,0.105893637
San Antonio,78223,61093,2168,2181,2120,6469,0.105887745
Nashville,42104,39619,1227,1670,1298,4195,0.105883541
Savannah,30461,17718,601,774,501,1876,0.105881025
Detroit,48198,39171,1058,1458,1631,4147,0.105869138
"Columbus, OH",43110,41986,1356,1593,1496,4445,0.105868623
New York,8832,2966,95,114,105,314,0.105866487
"Jackson, MS",39206,21839,649,730,933,2312,0.105865653
Greenville-N.Bern-Washngtn,28540,49715,1495,1658,2110,5263,0.105863422
Des Moines-Ames,50125,22265,886,912,559,2357,0.105861217
Chicago,60478,16324,621,638,469,1728,0.105856408
Tucson (Sierra Vista),85745,37589,1004,1673,1302,3979,0.105855436
Tucson (Sierra Vista),85648,21861,905,798,611,2314,0.105850602
Kansas City,64132,12263,399,439,460,1298,0.105846856
"Columbia, SC",29203,40097,1336,1434,1474,4244,0.10584333
New York,7304,51370,1407,1762,2268,5437,0.105839984
Ft. Smith-Fay-Sprngdl-Rgrs,74953,12359,502,423,383,1308,0.105833805
Houston,77087,34178,1290,1240,1087,3617,0.105828311
Oklahoma City,73018,20251,736,810,597,2143,0.105821935
Philadelphia,19082,42916,1391,1509,1641,4541,0.105811352
Kansas City,64127,17724,631,666,578,1875,0.105788761
Atlanta,30046,43275,1475,1546,1557,4578,0.105788562
Denver,80110,24455,574,883,1130,2587,0.105786138
New Orleans,70127,23028,840,797,799,2436,0.105784263
Atlanta,30096,71517,1997,2624,2944,7565,0.105779046
Amarillo,88101,44319,1450,1626,1612,4688,0.10577856
Tucson (Sierra Vista),85607,20299,802,771,574,2147,0.105768757
"Columbia, SC",29206,22474,955,701,721,2377,0.105766664
Buffalo,14212,13360,478,492,443,1413,0.105763473
Tampa-St. Pete (Sarasota),33701,19375,402,698,949,2049,0.105754839
Salt Lake City,84779,643,34,22,12,68,0.105754277
"Tri-Cities, TN-VA",24293,9154,325,419,224,968,0.105746122
Houston,77040,49044,1578,1752,1856,5186,0.105741783
Grand Rapids-Kalmzoo-B.Crk,49321,16796,449,575,752,1776,0.105739462
Los Angeles,92804,81753,2467,2990,3187,8644,0.105733123
Cleveland-Akron (Canton),44062,14859,617,505,449,1571,0.105727169
Richmond-Petersburg,23222,24261,653,1074,838,2565,0.105725238
Lubbock,79323,6555,282,231,180,693,0.105720824
Ft. Wayne,46711,8258,331,275,267,873,0.10571567
Chicago,60120,49586,1734,1722,1786,5242,0.105715323
"Columbus, OH",43204,43090,1260,1400,1895,4555,0.105708981
Las Vegas,89031,78132,2721,2666,2872,8259,0.105705729
Harlingen-Wslco-Brnsvl-Mca,78550,55601,2088,1921,1868,5877,0.105699538
Fresno-Visalia,93657,37713,1517,1317,1152,3986,0.105692997
Sacramnto-Stkton-Modesto,95386,11212,449,404,332,1185,0.105690332
Baltimore,21212,32445,1097,1352,980,3429,0.105686546
Yakima-Pasco-Rchlnd-Knnwck,98902,48343,1771,1698,1640,5109,0.105682312
Terre Haute,47872,8262,227,262,384,873,0.105664488
San Antonio,78216,38064,891,1392,1739,4022,0.105664145
Los Angeles,91733,40431,1390,1452,1430,4272,0.105661497
Chicago,60652,38512,1337,1405,1327,4069,0.10565538
Austin,78745,60357,1028,2127,3222,6377,0.105654688
Chicago,60644,44941,1412,1633,1703,4748,0.10564963
Chattanooga,37407,9979,374,334,346,1054,0.105621806
Los Angeles,90031,35291,978,1287,1462,3727,0.105607662
New York,7018,31532,934,1122,1274,3330,0.105607002
El Paso (Las Cruces),88008,11155,415,390,373,1178,0.105602869
Waco-Temple-Bryan,76548,35871,1320,1301,1167,3788,0.105600624
Tulsa,74107,19954,637,725,745,2107,0.105592864
Chicago,60915,9338,313,349,324,986,0.105590062
San Francisco-Oak-San Jose,94108,11517,173,387,656,1216,0.105583051
Los Angeles,90004,55981,1269,1812,2829,5910,0.105571533
Johnstown-Altoona-St Colge,16872,1544,65,50,48,163,0.105569948
La Crosse-Eau Claire,54603,14171,354,500,642,1496,0.105567709
"Washington, DC (Hagrstwn)",20770,27193,791,948,1131,2870,0.105541867
Detroit,48208,6718,146,221,342,709,0.105537362
Philadelphia,19134,57843,1905,2011,2188,6104,0.10552703
Detroit,48224,38940,1376,1293,1440,4109,0.105521315
"Portland, OR",97026,4246,148,157,143,448,0.105511069
Memphis,72364,16113,584,560,556,1700,0.105504872
Norfolk-Portsmth-Newpt Nws,23608,43307,1366,1484,1719,4569,0.105502575
San Diego,91950,57603,1874,2064,2139,6077,0.105497978
Houston,77051,19991,693,722,694,2109,0.105497474
Salt Lake City,84020,55281,2177,1863,1792,5832,0.105497368
Salt Lake City,84015,74033,2728,2475,2607,7810,0.105493496
San Antonio,78109,68676,2559,2328,2357,7244,0.105480808
Los Angeles,90026,63492,1220,2081,3395,6696,0.105462105
Albuquerque-Santa Fe,88260,15277,645,532,434,1611,0.105452641
Cleveland-Akron (Canton),44709,18976,616,781,604,2001,0.105448988
Grand Rapids-Kalmzoo-B.Crk,49009,46507,1407,1926,1571,4904,0.105446492
San Francisco-Oak-San Jose,94544,82203,2827,2840,3001,8668,0.105446273
Salt Lake City,84074,63816,2701,2072,1956,6729,0.105443776
Las Vegas,89106,29812,1089,1040,1014,3143,0.105427345
Memphis,72390,6469,229,256,197,682,0.105425877
Norfolk-Portsmth-Newpt Nws,23503,31075,727,1139,1410,3276,0.105422365
Chicago,60653,31002,918,1073,1277,3268,0.105412554
Atlanta,30288,8083,283,280,289,852,0.105406409
Dayton,45410,16081,471,616,608,1695,0.105403893
Sioux Falls(Mitchell),57108,38060,1224,1160,1627,4011,0.105386232
Los Angeles,92583,34996,1342,1281,1065,3688,0.105383472
Harrisburg-Lncstr-Leb-York,17057,23773,792,902,811,2505,0.10537164
Dallas-Ft. Worth,76117,33216,1148,1186,1166,3500,0.105370906
Ft. Wayne,46807,16229,545,559,606,1710,0.105366936
Houston,77003,12567,193,450,681,1324,0.105355296
Santabarbra-Sanmar-Sanluob,93454,41888,1603,1460,1350,4413,0.105352368
Atlanta,30134,46853,1715,1638,1583,4936,0.105350778
Grand Rapids-Kalmzoo-B.Crk,49534,25506,728,868,1091,2687,0.105347761
Greenvll-Spart-Ashevll-And,29302,18577,631,729,597,1957,0.105345319
Fresno-Visalia,93625,9104,370,313,276,959,0.105338313
New York,11385,98320,2259,3293,4804,10356,0.105329536
"Rochester, NY",14619,13928,441,504,522,1467,0.105327398
Raleigh-Durham (Fayetvlle),27604,46269,1313,1642,1918,4873,0.105318896
Atlanta,30307,21791,421,681,1193,2295,0.10531871
Albuquerque-Santa Fe,87401,44437,1722,1585,1373,4680,0.105317641
"Columbus, OH",43211,23074,902,770,758,2430,0.10531334
"Columbus, OH",43205,12395,264,425,616,1305,0.105284389
Montgomery-Selma,36111,12111,407,417,451,1275,0.105276195
San Francisco-Oak-San Jose,94601,53128,1688,1903,2002,5593,0.105274055
San Francisco-Oak-San Jose,95134,27169,281,710,1869,2860,0.105267032
Little Rock-Pine Bluff,71655,13993,511,527,435,1473,0.105266919
Salt Lake City,84034,19,1,0,1,2,0.105263158
Monterey-Salinas,93943,19,0,1,1,2,0.105263158
New York,11416,27295,772,1009,1092,2873,0.105257373
Cleveland-Akron (Canton),44132,17074,496,592,709,1797,0.105247745
Charlotte,28205,51167,1012,1601,2772,5385,0.105243614
Los Angeles,90706,75521,2459,2648,2841,7948,0.10524225
New York,6605,24383,788,872,906,2566,0.105237255
Nashville,37207,43147,1302,1535,1703,4540,0.105221684
Houston,77380,29785,742,1156,1236,3134,0.105220749
Raleigh-Durham (Fayetvlle),27616,62052,2073,2187,2269,6529,0.105218204
New York,10035,35622,979,1246,1523,3748,0.105215878
Los Angeles,90049,35501,911,1128,1696,3735,0.105208304
South Bend-Elkhart,46615,14220,400,530,566,1496,0.105203938
Wilkes Barre-Scranton-Hztn,17701,42653,1526,1687,1274,4487,0.105197759
Atlanta,30354,16759,578,605,580,1763,0.105197207
Atlanta,30016,64966,2342,2300,2192,6834,0.105193486
Los Angeles,90242,43292,1366,1522,1666,4554,0.105192645
Los Angeles,92395,47984,1771,1710,1566,5047,0.105180894
Chicago,60153,22457,772,813,777,2362,0.105178786
Harrisburg-Lncstr-Leb-York,17505,1740,56,65,62,183,0.105172414
"Washington, DC (Hagrstwn)",22311,21251,475,687,1073,2235,0.105171521
Anchorage,99504,41543,1212,1444,1713,4369,0.105168139
Dallas-Ft. Worth,75043,64272,2176,2368,2215,6759,0.105162435
San Francisco-Oak-San Jose,95407,43353,1512,1525,1522,4559,0.105159966
Green Bay-Appleton,54115,50064,1934,1952,1378,5264,0.105145414
Boston (Manchester),1850,16520,570,575,592,1737,0.105145278
"Charleston, SC",29456,42202,1374,1414,1649,4437,0.105137197
Los Angeles,92843,45152,1403,1644,1700,4747,0.10513377
Bakersfield,93280,28013,1118,978,849,2945,0.105129761
Bismarck-Mnt-Dcknsn(Wlstn),58568,390,14,16,11,41,0.105128205
Orlando-Daytona Bch-Melbrn,32819,36200,975,1377,1453,3805,0.105110497
Los Angeles,90605,38313,1265,1422,1340,4027,0.105107927
Boston (Manchester),1603,23187,628,959,850,2437,0.105101997
Wichita-Hutchinson Plus,67566,628,26,22,18,66,0.105095541
Harlingen-Wslco-Brnsvl-Mca,78593,5520,217,209,154,580,0.105072464
Raleigh-Durham (Fayetvlle),27617,20170,487,619,1013,2119,0.105057015
Ft. Smith-Fay-Sprngdl-Rgrs,72719,18391,649,588,695,1932,0.105051384
San Antonio,78221,41212,1555,1435,1339,4329,0.105042221
Cleveland-Akron (Canton),44046,2285,93,77,70,240,0.105032823
Omaha,68134,29421,870,999,1221,3090,0.105027022
Atlanta,30344,35258,969,1212,1522,3703,0.10502581
Tulsa,74129,19205,691,622,704,2017,0.105024733
Little Rock-Pine Bluff,72068,438,16,17,13,46,0.105022831
Phoenix (Prescott),85295,58778,2234,1939,2000,6173,0.105022287
Odessa-Midland,79763,39706,1473,1357,1340,4170,0.105021911
Boise,83651,37640,1268,1301,1384,3953,0.105021254
San Antonio,78217,31994,880,1167,1313,3360,0.105019691
Memphis,72333,638,27,24,16,67,0.105015674
Columbia-Jefferson City,65251,22140,816,966,543,2325,0.10501355
Omaha,68123,33415,1011,1237,1261,3509,0.105012719
Los Angeles,90006,55527,1575,1893,2363,5831,0.105011976
Fresno-Visalia,93230,71813,2733,2440,2367,7540,0.104994917
Rockford,61020,3086,128,115,81,324,0.104990279
"Lafayette, LA",70503,26993,749,1039,1046,2834,0.104990183
Pittsburgh,15233,2448,42,91,124,257,0.10498366
Idaho Fals-Pocatllo(Jcksn),83425,562,26,19,14,59,0.104982206
El Paso (Las Cruces),88047,2029,69,72,72,213,0.104977822
Oklahoma City,73008,21501,778,803,676,2257,0.104971862
Orlando-Daytona Bch-Melbrn,32829,20751,591,669,918,2178,0.104958797
Phoenix (Prescott),85042,46914,1531,1615,1778,4924,0.104958008
St. Louis,63088,8509,188,311,394,893,0.104947702
Ft. Smith-Fay-Sprngdl-Rgrs,72758,52139,1814,1802,1855,5471,0.10493105
Cleveland-Akron (Canton),44654,20433,762,706,676,2144,0.104928302
Salt Lake City,84319,10960,425,379,346,1150,0.104927007
Syracuse,13224,8788,249,346,327,922,0.104915794
Los Angeles,93015,19970,769,712,614,2095,0.104907361
Laredo,78369,591,18,25,19,62,0.104906937
Yuma-El Centro,92243,50388,1864,1759,1663,5286,0.10490593
"Jackson, MS",39169,2345,86,72,88,246,0.104904051
Los Angeles,90260,31992,1022,1130,1204,3356,0.104901225
"Columbus, OH",43229,57049,1744,1999,2241,5984,0.104892286
Minneapolis-St. Paul,55117,46060,1447,1651,1733,4831,0.104884933
Memphis,38680,7447,269,261,251,781,0.104874446
Los Angeles,92626,53417,1194,1787,2621,5602,0.104872981
Pittsburgh,26501,19071,451,776,773,2000,0.104871271
Salt Lake City,84078,30718,1262,1062,897,3221,0.104857087
New York,7029,23434,462,757,1238,2457,0.104847657
Dallas-Ft. Worth,75146,22462,856,784,715,2355,0.104843736
Charlotte,28269,86806,2922,3024,3155,9101,0.104842983
Fresno-Visalia,93722,87159,3259,3013,2866,9138,0.104842873
Toledo,43609,19717,712,679,676,2067,0.104833393
"Alexandria, LA",71461,2051,65,67,83,215,0.104826914
Kansas City,64120,353,15,12,10,37,0.104815864
Hartford & New Haven,6710,10915,389,376,379,1144,0.104809895
Lincoln & Hastings-Krny,68333,8530,301,348,245,894,0.104806565
Des Moines-Ames,50219,14322,584,609,308,1501,0.104803798
Los Angeles,90301,35555,1140,1214,1372,3726,0.104795387
New York,11575,17234,536,636,634,1806,0.104792851
San Diego,92078,52430,2084,1957,1453,5494,0.104787335
Joplin-Pittsburg,64863,1737,79,57,46,182,0.104778353
"Albany, GA",31535,12436,436,468,399,1303,0.104776455
Syracuse,13203,16228,461,576,663,1700,0.10475721
Austin,78664,63073,2044,2258,2304,6606,0.104735782
Lubbock,79346,2091,82,82,55,219,0.104734577
Los Angeles,90621,35826,1125,1214,1413,3752,0.10472841
Oklahoma City,73132,29419,895,1026,1160,3081,0.104728237
"Portland, OR",97128,38653,1528,1421,1099,4048,0.104726671
Los Angeles,91732,59048,1910,2152,2121,6183,0.104711421
Salt Lake City,84029,14507,628,472,419,1519,0.104708072
Salt Lake City,84084,32223,1103,1136,1135,3374,0.104707817
Baltimore,21224,53882,1195,1569,2877,5641,0.104691734
Phoenix (Prescott),85540,3764,136,115,143,394,0.104675877
Philadelphia,19135,34048,1207,1215,1142,3564,0.104675752
Grand Rapids-Kalmzoo-B.Crk,49509,28625,925,1030,1041,2996,0.104663755
Philadelphia,19805,40313,1302,1449,1467,4218,0.10463126
Missoula,59808,23779,656,922,910,2488,0.104630136
Little Rock-Pine Bluff,72082,1644,51,53,68,172,0.104622871
Atlanta,30281,71346,2360,2617,2487,7464,0.104616937
Terre Haute,47558,5411,235,187,144,566,0.104601737
Dallas-Ft. Worth,75110,30927,1170,1097,968,3235,0.104601158
Yakima-Pasco-Rchlnd-Knnwck,97818,5507,212,208,156,576,0.104594153
Knoxville,37912,22937,583,746,1070,2399,0.104590836
Salt Lake City,89314,153,6,5,5,16,0.104575163
Houston,77531,16554,523,581,627,1731,0.104566872
"Columbus, OH",43029,526,25,18,12,55,0.104562738
"Springfield, MO",65756,746,33,26,19,78,0.104557641
Colorado Springs-Pueblo,80817,31925,1066,1050,1222,3338,0.104557557
Dallas-Ft. Worth,76123,45281,1752,1578,1404,4734,0.104547161
Denver,80234,28045,743,939,1250,2932,0.104546265
"Washington, DC (Hagrstwn)",22191,76940,2433,2579,3031,8043,0.104536002
Wichita Falls & Lawton,73505,47027,1495,1659,1762,4916,0.104535692
Odessa-Midland,79701,29858,1098,1009,1014,3121,0.1045281
Kansas City,64648,1837,61,80,51,192,0.104518236
Minneapolis-St. Paul,55425,10640,260,403,449,1112,0.104511278
Abilene-Sweetwater,79606,29758,850,1131,1129,3110,0.104509712
Tyler-Longview(Lfkn&Ncgd),75964,19904,779,674,627,2080,0.104501608
Phoenix (Prescott),85007,14566,431,515,576,1522,0.104489908
Los Angeles,91101,20166,283,588,1236,2107,0.104482793
Dallas-Ft. Worth,76244,80866,3444,2703,2301,8448,0.104469122
Louisville,40205,23704,794,925,757,2476,0.104454944
Phoenix (Prescott),85203,37769,1316,1244,1385,3945,0.10445074
Harlingen-Wslco-Brnsvl-Mca,78501,61562,2052,2223,2155,6430,0.104447549
Sherman-Ada,74820,31800,1051,1152,1118,3321,0.104433962
Meridian,35464,316,11,13,9,33,0.10443038
Salt Lake City,84066,13732,623,451,360,1434,0.104427614
Detroit,48228,52642,1847,1801,1848,5496,0.104403328
Fresno-Visalia,95317,728,30,21,25,76,0.104395604
Los Angeles,93543,13604,498,472,450,1420,0.104381064
Houston,77048,23368,885,787,767,2439,0.104373502
Jonesboro,72476,7071,292,252,194,738,0.104369962
Louisville,40210,13807,511,495,435,1441,0.10436735
Dallas-Ft. Worth,75114,12801,525,433,378,1336,0.104366846
Salt Lake City,84337,15887,615,506,537,1658,0.104362057
Salt Lake City,84007,575,25,19,16,60,0.104347826
Phoenix (Prescott),85306,26556,888,964,919,2771,0.104345534
Los Angeles,91746,28812,926,1070,1010,3006,0.104331529
Las Vegas,89032,49367,1723,1703,1724,5150,0.1043207
Philadelphia,19125,27751,369,780,1746,2895,0.104320565
Indianapolis,46268,25873,711,936,1052,2699,0.104317242
Hartford & New Haven,6259,4611,189,189,103,481,0.104315767
Sacramnto-Stkton-Modesto,95358,32038,1244,1192,906,3342,0.104313628
New York,10993,5014,169,190,164,523,0.104307938
San Antonio,78801,20910,778,767,636,2181,0.104304161
New York,7106,33944,1124,1203,1213,3540,0.104289418
Palm Springs,92240,42200,1604,1455,1342,4401,0.1042891
Phoenix (Prescott),85388,37703,1563,1298,1071,3932,0.104288783
Dallas-Ft. Worth,75210,8544,329,302,260,891,0.104283708
Sacramnto-Stkton-Modesto,95380,42653,1495,1529,1424,4448,0.104283403
Greenville-N.Bern-Washngtn,28578,4958,207,172,138,517,0.104275918
Bismarck-Mnt-Dcknsn(Wlstn),58528,585,26,17,18,61,0.104273504
Charleston-Huntington,45662,26498,785,1186,792,2763,0.104272021
Philadelphia,18109,19125,589,687,718,1994,0.104261438
Laredo,78076,12876,533,446,363,1342,0.104224915
Chicago,46312,26111,877,891,953,2721,0.104208954
Kansas City,64129,7888,245,276,301,822,0.104208925
Des Moines-Ames,50321,7917,212,287,326,825,0.104206139
Philadelphia,8341,1190,38,50,36,124,0.104201681
New York,10466,67283,2101,2464,2446,7011,0.104201656
San Francisco-Oak-San Jose,95110,23615,504,793,1163,2460,0.104171078
Shreveport,71048,48,2,1,2,5,0.104166667
Los Angeles,92318,192,6,6,8,20,0.104166667
Sacramnto-Stkton-Modesto,95385,336,13,13,9,35,0.104166667
Tampa-St. Pete (Sarasota),33605,19086,573,662,753,1988,0.104160117
New York,8861,58882,2041,2097,1995,6133,0.104157467
Denver,80017,37837,1116,1314,1511,3941,0.104157306
Los Angeles,92336,112044,4158,3959,3553,11670,0.10415551
Cleveland-Akron (Canton),44121,32013,1111,1156,1067,3334,0.104145191
"Washington, DC (Hagrstwn)",20783,51449,1586,1885,1887,5358,0.104141966
Ft. Smith-Fay-Sprngdl-Rgrs,72830,15508,559,608,448,1615,0.104139799
New York,7112,29192,950,978,1112,3040,0.10413812
New Orleans,70129,11072,437,367,349,1153,0.104136561
"Columbus, GA (Opelika, AL)",31907,58626,2014,2028,2063,6105,0.104134684
Montgomery-Selma,36117,53415,1555,1852,2155,5562,0.104128054
New York,10302,20139,667,754,676,2097,0.104126322
Fresno-Visalia,93292,45647,1655,1535,1563,4753,0.104125134
Denver,80012,50567,1424,1835,2006,5265,0.104119287
Miami-Ft. Lauderdale,33025,78884,2176,2839,3198,8213,0.104114903
Ft. Wayne,46816,19269,667,650,689,2006,0.104105039
Philadelphia,19120,63715,2167,2221,2245,6633,0.104104214
New York,11530,29540,1214,1287,574,3075,0.104096141
Tampa-St. Pete (Sarasota),33873,13547,520,471,419,1410,0.104082085
Madison,53719,33916,745,1096,1689,3530,0.10408067
Atlanta,30038,44785,1449,1525,1687,4661,0.104075025
Chattanooga,30720,27377,941,982,926,2849,0.104065456
Macon,31088,61580,2125,2117,2166,6408,0.10405976
Idaho Fals-Pocatllo(Jcksn),83262,1355,54,50,37,141,0.104059041
West Palm Beach-Ft. Pierce,33413,19009,665,672,641,1978,0.104055973
Houston,77471,48285,1753,1664,1607,5024,0.104048876
Dayton,45419,16387,582,618,505,1705,0.10404589
Montgomery-Selma,36786,2451,93,86,76,255,0.104039168
Memphis,38116,38265,1228,1283,1470,3981,0.104037632
Topeka,66431,644,43,13,11,67,0.104037267
San Antonio,78259,33556,1184,1136,1171,3491,0.104035046
New York,12733,1740,54,84,43,181,0.104022989
Phoenix (Prescott),85256,5826,247,205,154,606,0.104016478
Raleigh-Durham (Fayetvlle),27609,38082,830,1287,1844,3961,0.104012394
New York,12550,56514,1926,2066,1886,5878,0.104009626
Miami-Ft. Lauderdale,33178,66900,2356,2299,2303,6958,0.104005979
Philadelphia,18104,48710,1609,2192,1265,5066,0.104003285
Los Angeles,93060,35442,1314,1250,1122,3686,0.104000903
Amarillo,73944,375,16,11,12,39,0.104
Joplin-Pittsburg,64870,17242,593,545,655,1793,0.103990256
Phoenix (Prescott),85006,22912,677,782,923,2382,0.103962989
Austin,78723,37188,763,1298,1805,3866,0.103958266
Los Angeles,90810,37218,1215,1319,1335,3869,0.103955076
Greensboro-H.Point-W.Salem,27127,42173,1509,1408,1467,4384,0.103952766
Los Angeles,92879,49218,1640,1751,1725,5116,0.103945711
Lansing,48911,40608,1218,1457,1546,4221,0.103945035
Seattle-Tacoma,98107,29718,371,727,1991,3089,0.103943738
Fresno-Visalia,93291,66696,2734,2264,1934,6932,0.103934269
Salt Lake City,84653,12508,610,432,258,1300,0.103933483
"Washington, DC (Hagrstwn)",20784,32560,1142,1114,1128,3384,0.103931204
Oklahoma City,73118,13808,255,484,696,1435,0.103925261
"Jackson, MS",39232,9151,219,252,480,951,0.103923069
Los Angeles,91342,92126,3083,3277,3214,9574,0.103922888
"Jackson, TN",38355,7535,361,253,169,783,0.103915063
Houston,77026,23310,780,823,819,2422,0.103903904
"Washington, DC (Hagrstwn)",25432,77,2,3,3,8,0.103896104
San Francisco-Oak-San Jose,95122,51802,1681,1899,1802,5382,0.103895602
Dayton,45504,17431,586,698,527,1811,0.103895359
Dallas-Ft. Worth,75155,4505,184,161,123,468,0.103884573
San Antonio,78148,20649,645,778,722,2145,0.103879122
Kansas City,64151,30478,846,973,1347,3166,0.103878207
"Washington, DC (Hagrstwn)",22172,11196,351,411,401,1163,0.103876384
Cincinnati,45015,12496,435,439,424,1298,0.103873239
Philadelphia,19106,15240,84,378,1121,1583,0.103871391
San Antonio,78202,11284,383,395,394,1172,0.103863878
Orlando-Daytona Bch-Melbrn,34753,5902,235,199,179,613,0.103863097
Las Vegas,89169,26527,694,937,1124,2755,0.103856448
Davenport-R.Island-Moline,52807,16100,439,565,668,1672,0.103850932
Colorado Springs-Pueblo,81001,30574,1062,1126,987,3175,0.103846405
Seattle-Tacoma,98424,12540,397,431,474,1302,0.103827751
Houston,77070,57435,1746,1965,2252,5963,0.103821711
Orlando-Daytona Bch-Melbrn,32822,63860,1826,2205,2599,6630,0.103820858
Minneapolis-St. Paul,55426,26228,532,818,1373,2723,0.103820345
San Francisco-Oak-San Jose,94115,34104,418,962,2160,3540,0.103800141
"Albany, GA",31794,28527,990,959,1012,2961,0.103796403
Houston,77036,76096,2509,2670,2719,7898,0.10378995
Los Angeles,90602,25677,821,901,943,2665,0.103789383
Lincoln & Hastings-Krny,68510,21303,592,869,750,2211,0.103788199
Atlanta,30012,31488,1186,1102,980,3268,0.103785569
Los Angeles,92354,23809,626,755,1090,2471,0.103784283
Fresno-Visalia,93620,10493,425,367,297,1089,0.103783475
Cincinnati,41071,19004,399,602,971,1972,0.103767628
Los Angeles,90057,44081,1207,1615,1752,4574,0.103763526
Los Angeles,90302,29057,828,944,1243,3015,0.103761572
"Jackson, TN",38301,34483,1176,1254,1148,3578,0.103761274
Ft. Wayne,46738,8376,307,296,266,869,0.103748806
Twin Falls,83301,65148,2354,2274,2131,6759,0.103748388
San Antonio,78258,54084,2004,1857,1750,5611,0.103746025
Denver,80124,23442,687,742,1003,2432,0.103745414
Baltimore,21216,27039,881,1041,883,2805,0.103739044
Atlanta,30035,22327,684,728,904,2316,0.103730909
"Washington, DC (Hagrstwn)",20032,37879,1186,1321,1422,3929,0.103725019
Chicago,46324,22233,782,803,721,2306,0.103719696
Wichita-Hutchinson Plus,67216,22813,854,771,741,2366,0.103712795
"Washington, DC (Hagrstwn)",20710,9942,313,358,360,1031,0.103701469
Dallas-Ft. Worth,75070,66731,2187,2176,2557,6920,0.10369993
Austin,78729,30529,595,980,1590,3165,0.103671919
Minneapolis-St. Paul,55412,23219,764,863,780,2407,0.103665102
New York,10451,49816,1643,1791,1730,5164,0.103661474
New York,10931,984,36,36,30,102,0.103658537
San Antonio,78237,35150,1351,1199,1093,3643,0.103641536
San Francisco-Oak-San Jose,95076,81873,2996,2968,2521,8485,0.103636119
Cincinnati,45238,45660,1519,1637,1576,4732,0.103635567
Cincinnati,45067,14928,579,529,439,1547,0.103630761
Little Rock-Pine Bluff,72022,17959,631,574,656,1861,0.103624923
"Rochester, NY",14514,7335,265,255,240,760,0.103612815
New York,11103,36950,518,1132,2178,3828,0.103599459
Atlanta,30013,29547,1048,1007,1006,3061,0.103597658
Oklahoma City,73120,37019,723,1193,1919,3835,0.103595451
Indianapolis,46226,43343,1475,1434,1581,4490,0.103592276
Salt Lake City,84001,724,31,23,21,75,0.10359116
Minneapolis-St. Paul,55107,15844,545,569,527,1641,0.10357233
South Bend-Elkhart,46516,35208,1267,1215,1164,3646,0.10355601
Tulsa,74145,18281,538,631,724,1893,0.103550134
San Diego,92027,55886,1871,1983,1933,5787,0.103550084
Greensboro-H.Point-W.Salem,27107,51119,2017,1799,1477,5293,0.103542714
"Tri-Cities, TN-VA",37601,37993,1169,1361,1403,3933,0.103519069
Louisville,40203,16191,418,586,672,1676,0.103514298
Amarillo,79009,1739,80,57,43,180,0.103507763
St. Louis,63117,10193,226,318,511,1055,0.103502404
San Antonio,78211,29275,1122,976,932,3030,0.103501281
Atlanta,30543,5430,188,199,175,562,0.103499079
Monterey-Salinas,95039,1575,66,48,49,163,0.103492063
Philadelphia,19149,59489,2102,2079,1975,6156,0.103481316
Phoenix (Prescott),85543,6668,296,214,180,690,0.103479304
Phoenix (Prescott),85264,1121,44,38,34,116,0.103479037
Denver,81657,5064,77,138,309,524,0.103475513
Casper-Riverton,82609,18856,614,669,668,1951,0.103468392
Albuquerque-Santa Fe,87114,69084,2349,2417,2382,7148,0.103468242
Lubbock,79357,1846,76,60,55,191,0.103466956
New York,7305,70613,2246,2467,2592,7305,0.103451206
Fargo,58321,116,7,3,2,12,0.103448276
Memphis,72331,2291,91,70,76,237,0.103448276
Orlando-Daytona Bch-Melbrn,34746,68567,2212,2461,2420,7093,0.103446264
Orlando-Daytona Bch-Melbrn,32818,51477,1761,1833,1731,5325,0.103444257
Houston,77396,62151,2307,2028,2094,6429,0.103441618
Dallas-Ft. Worth,75154,52919,2071,1787,1616,5474,0.103441108
Great Falls,59405,33531,962,1331,1175,3468,0.10342668
Salt Lake City,84404,69869,2529,2333,2364,7226,0.103422119
Milwaukee,53404,15345,525,525,537,1587,0.10342131
Seattle-Tacoma,98327,10298,345,339,381,1065,0.103418139
San Francisco-Oak-San Jose,94303,47325,1648,1658,1588,4894,0.103412573
New York,10033,47358,1017,1605,2275,4897,0.10340386
Richmond-Petersburg,23005,19874,747,850,458,2055,0.103401429
Hartford & New Haven,6514,25389,692,1030,903,2625,0.103391232
El Paso (Las Cruces),79907,50643,1738,1831,1667,5236,0.103390399
Little Rock-Pine Bluff,72114,11327,292,370,509,1171,0.103381301
Chicago,60447,15690,658,518,446,1622,0.103377948
Wilkes Barre-Scranton-Hztn,18466,17550,637,626,551,1814,0.103361823
Roanoke-Lynchburg,24013,7682,259,280,255,794,0.1033585
Beaumont-Port Arthur,77702,2593,83,101,84,268,0.103355187
Detroit,48141,25389,906,822,896,2624,0.103351845
Kansas City,64053,5680,187,206,194,587,0.10334507
New York,10708,21976,900,917,454,2271,0.103340007
Great Falls,59501,12214,407,465,390,1262,0.103324054
Miami-Ft. Lauderdale,33143,33954,822,1262,1424,3508,0.103316251
Salt Lake City,84338,513,23,16,14,53,0.10331384
Toledo,43604,8818,212,283,416,911,0.103311408
Indianapolis,46229,29949,1071,1051,972,3094,0.103308959
New York,11417,30223,846,1090,1186,3122,0.103298812
Raleigh-Durham (Fayetvlle),28371,7135,265,250,222,737,0.103293623
Ft. Myers-Naples,33974,19721,773,672,592,2037,0.103290908
Norfolk-Portsmth-Newpt Nws,23702,12141,366,418,470,1254,0.103286385
Shreveport,71108,16663,638,553,530,1721,0.103282722
San Antonio,78069,6071,223,208,196,627,0.103277878
Memphis,38018,36544,1017,1294,1463,3774,0.103272767
Bismarck-Mnt-Dcknsn(Wlstn),57642,1898,85,63,48,196,0.103266596
Colorado Springs-Pueblo,80918,45407,1190,1625,1874,4689,0.103266016
Ft. Smith-Fay-Sprngdl-Rgrs,72923,7476,186,218,368,772,0.103263777
San Antonio,78834,6586,270,231,179,680,0.103249317
Atlanta,30296,30132,969,1059,1083,3111,0.103245719
Atlanta,30088,27624,819,950,1083,2852,0.103243556
Kansas City,66112,12960,431,469,438,1338,0.103240741
Detroit,48211,5308,159,198,191,548,0.103240392
Kansas City,64125,1947,71,75,55,201,0.103235747
Salt Lake City,84005,55820,2368,1634,1760,5762,0.103224651
Los Angeles,91786,55879,1564,1996,2208,5768,0.103223035
Ft. Wayne,46703,19182,726,761,493,1980,0.10322177
"Columbus, OH",43235,45121,1047,1472,2138,4657,0.103211365
San Francisco-Oak-San Jose,94503,22714,829,836,679,2344,0.103196267
Houston,77022,28761,1018,987,963,2968,0.103195299
Rochestr-Mason City-Austin,50436,5698,227,205,156,588,0.103194103
Sacramnto-Stkton-Modesto,95207,51583,1636,1764,1923,5323,0.103192912
Los Angeles,93041,21814,689,778,784,2251,0.103190612
New York,10021,42740,686,1191,2533,4410,0.103182031
St. Louis,62207,6746,206,233,257,696,0.10317225
Sacramnto-Stkton-Modesto,95367,25220,995,873,734,2602,0.103172086
Los Angeles,92647,59999,1630,2117,2443,6190,0.103168386
Denver,81650,14782,543,506,476,1525,0.103166013
San Francisco-Oak-San Jose,94107,32540,302,907,2148,3357,0.103165335
"Columbus, GA (Opelika, AL)",36856,8278,316,279,259,854,0.103165016
Atlanta,30213,46355,1536,1526,1720,4782,0.103160393
Chicago,60411,51622,1815,1776,1734,5325,0.103153694
Tampa-St. Pete (Sarasota),33609,19943,520,647,890,2057,0.10314396
Atlanta,30052,83680,3318,2822,2491,8631,0.103142925
Los Angeles,91343,61304,1966,2194,2163,6323,0.10314172
Dallas-Ft. Worth,75216,54179,2003,1844,1741,5588,0.103139593
Great Falls,59526,2696,106,92,80,278,0.103115727
Salt Lake City,84335,16797,729,529,474,1732,0.103113651
Huntsville-Decatur (Flor),35951,13763,555,455,409,1419,0.103102521
Cincinnati,45177,22638,838,888,608,2334,0.103100981
Tucson (Sierra Vista),85714,12697,440,455,414,1309,0.103095219
Jacksonville,32065,42748,1676,1474,1257,4407,0.103092542
Miami-Ft. Lauderdale,33073,33690,1131,1234,1108,3473,0.103086969
Los Angeles,91352,46370,1554,1581,1645,4780,0.10308389
"Washington, DC (Hagrstwn)",20708,28184,772,994,1139,2905,0.103072665
Chicago,60123,46558,1669,1557,1572,4798,0.103054255
Oklahoma City,73754,1048,40,31,37,108,0.103053435
Dallas-Ft. Worth,75241,31589,1201,1134,920,3255,0.103042198
"Washington, DC (Hagrstwn)",22102,29901,642,987,1452,3081,0.103040032
Los Angeles,92377,20672,743,723,664,2130,0.103037926
New York,11722,39696,1305,1435,1350,4090,0.103033051
New Orleans,70131,26362,827,912,977,2716,0.103027084
Cleveland-Akron (Canton),44633,2611,98,93,78,269,0.103025661
Los Angeles,92230,2679,109,87,80,276,0.103023516
New York,10467,96728,3109,3363,3493,9965,0.103020842
Dallas-Ft. Worth,75010,34231,990,1261,1275,3526,0.103006047
San Diego,92139,34591,1011,1244,1308,3563,0.103003671
Houston,77550,24310,549,947,1008,2504,0.103002879
New York,11559,9029,338,327,265,930,0.10300144
Atlanta,30531,12545,476,452,364,1292,0.102989239
Johnstown-Altoona-St Colge,16852,369,15,12,11,38,0.10298103
Cheyenne-Scottsbluff,82007,21839,731,730,788,2249,0.102980906
Albuquerque-Santa Fe,86503,11139,426,388,333,1147,0.102971541
Evansville,47660,4749,190,158,141,489,0.102969046
Phoenix (Prescott),85128,20550,765,719,632,2116,0.10296837
Macon,31806,4283,181,137,123,441,0.102965211
Greenvll-Spart-Ashevll-And,29615,40462,927,1384,1855,4166,0.102960803
Philadelphia,19032,6926,246,226,241,713,0.102945423
Chicago,60139,31648,994,1076,1188,3258,0.102944894
Atlanta,30360,16660,588,574,553,1715,0.102941176
Salt Lake City,84314,1428,66,50,31,147,0.102941176
Albuquerque-Santa Fe,87731,408,12,25,5,42,0.102941176
Yuma-El Centro,92283,2798,121,96,71,288,0.102930665
"Washington, DC (Hagrstwn)",20121,28244,813,949,1145,2907,0.102924515
Billings,59034,4965,207,167,137,511,0.102920443
Nashville,37127,22805,729,925,693,2347,0.102916027
Albuquerque-Santa Fe,88253,1001,37,34,32,103,0.102897103
Albuquerque-Santa Fe,87053,622,25,20,19,64,0.102893891
Amarillo,79027,4636,194,160,123,477,0.102890423
Hartford & New Haven,6380,2848,99,90,104,293,0.102879213
Atlanta,30315,38181,1122,1305,1501,3928,0.102878395
Houston,77041,35888,1220,1337,1135,3692,0.102875613
Dallas-Ft. Worth,75401,19063,652,636,673,1961,0.102869433
Abilene-Sweetwater,76437,5619,259,184,135,578,0.102865279
Minneapolis-St. Paul,55119,43363,1380,1460,1620,4460,0.102852662
Minneapolis-St. Paul,56303,27983,713,1046,1119,2878,0.102848158
Los Angeles,92663,20546,351,623,1139,2113,0.102842402
Houston,77357,39521,1556,1326,1182,4064,0.102831406
Madison,53718,18993,392,673,888,1953,0.102827357
"Washington, DC (Hagrstwn)",22204,53060,1157,1660,2639,5456,0.102826988
Boise,83702,25558,629,922,1077,2628,0.102824947
Miami-Ft. Lauderdale,33030,40801,1476,1452,1267,4195,0.102816107
New Orleans,70086,1634,54,60,54,168,0.102815177
Sioux City,51111,107,3,3,5,11,0.102803738
Salt Lake City,84067,39882,1427,1253,1420,4100,0.10280327
New York,11204,84338,2830,3001,2839,8670,0.102800636
Yakima-Pasco-Rchlnd-Knnwck,97838,28827,1084,985,894,2963,0.102785583
Amarillo,79098,467,22,16,10,48,0.102783726
San Antonio,78203,5322,202,178,167,547,0.102780909
Salt Lake City,89801,26659,970,868,902,2740,0.102779549
Minneapolis-St. Paul,56377,22194,815,793,673,2281,0.102775525
Toledo,43612,28101,1009,994,885,2888,0.102772143
Kansas City,64134,21261,706,719,760,2185,0.102770331
Green Bay-Appleton,54303,28677,804,1001,1142,2947,0.102765282
Syracuse,13053,4739,206,164,117,487,0.102764296
Austin,78703,21963,462,644,1151,2257,0.102763739
Tampa-St. Pete (Sarasota),33563,27756,1006,937,909,2852,0.102752558
Springfield-Holyoke,1104,23504,827,819,769,2415,0.102748468
Wichita-Hutchinson Plus,67212,43456,1298,1431,1736,4465,0.102747607
New York,12507,146,5,9,1,15,0.102739726
St. Joseph,64501,10590,307,362,419,1088,0.102738432
"Rochester, NY",14615,15934,472,532,633,1637,0.102736287
Albany-Schenectady-Troy,12204,8264,216,314,319,849,0.102734753
Bismarck-Mnt-Dcknsn(Wlstn),58763,4828,184,170,142,496,0.102734051
San Diego,91911,87667,2883,3126,2997,9006,0.102729647
Cleveland-Akron (Canton),44302,4770,104,170,216,490,0.102725367
Shreveport,71832,10095,396,349,292,1037,0.102724121
"Columbia, SC",29229,55493,2170,1895,1635,5700,0.102715658
Kansas City,66204,19590,415,622,975,2012,0.102705462
Cedar Rapids-Wtrlo-IWC&Dub,52233,6660,186,226,272,684,0.102702703
Johnstown-Altoona-St Colge,16601,31775,989,1406,868,3263,0.102690795
Topeka,66503,16888,443,565,726,1734,0.102676457
New York,7524,13218,447,438,472,1357,0.102663035
Memphis,38105,6264,160,218,265,643,0.102650064
Providence-New Bedford,2860,49041,1464,1709,1861,5034,0.102648804
Salt Lake City,84302,27941,1097,962,809,2868,0.102644859
Amarillo,79035,5378,188,194,170,552,0.102640387
Augusta-Aiken,29801,28342,1004,1051,854,2909,0.102639193
Austin,78626,51358,1856,1778,1637,5271,0.102632501
Dallas-Ft. Worth,76177,32096,998,1011,1285,3294,0.102629611
Portland-Auburn,4011,22401,821,938,540,2299,0.102629347
Salt Lake City,83237,1793,67,57,60,184,0.102621305
Yakima-Pasco-Rchlnd-Knnwck,99350,13789,546,497,372,1415,0.102618029
Tampa-St. Pete (Sarasota),33578,66378,1925,2186,2700,6811,0.102609298
Tulsa,74108,8089,256,267,307,830,0.102608481
Tyler-Longview(Lfkn&Ncgd),75604,30992,1053,1078,1049,3180,0.102607124
Memphis,38635,13771,498,530,385,1413,0.102606928
Madison,53511,49189,1763,1857,1427,5047,0.102604241
Denver,80601,43943,1582,1366,1560,4508,0.102587443
Bluefield-Beckley-Oak Hill,24962,195,6,4,10,20,0.102564103
Cleveland-Akron (Canton),44624,7215,281,237,222,740,0.102564103
Shreveport,71406,195,8,6,6,20,0.102564103
El Paso (Las Cruces),87940,195,7,8,5,20,0.102564103
Chicago,60436,18097,629,627,600,1856,0.102558435
Houston,77080,47903,1575,1675,1662,4912,0.102540551
Phoenix (Prescott),85139,19056,765,656,533,1954,0.102539882
St. Louis,63042,19027,553,624,774,1951,0.102538498
Boise,83686,62183,2353,2156,1867,6376,0.102536063
Montgomery-Selma,36066,23592,779,838,802,2419,0.102534758
Miami-Ft. Lauderdale,33327,21828,1137,742,359,2238,0.102528862
Chicago,60504,39015,1365,1321,1314,4000,0.10252467
Springfield-Holyoke,1151,9032,337,322,267,926,0.102524358
Meridian,35460,478,16,16,17,49,0.10251046
Wichita-Hutchinson Plus,67217,30612,1081,1013,1044,3138,0.10250882
Los Angeles,90650,98169,3047,3492,3524,10063,0.102506901
Omaha,68661,7424,321,254,186,761,0.102505388
"Portland, OR",97032,5190,201,185,146,532,0.102504817
Cincinnati,45211,38809,1207,1314,1457,3978,0.102501997
"Jackson, TN",38305,52946,1550,2213,1664,5427,0.102500661
Los Angeles,92530,61182,2184,2121,1966,6271,0.102497467
Utica,13502,32998,1196,1141,1045,3382,0.10249106
Los Angeles,91762,65192,2164,2181,2336,6681,0.1024819
Sioux Falls(Mitchell),57221,810,37,27,19,83,0.102469136
Sacramnto-Stkton-Modesto,95953,11663,466,390,339,1195,0.102460773
Birmingham (Ann and Tusc),35443,937,31,37,28,96,0.102454642
Cleveland-Akron (Canton),44313,26637,548,896,1285,2729,0.102451477
San Francisco-Oak-San Jose,94531,50562,1630,1802,1748,5180,0.102448479
Indianapolis,47384,1767,68,61,52,181,0.102433503
Dallas-Ft. Worth,76135,21636,688,768,760,2216,0.102421889
Ft. Wayne,46825,29662,730,975,1333,3038,0.102420605
Dallas-Ft. Worth,75223,13689,459,481,462,1402,0.102418
"Albany, GA",31533,16766,566,600,551,1717,0.102409639
Harrisburg-Lncstr-Leb-York,17022,32120,1130,1283,876,3289,0.10239726
Amarillo,79110,19239,638,604,728,1970,0.102396174
"Washington, DC (Hagrstwn)",22206,21603,372,677,1163,2212,0.102393186
Omaha,68110,9777,344,346,311,1001,0.102383144
Bismarck-Mnt-Dcknsn(Wlstn),58801,35143,1053,1220,1325,3598,0.102381698
Hartford & New Haven,6513,37332,1281,1282,1259,3822,0.102378656
Rapid City,57551,2442,105,86,59,250,0.102375102
Harrisburg-Lncstr-Leb-York,17509,4601,186,140,145,471,0.10236905
Orlando-Daytona Bch-Melbrn,32832,43512,1624,1395,1435,4454,0.102362567
Atlanta,30099,508,18,16,18,52,0.102362205
Phoenix (Prescott),85379,51094,2043,1681,1506,5230,0.102360355
Los Angeles,91730,70804,2073,2511,2663,7247,0.102352974
Fresno-Visalia,95333,4104,150,150,120,420,0.102339181
Clarksburg-Weston,26201,18566,647,750,503,1900,0.102337606
Providence-New Bedford,2746,17052,527,595,623,1745,0.102334037
Los Angeles,92311,34489,1321,1148,1060,3529,0.10232248
New Orleans,70119,37571,682,1219,1943,3844,0.102312954
El Paso (Las Cruces),79905,22423,801,800,693,2294,0.102305668
Chicago,60402,62230,2066,2167,2133,6366,0.102297927
Greensboro-H.Point-W.Salem,27203,22230,694,775,805,2274,0.102294197
Houston,77071,25467,820,889,896,2605,0.102289237
Orlando-Daytona Bch-Melbrn,34786,42723,1617,1362,1391,4370,0.102286824
Oklahoma City,73107,27348,767,915,1115,2797,0.102274389
Oklahoma City,73160,62580,2157,2049,2194,6400,0.102269096
San Antonio,78228,56314,2108,1908,1743,5759,0.102265866
Los Angeles,90715,19684,612,683,718,2013,0.1022658
Spokane,99201,16800,258,602,858,1718,0.102261905
"Lafayette, LA",70508,42099,1153,1417,1735,4305,0.102258961
Salt Lake City,84664,15011,724,502,309,1535,0.102258344
Oklahoma City,73701,24497,955,807,743,2505,0.102257419
New York,10927,12459,399,437,438,1274,0.102255398
Los Angeles,91761,67518,2159,2216,2529,6904,0.102254214
Kansas City,64138,25339,770,854,967,2591,0.102253443
Nashville,37345,2308,81,88,67,236,0.102253033
Wichita Falls & Lawton,73540,489,18,18,14,50,0.102249489
Dallas-Ft. Worth,75069,41048,1347,1441,1409,4197,0.102246151
Albuquerque-Santa Fe,88232,1966,70,70,61,201,0.102238047
Monterey-Salinas,93940,33246,785,1239,1375,3399,0.102237863
Colorado Springs-Pueblo,80920,41071,1338,1344,1517,4199,0.102237589
Omaha,68157,6397,215,209,230,654,0.102235423
Boston (Manchester),3857,9488,197,291,482,970,0.102234401
Dallas-Ft. Worth,75094,23810,1187,824,423,2434,0.102225955
San Antonio,78214,21834,775,758,699,2232,0.102225886
Beaumont-Port Arthur,77642,38426,1288,1301,1339,3928,0.102222454
Sioux Falls(Mitchell),57321,362,14,14,9,37,0.102209945
San Diego,91913,56865,2085,1863,1864,5812,0.102206981
South Bend-Elkhart,46517,24412,884,905,706,2495,0.102203834
San Francisco-Oak-San Jose,94123,25959,225,507,1921,2653,0.102199622
Louisville,42718,26723,971,968,792,2731,0.10219661
Dallas-Ft. Worth,76001,34405,1285,1156,1075,3516,0.102194448
Salt Lake City,89831,1096,45,40,27,112,0.102189781
Cedar Rapids-Wtrlo-IWC&Dub,52340,5001,140,171,200,511,0.102179564
San Francisco-Oak-San Jose,94103,40716,434,1203,2523,4160,0.102171137
Las Vegas,89107,37115,1299,1276,1217,3792,0.102168934
Shreveport,75455,27742,1043,963,828,2834,0.102155576
Idaho Fals-Pocatllo(Jcksn),83451,979,39,32,29,100,0.102145046
Omaha,51510,3652,141,123,109,373,0.102135816
Louisville,40218,32899,941,1180,1239,3360,0.102130764
Greenvll-Spart-Ashevll-And,28804,24322,920,914,650,2484,0.102129759
Detroit,48223,22407,723,747,818,2288,0.102110947
Denver,80233,45501,1294,1600,1752,4646,0.102107646
New York,10705,41623,1358,1465,1427,4250,0.102107008
Tampa-St. Pete (Sarasota),33610,47529,1594,1618,1641,4853,0.102106083
Harlingen-Wslco-Brnsvl-Mca,78569,5377,212,196,141,549,0.102101544
Bakersfield,93461,1479,60,55,36,151,0.102096011
Montgomery-Selma,36720,764,28,29,21,78,0.102094241
Birmingham (Ann and Tusc),35446,2341,95,76,68,239,0.102093123
Tampa-St. Pete (Sarasota),34208,40328,1357,1388,1372,4117,0.102087879
Philadelphia,19132,33315,1062,1140,1199,3401,0.102086147
Chicago,60426,22707,783,792,743,2318,0.102083058
Champaign&Sprngfld-Decatur,61874,7837,221,325,254,800,0.102079878
New York,10532,6877,208,313,181,702,0.102079395
San Diego,91914,16880,663,595,465,1723,0.10207346
Kansas City,64635,627,13,16,35,64,0.102073365
Idaho Fals-Pocatllo(Jcksn),83402,31109,1060,1070,1045,3175,0.102060497
Bakersfield,93215,53302,1971,1861,1608,5440,0.10205996
Boston (Manchester),2462,1558,63,64,32,159,0.102053915
Kansas City,66223,26203,806,924,944,2674,0.102049384
Lexington,40376,98,3,4,3,10,0.102040816
Houston,77047,34988,1281,1138,1151,3570,0.102034983
Chicago,60432,19357,766,661,548,1975,0.102030273
San Francisco-Oak-San Jose,94133,25748,263,740,1624,2627,0.102027342
Corpus Christi,78414,46574,1571,1457,1723,4751,0.102009705
New York,7088,3990,134,148,125,407,0.102005013
Greenwood-Greenville,38753,1098,59,30,23,112,0.102003643
Boston (Manchester),1604,40872,1064,1381,1724,4169,0.10200137
Birmingham (Ann and Tusc),35242,60217,1797,2124,2221,6142,0.101997775
Philadelphia,19310,2755,94,98,89,281,0.10199637
Casper-Riverton,82601,27218,969,982,825,2776,0.101991329
Boise,83704,42506,1079,1469,1787,4335,0.101985602
Salt Lake City,84701,9119,409,266,255,930,0.101984867
Atlanta,30620,16679,658,559,484,1701,0.101984531
Albany-Schenectady-Troy,12125,1481,66,51,34,151,0.101958136
Idaho Fals-Pocatllo(Jcksn),83202,23422,901,783,704,2388,0.101955427
San Diego,92114,63876,2073,2242,2197,6512,0.101947523
Kansas City,64131,23983,597,768,1080,2445,0.101947213
Corpus Christi,78415,38973,1357,1364,1252,3973,0.10194237
San Francisco-Oak-San Jose,95111,56741,1889,1963,1932,5784,0.101936871
Boston (Manchester),1810,36876,1479,1470,810,3759,0.101936219
Philadelphia,8021,51730,1467,1760,2046,5273,0.101933114
Miami-Ft. Lauderdale,33033,67183,2500,2296,2052,6848,0.101930548
Detroit,48225,15464,566,541,469,1576,0.101914123
Peoria-Bloomington,61605,13728,472,476,451,1399,0.101908508
Syracuse,13205,17997,549,596,689,1834,0.101905873
Sacramnto-Stkton-Modesto,95828,62731,2296,2153,1943,6392,0.101895395
Louisville,40215,21130,667,704,782,2153,0.101893043
Seattle-Tacoma,98004,41909,905,1409,1956,4270,0.101887423
Salt Lake City,83286,1590,84,49,29,162,0.101886792
Sioux City,68776,16078,617,526,495,1638,0.101878343
Chicago,60435,48010,1605,1667,1619,4891,0.101874609
Spokane,99031,1551,62,46,50,158,0.101869761
Grand Rapids-Kalmzoo-B.Crk,49442,42718,1461,1475,1415,4351,0.101854019
San Diego,91980,108,4,4,3,11,0.101851852
New York,10310,27533,932,971,901,2804,0.101841427
South Bend-Elkhart,46601,5921,179,214,210,603,0.101840905
Oklahoma City,73601,9506,354,343,271,968,0.101830423
Houston,77420,2416,90,89,67,246,0.101821192
Odessa-Midland,79761,29584,1057,951,1004,3012,0.10181179
Little Rock-Pine Bluff,72204,32472,1170,1170,966,3306,0.101810791
Phoenix (Prescott),86025,5481,221,165,172,558,0.10180624
Montgomery-Selma,36083,7603,270,257,247,774,0.10180192
Chicago,60459,29108,1014,1012,937,2963,0.101793321
Dallas-Ft. Worth,76051,52126,1393,1849,2064,5306,0.101791812
Joplin-Pittsburg,74339,2289,89,76,68,233,0.101791175
Seattle-Tacoma,98125,43151,788,1317,2287,4392,0.101782114
"Lafayette, LA",70501,29564,930,1122,957,3009,0.101779191
San Francisco-Oak-San Jose,94609,24947,328,795,1416,2539,0.101775765
Sacramnto-Stkton-Modesto,95843,49916,1743,1775,1562,5080,0.101770975
Philadelphia,8232,19770,625,680,707,2012,0.101770359
Savannah,31301,4245,144,120,168,432,0.101766784
Bakersfield,93301,14034,441,468,519,1428,0.101752886
Atlanta,30135,71146,2596,2421,2222,7239,0.101748517
Boston (Manchester),3060,31631,908,1115,1195,3218,0.101735639
"Columbus, OH",43206,21694,491,620,1096,2207,0.101733198
Boston (Manchester),2148,66794,1459,2043,3293,6795,0.101730694
New York,11369,41073,1189,1409,1580,4178,0.101721325
Bangor,4609,5230,166,213,153,532,0.101720841
Santabarbra-Sanmar-Sanluob,93103,18404,508,644,720,1872,0.101717018
"Albany, GA",31650,3156,123,111,87,321,0.101711027
Los Angeles,91321,33851,1126,1157,1160,3443,0.101710437
Sioux City,51011,59,3,2,1,6,0.101694915
Wichita-Hutchinson Plus,67055,59,2,2,2,6,0.101694915
Traverse City-Cadillac,49783,18084,600,696,543,1839,0.101692104
Lansing,49224,13020,429,582,313,1324,0.101689708
Nashville,38456,5035,205,160,147,512,0.101688183
Elmira (Corning),14901,13581,505,476,400,1381,0.101686179
Kansas City,64056,16807,606,539,564,1709,0.101683822
Rockford,61102,16886,601,597,519,1717,0.101681867
Greensboro-H.Point-W.Salem,27105,40794,1496,1427,1225,4148,0.10168162
Boston (Manchester),1905,27617,968,911,929,2808,0.101676504
Chicago,60621,28937,932,1003,1007,2942,0.101669143
Mobile-Pensacola (Ft Walt),32547,36649,1032,1241,1453,3726,0.101667167
Baton Rouge,70819,5066,206,173,136,515,0.101658113
Birmingham (Ann and Tusc),36277,5371,182,172,192,546,0.101657047
Harlingen-Wslco-Brnsvl-Mca,78583,5617,219,189,163,571,0.101655688
Houston,77591,18524,604,642,637,1883,0.101651911
San Francisco-Oak-San Jose,94806,63366,2041,2184,2216,6441,0.101647571
Los Angeles,93012,37902,1299,1491,1062,3852,0.101630521
Oklahoma City,74851,11444,377,351,435,1163,0.101625306
Ft. Smith-Fay-Sprngdl-Rgrs,72730,10972,371,348,396,1115,0.101622311
New York,7508,24729,710,996,807,2513,0.101621578
Bangor,4421,1299,55,64,13,132,0.101616628
Lexington,40324,54383,2013,1782,1731,5526,0.101612636
Dayton,45403,15638,485,521,583,1589,0.101611459
Chattanooga,37410,4606,166,148,154,468,0.1016066
Buffalo,14726,2008,80,70,54,204,0.101593625
Sioux Falls(Mitchell),57401,32189,1128,1170,972,3270,0.101587499
New York,10023,62176,1819,1909,2588,6316,0.101582604
Fresno-Visalia,93727,90161,3215,2973,2970,9158,0.101573851
Amarillo,79106,27538,879,970,948,2797,0.101568741
New York,10469,67492,2008,2417,2430,6855,0.101567593
Harrisburg-Lncstr-Leb-York,17602,53758,1555,1904,2001,5460,0.101566279
Seattle-Tacoma,98848,14415,587,475,402,1464,0.101560874
Amarillo,73942,14514,575,480,419,1474,0.101557117
Dallas-Ft. Worth,76055,3220,126,103,98,327,0.101552795
Minneapolis-St. Paul,55407,36761,1079,1320,1334,3733,0.101547836
San Diego,92107,26571,540,880,1278,2698,0.101539272
Chicago,60538,31398,1234,1008,946,3188,0.10153513
Las Vegas,89143,14668,590,470,429,1489,0.101513499
Los Angeles,90660,59057,1777,2057,2161,5995,0.101512098
Fresno-Visalia,93720,49465,1484,1724,1813,5021,0.101506115
Dallas-Ft. Worth,75125,8207,314,280,239,833,0.101498721
Los Angeles,92840,53984,1633,1812,2034,5479,0.101493035
Miami-Ft. Lauderdale,33328,28821,986,1046,893,2925,0.101488498
Jacksonville,31548,25087,788,847,911,2546,0.101486826
Lincoln & Hastings-Krny,68901,26102,914,924,811,2649,0.101486476
Chicago,60164,21402,715,750,707,2172,0.101485842
St. Louis,62022,1084,41,47,22,110,0.101476015
Abilene-Sweetwater,79603,24264,890,811,761,2462,0.101467194
Sacramnto-Stkton-Modesto,95212,32159,1199,1065,999,3263,0.101464598
Sioux City,68701,30967,1024,1160,958,3142,0.101462848
Salt Lake City,84315,10133,435,349,244,1028,0.101450706
Oklahoma City,73734,621,28,21,14,63,0.101449275
Salt Lake City,84013,4623,165,119,185,469,0.101449275
"Portland, OR",97071,32639,1241,1084,985,3310,0.101412421
Miami-Ft. Lauderdale,33190,14101,529,458,443,1430,0.101411247
Atlanta,30019,53846,2208,1778,1474,5460,0.10140029
Tucson (Sierra Vista),85634,5217,200,168,161,529,0.101399272
Los Angeles,90250,94784,2922,3182,3507,9611,0.10139897
Chicago,60617,74467,2463,2601,2486,7550,0.101387192
Philadelphia,8542,3245,95,104,130,329,0.101386749
Cincinnati,40355,217,9,8,5,22,0.101382488
Amarillo,79001,217,11,7,4,22,0.101382488
Salt Lake City,84018,217,10,7,5,22,0.101382488
New York,11550,61494,2013,2136,2085,6234,0.101375744
Sacramnto-Stkton-Modesto,95376,53930,1922,1869,1676,5467,0.101372149
Buffalo,14204,9204,274,307,352,933,0.10136897
Detroit,48342,19148,613,646,682,1941,0.101368289
St. Louis,63653,1243,43,46,37,126,0.101367659
Lubbock,79359,2634,113,88,66,267,0.101366743
Baton Rouge,70815,28305,936,946,987,2869,0.101360184
Kansas City,66104,26937,1013,934,783,2730,0.101347589
Wichita-Hutchinson Plus,67219,13400,509,410,439,1358,0.101343284
Phoenix (Prescott),85023,34635,1016,1182,1312,3510,0.101342573
Lansing,49202,19757,584,657,761,2002,0.101331174
Harlingen-Wslco-Brnsvl-Mca,78575,5961,212,218,174,604,0.101325281
New Orleans,70128,18052,626,613,590,1829,0.101318413
Houston,77092,37143,1198,1260,1305,3763,0.101311149
Dallas-Ft. Worth,75044,51322,1407,1666,2126,5199,0.101301586
Little Rock-Pine Bluff,72113,26104,761,879,1004,2644,0.101287159
Denver,80247,28908,545,966,1417,2928,0.101286841
San Antonio,78065,12520,454,455,359,1268,0.101277955
Colorado Springs-Pueblo,80906,38568,1039,1361,1506,3906,0.101275669
Orlando-Daytona Bch-Melbrn,32751,26109,635,873,1136,2644,0.101267762
Buffalo,14897,790,29,27,24,80,0.101265823
Los Angeles,92332,79,3,3,2,8,0.101265823
Detroit,48218,7150,264,239,221,724,0.101258741
Boise,83628,5462,198,192,163,553,0.101244965
San Antonio,78840,46367,1675,1615,1404,4694,0.101235793
"Portland, OR",97322,39117,1136,1364,1460,3960,0.101234757
Houston,77373,71232,2546,2310,2355,7211,0.101232592
Cleveland-Akron (Canton),44707,9257,300,303,334,937,0.101220698
Buffalo,14210,15840,482,522,599,1603,0.101199495
Denver,80640,11532,440,374,353,1167,0.10119667
Macon,31206,26414,946,885,842,2673,0.101196335
Little Rock-Pine Bluff,72562,2174,74,82,64,220,0.101195952
Oklahoma City,73647,2342,91,81,65,237,0.101195559
Joplin-Pittsburg,64854,4852,175,154,162,491,0.101195383
Shreveport,71115,15021,429,535,556,1520,0.101191665
Cleveland-Akron (Canton),44689,504,20,17,14,51,0.101190476
Albuquerque-Santa Fe,87052,3202,110,108,106,324,0.101186758
Seattle-Tacoma,98057,14242,241,481,719,1441,0.10117961
Tulsa,74017,29999,998,1083,954,3035,0.101170039
Philadelphia,19140,50234,1674,1640,1768,5082,0.101166541
Atlanta,30331,62709,2019,2027,2298,6344,0.101165702
San Francisco-Oak-San Jose,94565,101271,3469,3457,3319,10245,0.101164203
Memphis,38119,23251,532,781,1039,2352,0.101156939
Tulsa,74128,13099,447,466,412,1325,0.10115276
Sacramnto-Stkton-Modesto,95834,39793,1173,1290,1562,4025,0.101148443
Atlanta,30152,43565,1597,1535,1274,4406,0.101136233
Chicago,60429,14397,506,520,430,1456,0.10113218
Ft. Smith-Fay-Sprngdl-Rgrs,72712,41996,1359,1431,1457,4247,0.101128679
Chicago,60073,60962,2302,1981,1882,6165,0.101128572
Wilkes Barre-Scranton-Hztn,18419,5053,221,194,96,511,0.101128043
Amarillo,79007,13488,512,467,385,1364,0.101126928
Paducah-Cape Girard-Harsbg,42047,178,9,5,4,18,0.101123596
"Albany, GA",31642,4727,170,150,158,478,0.101121219
El Paso (Las Cruces),79932,30729,1158,995,954,3107,0.101109701
San Francisco-Oak-San Jose,94710,10009,180,301,531,1012,0.101109002
Salt Lake City,84742,455,19,13,14,46,0.101098901
Tallahassee-Thomasville,32343,3462,141,112,97,350,0.101097631
Corpus Christi,78417,3472,120,113,118,351,0.10109447
Fresno-Visalia,95301,41675,1553,1465,1195,4213,0.101091782
Detroit,48423,34009,1055,1090,1293,3438,0.101090888
Detroit,48146,38555,1242,1318,1337,3897,0.101076384
Kansas City,64118,42988,1121,1441,1783,4345,0.101074719
Philadelphia,19503,1306,37,41,54,132,0.101071975
Orlando-Daytona Bch-Melbrn,32773,36618,1208,1200,1293,3701,0.101070512
Minneapolis-St. Paul,56187,15168,586,511,436,1533,0.101068038
Los Angeles,90404,22381,415,741,1106,2262,0.10106787
Philadelphia,19014,21798,655,955,593,2203,0.101064318
Tyler-Longview(Lfkn&Ncgd),75708,8609,310,296,264,870,0.101057033
Greenville-N.Bern-Washngtn,28574,19405,663,572,726,1961,0.101056429
Phoenix (Prescott),86044,3325,149,115,72,336,0.101052632
Harrisburg-Lncstr-Leb-York,17562,4473,170,142,140,452,0.101050749
Sacramnto-Stkton-Modesto,95204,30263,1097,991,970,3058,0.101047484
San Diego,92025,51511,1748,1777,1680,5205,0.101046378
Los Angeles,91405,51858,1419,1713,2108,5240,0.101045162
Green Bay-Appleton,54935,43101,1429,1461,1465,4355,0.101041739
Atlanta,30252,51643,2037,1730,1451,5218,0.101039831
Kansas City,66101,14243,504,471,464,1439,0.101032086
Los Angeles,91790,46288,1347,1547,1782,4676,0.101019703
Baton Rouge,70805,25530,871,855,853,2579,0.10101841
Amarillo,79070,9335,379,336,228,943,0.101017675
Pittsburgh,15031,396,18,12,10,40,0.101010101
Harrisburg-Lncstr-Leb-York,17002,792,30,27,23,80,0.101010101
Dallas-Ft. Worth,75126,92365,3763,2993,2573,9329,0.101001462
Dallas-Ft. Worth,75152,6317,253,208,177,638,0.100997309
Birmingham (Ann and Tusc),35442,5743,128,183,269,580,0.100992513
New York,11950,16438,552,575,533,1660,0.100985521
Syracuse,13441,812,27,27,28,82,0.100985222
"Portland, OR",98661,50366,1399,1755,1932,5086,0.10098082
Dallas-Ft. Worth,76180,39147,1047,1399,1507,3953,0.100978364
Clarksburg-Weston,26416,6952,262,293,147,702,0.100978136
El Paso (Las Cruces),88012,34929,1234,1173,1120,3527,0.100976266
Milwaukee,53216,29810,1034,1049,927,3010,0.100972828
San Francisco-Oak-San Jose,94542,14827,385,498,614,1497,0.100964457
Yakima-Pasco-Rchlnd-Knnwck,99343,3318,132,122,81,335,0.100964436
Charlotte,28215,64857,2258,2151,2139,6548,0.100960575
New York,10926,3764,141,125,114,380,0.100956429
Albany-Schenectady-Troy,12209,10163,291,396,339,1026,0.100954443
Houston,77489,37938,1358,1286,1186,3830,0.100954188
San Antonio,78839,7222,246,254,229,729,0.100941567
Flint-Saginaw-Bay City,48529,9362,255,320,370,945,0.10093997
New York,11106,40009,637,1132,2269,4038,0.100927291
"Springfield, MO",65804,40749,997,1450,1665,4112,0.100910452
Billings,59003,773,30,29,19,78,0.100905563
Charlotte,28027,86124,2995,2777,2918,8690,0.100901026
Austin,78732,18494,974,600,292,1866,0.100897588
"Columbia, SC",29172,9614,335,286,349,970,0.100894529
"Jackson, MS",39665,1120,50,34,29,113,0.100892857
Dallas-Ft. Worth,75119,30528,1074,1033,973,3080,0.100890985
Philadelphia,19003,13798,410,523,459,1392,0.100884186
Idaho Fals-Pocatllo(Jcksn),83406,19322,795,618,536,1949,0.100869475
Albuquerque-Santa Fe,87413,14316,535,480,429,1444,0.100866164
Sacramnto-Stkton-Modesto,95322,10321,422,339,280,1041,0.10086232
Sacramnto-Stkton-Modesto,95203,17837,597,597,605,1799,0.100857768
Houston,77095,69068,2247,2378,2341,6966,0.100857126
Oklahoma City,73112,30184,726,938,1380,3044,0.100848131
Colorado Springs-Pueblo,80917,30205,781,993,1272,3046,0.100844231
"Springfield, MO",65734,3342,132,108,97,337,0.100837822
Toledo,43615,39172,982,1333,1635,3950,0.100837333
"Columbia, SC",29162,2509,99,91,63,253,0.100836987
Atlanta,30141,25309,852,819,881,2552,0.100833696
Phoenix (Prescott),85143,45286,1807,1449,1310,4566,0.100825862
Denver,80214,27503,554,896,1323,2773,0.100825365
Los Angeles,92532,27920,1043,885,887,2815,0.100823782
Cleveland-Akron (Canton),44601,33147,1166,1227,949,3342,0.100823604
Quincy-Hannibal-Keokuk,63401,21882,801,800,605,2206,0.100813454
Bowling Green,42160,2381,84,88,68,240,0.100797984
Cedar Rapids-Wtrlo-IWC&Dub,52046,2391,88,72,81,241,0.100794647
Norfolk-Portsmth-Newpt Nws,23602,41711,1095,1326,1783,4204,0.100788761
Dallas-Ft. Worth,76207,22474,514,874,877,2265,0.100783127
San Antonio,78877,1022,38,35,30,103,0.100782779
Lincoln & Hastings-Krny,68801,30056,1028,976,1025,3029,0.100778547
Atlanta,30014,41711,1504,1400,1299,4203,0.100764786
Miami-Ft. Lauderdale,33170,18350,650,630,569,1849,0.100762943
San Francisco-Oak-San Jose,94612,23987,236,825,1356,2417,0.100762913
Charleston-Huntington,41263,526,21,15,17,53,0.100760456
Harlingen-Wslco-Brnsvl-Mca,78563,397,16,15,9,40,0.100755668
New York,7017,39671,1184,1328,1485,3997,0.100753699
Burlington-Plattsburgh,3766,10402,174,352,522,1048,0.100749856
New Orleans,70058,40657,1325,1351,1420,4096,0.100745259
Atlanta,30092,35884,1010,1258,1347,3615,0.100741277
Los Angeles,92881,31193,1090,1128,924,3142,0.100727727
Corpus Christi,78410,29710,1086,997,909,2992,0.100706833
Los Angeles,92882,67455,2322,2243,2228,6793,0.100704173
Huntsville-Decatur (Flor),35962,7319,268,257,212,737,0.100696817
Denver,81052,9047,365,300,246,911,0.100696363
Salt Lake City,84043,83148,3556,2465,2351,8372,0.10068793
"Springfield, MO",65583,13815,447,457,487,1391,0.100687658
"Lafayette, IN",47905,43074,1274,1478,1585,4337,0.100687189
Los Angeles,91731,27056,862,943,919,2724,0.100680071
Nashville,37167,70010,2496,2310,2242,7048,0.100671333
Honolulu,96792,52181,1916,1743,1594,5253,0.100668826
Minneapolis-St. Paul,55344,15566,359,557,651,1567,0.100668123
Pittsburgh,15210,25481,721,860,984,2565,0.100663239
Oklahoma City,73115,21122,702,726,698,2126,0.100653347
Chico-Redding,95968,1381,54,44,41,139,0.100651702
Minneapolis-St. Paul,55441,18073,448,604,767,1819,0.100647375
Boston (Manchester),2149,50414,1416,1674,1984,5074,0.100646646
Boston (Manchester),3820,33762,780,1138,1480,3398,0.100645696
Providence-New Bedford,2744,13016,425,451,434,1310,0.10064536
Sacramnto-Stkton-Modesto,95605,15312,465,513,563,1541,0.100640021
"Albany, GA",31647,3379,129,118,93,340,0.100621486
Los Angeles,91360,42240,1449,1637,1164,4250,0.10061553
El Paso (Las Cruces),79930,24649,673,923,884,2480,0.100612601
Birmingham (Ann and Tusc),35957,17474,655,580,523,1758,0.100606616
Raleigh-Durham (Fayetvlle),28304,37605,1092,1252,1439,3783,0.100598325
Billings,59101,42519,1217,1432,1628,4277,0.100590324
Orlando-Daytona Bch-Melbrn,32766,16196,681,550,398,1629,0.10058039
Detroit,48128,11464,382,384,387,1153,0.100575715
Seattle-Tacoma,98032,41694,1067,1435,1691,4193,0.100566029
Boston (Manchester),1902,51320,1599,1738,1824,5161,0.100565082
San Diego,92101,55300,400,1877,3284,5561,0.100560579
Dallas-Ft. Worth,76103,15385,560,544,443,1547,0.100552486
Ft. Smith-Fay-Sprngdl-Rgrs,72762,47431,1629,1546,1594,4769,0.100546056
Salt Lake City,84071,2208,94,78,50,222,0.100543478
Gainesville,32609,18301,477,753,610,1840,0.100540954
Lansing,48864,23534,698,819,849,2366,0.100535396
Orlando-Daytona Bch-Melbrn,32908,17616,637,576,558,1771,0.100533606
Wichita-Hutchinson Plus,67501,24231,844,854,738,2436,0.100532376
Toledo,45840,54898,1749,1940,1830,5519,0.100531896
Denver,80002,19000,429,604,877,1910,0.100526316
New York,11692,22204,686,792,754,2232,0.100522428
Philadelphia,8611,31227,1066,1034,1039,3139,0.100521984
"Lafayette, LA",70532,2557,101,82,74,257,0.100508408
Philadelphia,8401,38328,1165,1467,1220,3852,0.100500939
Ft. Wayne,46835,36778,1015,1156,1525,3696,0.100494861
"Columbus, OH",43220,28072,599,904,1318,2821,0.100491593
Omaha,68128,19984,653,681,674,2008,0.100480384
Boston (Manchester),1845,32249,1368,1132,740,3240,0.100468232
Cleveland-Akron (Canton),44306,20797,644,676,769,2089,0.10044718
Sioux Falls(Mitchell),57110,27070,819,874,1026,2719,0.100443295
Albuquerque-Santa Fe,87105,54748,1946,1863,1690,5499,0.100442025
New York,7503,19853,648,659,687,1994,0.100438221
Houston,77020,25041,823,832,860,2515,0.100435286
South Bend-Elkhart,46526,32809,1188,1107,1000,3295,0.10042976
Dallas-Ft. Worth,75460,21906,733,761,706,2200,0.100429106
Atlanta,30039,48970,1751,1616,1551,4918,0.100428834
Idaho Fals-Pocatllo(Jcksn),83401,54477,2144,1714,1613,5471,0.100427703
Houston,77050,4680,178,149,143,470,0.10042735
"Springfield, MO",65803,43038,1206,1477,1639,4322,0.100422882
Savannah,31322,31708,914,1040,1230,3184,0.100416299
Amarillo,79119,23185,735,771,822,2328,0.100409748
Idaho Fals-Pocatllo(Jcksn),83445,8167,322,277,221,820,0.100404065
Chicago,60445,14423,477,488,483,1448,0.100395202
Houston,77028,19244,732,645,555,1932,0.100394928
"Portland, OR",97124,53352,1330,1726,2300,5356,0.100389864
Charleston-Huntington,25304,8368,259,348,233,840,0.100382409
Sacramnto-Stkton-Modesto,95660,34847,1245,1110,1143,3498,0.100381668
Tyler-Longview(Lfkn&Ncgd),75706,10839,397,361,330,1088,0.100378264
New York,10701,70547,2241,2446,2394,7081,0.100372801
Baltimore,21223,19418,568,655,726,1949,0.10037079
Dallas-Ft. Worth,76086,22976,744,718,844,2306,0.100365599
New York,11713,11080,346,365,401,1112,0.100361011
West Palm Beach-Ft. Pierce,33407,36688,1168,1198,1316,3682,0.100359791
Mobile-Pensacola (Ft Walt),39461,558,22,18,16,56,0.100358423
Dayton,45405,18605,618,618,631,1867,0.100349368
Denver,80230,10145,268,339,411,1018,0.100344998
Philadelphia,19138,30715,1012,1015,1055,3082,0.100341853
Dallas-Ft. Worth,75006,47438,1317,1615,1828,4760,0.100341498
Phoenix (Prescott),85326,83347,3068,2599,2696,8363,0.100339544
San Antonio,78252,32879,1168,1045,1086,3299,0.100337602
Wilkes Barre-Scranton-Hztn,18612,15548,520,684,356,1560,0.100334448
Odessa-Midland,79703,23332,826,694,821,2341,0.100334305
Waco-Temple-Bryan,76528,26372,594,896,1156,2646,0.100333687
"Portland, OR",97233,40835,1271,1346,1480,4097,0.100330599
El Paso (Las Cruces),79915,34756,1206,1154,1127,3487,0.100328001
Indianapolis,46201,31726,957,1049,1177,3183,0.100327807
New York,11230,79261,2430,2706,2816,7952,0.100326769
Salt Lake City,84318,6539,286,230,140,656,0.10032115
Rochestr-Mason City-Austin,55901,60529,1565,1976,2531,6072,0.100315551
Erie,16403,6689,171,192,308,671,0.100313948
San Antonio,78233,51967,1671,1767,1775,5213,0.100313661
Columbia-Jefferson City,65202,49655,1427,1692,1862,4981,0.100312154
Salt Lake City,84542,1605,57,53,51,161,0.100311526
Wilmington,28306,46139,1744,1512,1372,4628,0.100305598
Baton Rouge,39666,10479,436,358,257,1051,0.10029583
Knoxville,37921,29743,897,952,1134,2983,0.100292506
Boston (Manchester),3103,38539,1075,1277,1513,3865,0.10028802
Lubbock,79336,15517,575,514,467,1556,0.100277115
Idaho Fals-Pocatllo(Jcksn),83442,26716,1167,838,674,2679,0.100276988
Austin,78759,38873,864,1142,1892,3898,0.100275255
Baltimore,21206,46726,1447,1596,1642,4685,0.100265377
"Portland, OR",97114,5386,194,190,156,540,0.100259933
New York,10505,778,27,26,25,78,0.100257069
Charleston-Huntington,41260,778,35,21,22,78,0.100257069
Shreveport,71039,1566,66,49,42,157,0.100255428
Topeka,66612,2374,77,93,68,238,0.100252738
Hartford & New Haven,6250,4489,127,190,133,450,0.100245043
Baltimore,21061,56116,1653,1822,2150,5625,0.100238791
Dallas-Ft. Worth,76053,32414,1058,1126,1065,3249,0.100234467
New York,11222,42622,461,1018,2793,4272,0.100229928
Birmingham (Ann and Tusc),35476,9708,222,337,414,973,0.100226617
Odessa-Midland,79714,19147,719,631,569,1919,0.100224578
Houston,77091,28707,955,967,955,2877,0.100219459
"Columbia, SC",29223,53203,1638,1775,1918,5331,0.100201116
Los Angeles,92844,24122,719,839,859,2417,0.100198988
Lubbock,79072,24901,937,843,715,2495,0.100196779
Yakima-Pasco-Rchlnd-Knnwck,99362,43735,1587,1679,1116,4382,0.100194352
"Washington, DC (Hagrstwn)",22079,35312,1247,1221,1070,3538,0.100192569
Corpus Christi,78362,10959,397,394,307,1098,0.100191623
New York,7060,48727,1560,1689,1633,4882,0.100190859
Philadelphia,19095,8076,213,308,288,809,0.100173353
Indianapolis,46240,20565,404,599,1057,2060,0.100170192
Dallas-Ft. Worth,75207,7338,23,187,525,735,0.100163532
Sioux City,51109,3075,100,108,100,308,0.100162602
Salt Lake City,84751,1857,86,52,48,186,0.100161551
Louisville,40160,24231,766,821,840,2427,0.100160951
Los Angeles,92563,72860,2813,2354,2130,7297,0.100150974
Dallas-Ft. Worth,75022,27219,1201,941,584,2726,0.10015063
"Jackson, MS",39175,4224,170,143,110,423,0.100142045
Tulsa,74116,4244,164,137,124,425,0.100141376
Toledo,43613,32594,1004,1065,1195,3264,0.10014113
Twin Falls,83338,22821,933,748,604,2285,0.100127076
Philadelphia,8110,19685,635,687,649,1971,0.100127
Raleigh-Durham (Fayetvlle),27521,7002,230,241,230,701,0.100114253
Baton Rouge,70809,24484,537,809,1105,2451,0.100106192
Los Angeles,92548,7933,298,276,220,794,0.100088239
Rapid City,57701,49434,1454,1733,1760,4947,0.100072824
Houston,77033,27122,951,895,868,2714,0.100066367
Dallas-Ft. Worth,76039,39434,1068,1320,1558,3946,0.100065933
"Jackson, MS",39209,24065,745,798,865,2408,0.100062331
Houston,77484,13273,432,450,446,1328,0.100052739
Cleveland-Akron (Canton),44055,19860,678,682,627,1987,0.100050352
Sacramnto-Stkton-Modesto,95231,4468,143,154,150,447,0.100044763
Miami-Ft. Lauderdale,33161,52227,1607,1813,1805,5225,0.100044039
New Orleans,70079,2879,87,91,110,288,0.100034734
Philadelphia,8618,34379,960,1186,1293,3439,0.100031996
Little Rock-Pine Bluff,72210,16306,525,487,619,1631,0.100024531
New York,7202,43131,1412,1438,1464,4314,0.100020867
Colorado Springs-Pueblo,80925,17158,562,496,658,1716,0.100011656
New York,11421,41687,1166,1440,1563,4169,0.100007196
Bakersfield,93311,56509,2055,1922,1674,5651,0.10000177
"Tri-Cities, TN-VA",24316,30,1,1,1,3,0.1
Montgomery-Selma,36008,30,1,1,1,3,0.1
Kansas City,64476,380,12,16,10,38,0.1
Lincoln & Hastings-Krny,68847,18750,540,575,760,1875,0.1
Tulsa,74368,40,2,1,1,4,0.1
Amarillo,79094,30,1,1,1,3,0.1
Wichita Falls & Lawton,79247,20,1,1,0,2,0.1
Lubbock,79376,80,3,3,2,8,0.1
Salt Lake City,84039,700,36,20,14,70,0.1
Sacramnto-Stkton-Modesto,95209,44284,1677,1493,1258,4428,0.099990967
Meridian,39057,2401,104,84,52,240,0.099958351
Detroit,48075,22980,562,749,986,2297,0.099956484
Watertown,13673,2151,62,71,82,215,0.09995351
Baltimore,21640,1911,64,64,63,191,0.099947671
Los Angeles,90604,40113,1309,1350,1350,4009,0.099942662
St. Louis,62295,1521,53,55,44,152,0.099934254
Hartford & New Haven,6279,5454,125,220,200,545,0.099926659
Cincinnati,41030,6685,254,214,200,668,0.099925206
Los Angeles,90016,48618,1268,1648,1942,4858,0.09992184
San Diego,91963,1251,44,44,37,125,0.099920064
Los Angeles,90640,61495,1827,2090,2227,6144,0.099910562
St. Louis,62206,12271,475,370,381,1226,0.099910358
Philadelphia,8048,12882,421,477,389,1287,0.099906847
Atlanta,30337,12503,336,406,507,1249,0.099896025
Tyler-Longview(Lfkn&Ncgd),75709,6547,179,233,242,654,0.099893081
"Rochester, NY",14842,841,34,25,25,84,0.099881094
San Antonio,78112,10923,417,352,322,1091,0.099880985
"Washington, DC (Hagrstwn)",20695,17372,639,531,565,1735,0.099873359
Dayton,45404,11015,363,347,390,1100,0.099863822
Toledo,49221,40467,1494,1490,1057,4041,0.099859144
Seattle-Tacoma,98047,7050,224,233,247,704,0.099858156
Mobile-Pensacola (Ft Walt),36606,18016,507,575,717,1799,0.099855684
Minneapolis-St. Paul,56201,24886,814,850,821,2485,0.09985534
Philadelphia,8103,12609,435,452,372,1259,0.099849314
Spokane,99216,30937,824,1006,1259,3089,0.099848078
Lexington,40953,621,26,17,19,62,0.099838969
"Washington, DC (Hagrstwn)",20722,7412,224,256,260,740,0.0998381
Houston,77055,46941,1464,1613,1609,4686,0.099827443
Macon,31036,10810,295,345,439,1079,0.099814986
"Portland, OR",97030,38723,1017,1307,1541,3865,0.099811482
New York,7063,14708,510,511,447,1468,0.099809627
Lincoln & Hastings-Krny,68467,9849,351,321,311,983,0.099807087
Dallas-Ft. Worth,76063,84786,3266,2858,2337,8461,0.099792419
"Portland, OR",97113,15292,574,495,457,1526,0.09979074
Mobile-Pensacola (Ft Walt),32505,28610,931,959,965,2855,0.099790283
Atlanta,30008,34403,1112,1104,1217,3433,0.099787809
San Antonio,78220,19083,704,617,583,1904,0.099774669
Los Angeles,92661,3478,63,122,162,347,0.099769983
Raleigh-Durham (Fayetvlle),28377,10855,374,379,330,1083,0.099769691
Boston (Manchester),1852,36865,1044,1327,1307,3678,0.099769429
Harrisburg-Lncstr-Leb-York,17103,12200,429,371,417,1217,0.099754098
West Palm Beach-Ft. Pierce,33463,65716,2350,2250,1955,6555,0.099747398
"Lafayette, LA",70507,18808,618,594,664,1876,0.099744789
Atlanta,30080,55292,1121,1643,2751,5515,0.099743182
New York,8809,7750,176,248,349,773,0.099741935
"Columbia, SC",29168,2938,120,94,79,293,0.099727706
Raleigh-Durham (Fayetvlle),27713,60024,1288,2035,2663,5986,0.099726776
Birmingham (Ann and Tusc),35235,19906,619,661,705,1985,0.099718678
Houston,77518,9848,356,319,307,982,0.099715678
Ft. Smith-Fay-Sprngdl-Rgrs,72768,1394,51,48,40,139,0.099713056
Terre Haute,47885,9357,329,351,253,933,0.099711446
Denver,80030,15144,443,568,499,1510,0.099709456
Lexington,40515,37118,1008,1119,1574,3701,0.099709036
Cedar Rapids-Wtrlo-IWC&Dub,52317,23190,671,670,971,2312,0.099698146
Mankato,56034,662,22,19,25,66,0.099697885
Cleveland-Akron (Canton),44109,38607,1151,1253,1445,3849,0.099696946
Biloxi-Gulfport,39501,22910,676,812,796,2284,0.099694457
Orlando-Daytona Bch-Melbrn,32809,28638,919,973,963,2855,0.099692716
Fresno-Visalia,93277,53094,1880,1750,1663,5293,0.099691114
Boise,83712,9670,245,371,348,964,0.099689762
St. Louis,63074,13713,405,453,509,1367,0.099686429
Spokane,99321,632,27,22,14,63,0.099683544
Yakima-Pasco-Rchlnd-Knnwck,98936,6902,269,228,191,688,0.099681252
"Washington, DC (Hagrstwn)",20111,40249,1317,1296,1399,4012,0.099679495
Lubbock,79423,47302,1627,1495,1593,4715,0.099678661
Des Moines-Ames,50320,24391,794,806,831,2431,0.09966791
Ottumwa-Kirksville,52570,903,29,39,22,90,0.099667774
New York,10974,3763,117,133,125,375,0.099654531
New York,6902,72214,1807,2423,2966,7196,0.099648268
Fargo,56516,281,9,9,10,28,0.099644128
Mobile-Pensacola (Ft Walt),36695,51538,1640,1710,1785,5135,0.099635221
New York,11436,20156,572,662,774,2008,0.099622941
Albuquerque-Santa Fe,87701,18433,598,660,578,1836,0.099603971
Greenvll-Spart-Ashevll-And,29340,20562,759,669,620,2048,0.099601206
Los Angeles,92508,35623,1330,1147,1071,3548,0.099598574
Chicago,60440,50606,1698,1671,1671,5040,0.099592934
Atlanta,30106,24239,790,816,808,2414,0.099591567
Dallas-Ft. Worth,76071,7069,277,226,201,704,0.099589758
Topeka,66611,9710,250,357,360,967,0.099588054
Los Angeles,91752,41416,1449,1370,1305,4124,0.099575043
Tucson (Sierra Vista),85621,22064,850,760,587,2197,0.099573967
Sacramnto-Stkton-Modesto,95240,49511,1702,1689,1539,4930,0.099573832
Phoenix (Prescott),85322,703,25,26,19,70,0.099573257
Los Angeles,91381,23300,896,811,613,2320,0.099570815
Champaign&Sprngfld-Decatur,61802,19052,461,660,776,1897,0.099569599
Meridian,39342,1617,56,53,52,161,0.0995671
Chicago,60471,12625,385,426,446,1257,0.099564356
Milwaukee,53209,43143,1496,1405,1394,4295,0.09955265
Miami-Ft. Lauderdale,33150,28247,894,994,924,2812,0.099550395
Albuquerque-Santa Fe,86505,14747,611,470,387,1468,0.09954567
Hartford & New Haven,6360,36611,1064,1295,1285,3644,0.099532927
Houston,77346,82912,3228,2683,2341,8252,0.09952721
Bismarck-Mnt-Dcknsn(Wlstn),58538,2311,91,81,58,230,0.099524016
Grand Rapids-Kalmzoo-B.Crk,49525,31502,1064,1068,1003,3135,0.099517491
Albany-Schenectady-Troy,12189,19263,498,628,791,1917,0.099517209
Fresno-Visalia,93631,17930,651,572,561,1784,0.099498048
Spokane,99040,995,39,32,28,99,0.099497487
"Columbus, OH",43213,36034,1062,1212,1311,3585,0.099489371
Chicago,60133,35715,1205,1159,1189,3553,0.09948201
Orlando-Daytona Bch-Melbrn,32771,63270,1970,2113,2211,6294,0.099478426
Cleveland-Akron (Canton),44681,8575,296,270,287,853,0.099475219
Nashville,37129,68188,2192,2173,2418,6783,0.099474981
New York,10940,53804,1729,1879,1744,5352,0.099472158
San Diego,92154,88871,2739,3000,3100,8839,0.099458766
Ft. Wayne,46748,7752,295,268,208,771,0.099458204
Austin,78748,57743,1299,1743,2701,5743,0.099457943
Spokane,98837,48805,1674,1692,1488,4854,0.099457023
Memphis,38614,16450,551,560,525,1636,0.099452888
New York,7111,61387,1836,2036,2233,6105,0.099451024
Indianapolis,46933,6536,198,226,226,650,0.099449204
Chicago,60545,14461,539,467,432,1438,0.099439873
Dallas-Ft. Worth,76022,14270,413,459,547,1419,0.099439383
Charleston-Huntington,25701,21541,483,830,829,2142,0.09943828
Harrisburg-Lncstr-Leb-York,17540,11354,401,399,329,1129,0.099436322
Twin Falls,83324,704,28,22,20,70,0.099431818
Cincinnati,45342,37203,1033,1246,1420,3699,0.099427466
Indianapolis,46221,28001,939,910,935,2784,0.099425021
New York,10550,40234,1194,1372,1434,4000,0.099418402
Albuquerque-Santa Fe,87420,10200,413,322,279,1014,0.099411765
"Washington, DC (Hagrstwn)",22554,70535,2615,2275,2122,7012,0.09941164
San Francisco-Oak-San Jose,94509,70789,2355,2344,2338,7037,0.0994081
Baltimore,21030,24777,665,855,943,2463,0.099406708
Colorado Springs-Pueblo,80915,22383,656,708,861,2225,0.099405799
Savannah,31539,14388,497,502,431,1430,0.099388379
"Washington, DC (Hagrstwn)",22193,84365,3034,2861,2488,8383,0.099365851
San Antonio,78207,49052,1719,1579,1576,4874,0.09936394
New York,8536,20181,624,596,785,2005,0.099350875
Baton Rouge,70812,10096,373,330,300,1003,0.099346276
South Bend-Elkhart,46528,27109,1055,881,757,2693,0.099339703
Paducah-Cape Girard-Harsbg,62942,604,23,17,20,60,0.099337748
Sioux City,68062,302,14,5,11,30,0.099337748
Los Angeles,90240,25429,765,866,895,2526,0.099335404
Houston,77327,39576,1572,1296,1063,3931,0.099327875
Augusta-Aiken,30401,13652,462,451,443,1356,0.099326106
San Angelo,76901,31316,956,1026,1128,3110,0.099310257
Houston,77077,62135,1378,2117,2675,6170,0.099299911
West Palm Beach-Ft. Pierce,34981,5852,173,185,223,581,0.099282297
Raleigh-Durham (Fayetvlle),28348,38290,1428,1258,1115,3801,0.099268739
Tulsa,74033,13247,465,421,429,1315,0.099267759
Pittsburgh,15208,9722,260,267,438,965,0.099259412
Atlanta,30121,26053,750,899,937,2586,0.099259202
Syracuse,13207,13672,457,465,435,1357,0.09925395
Philadelphia,8609,14176,457,463,487,1407,0.099252257
Corpus Christi,78390,6106,229,206,171,606,0.099246643
Hattiesburg-Laurel,39440,19397,665,635,625,1925,0.099242151
Greenville-N.Bern-Washngtn,28365,14158,567,483,355,1405,0.09923718
Birmingham (Ann and Tusc),35203,3749,62,120,190,372,0.09922646
St. Louis,62060,4001,134,141,122,397,0.099225194
"Charleston, SC",29418,25780,769,820,969,2558,0.099224205
Ft. Wayne,46962,8597,306,314,233,853,0.099220658
"Washington, DC (Hagrstwn)",20707,37566,1017,1241,1469,3727,0.099212053
San Antonio,78829,887,20,42,26,88,0.099210823
Des Moines-Ames,50315,37328,1135,1254,1314,3703,0.099201672
Harrisburg-Lncstr-Leb-York,17535,2752,99,84,90,273,0.099200581
New York,7011,41848,1320,1440,1391,4151,0.099192315
Wichita-Hutchinson Plus,67001,1835,80,63,39,182,0.099182561
Salt Lake City,82901,27274,1027,850,828,2705,0.099178705
Honolulu,96819,53392,1568,1843,1884,5295,0.099172161
Providence-New Bedford,2838,3802,125,124,128,377,0.099158338
Sacramnto-Stkton-Modesto,94533,79848,2613,2594,2710,7917,0.099150887
Chicago,60409,34090,1114,1146,1120,3380,0.099149311
"Columbus, OH",43068,61545,1940,2071,2091,6102,0.099146966
"Washington, DC (Hagrstwn)",20746,32679,863,1014,1363,3240,0.099146241
Dallas-Ft. Worth,75159,23390,861,753,705,2319,0.099144934
Louisville,40060,1150,46,39,29,114,0.099130435
"Portland, OR",97204,1029,15,41,46,102,0.099125364
New York,7087,70104,2100,2335,2514,6949,0.099124158
Austin,78721,13430,317,395,619,1331,0.099106478
Los Angeles,92346,58475,2053,1882,1860,5795,0.09910218
Houston,77505,23340,713,793,807,2313,0.099100257
Omaha,68005,23441,748,813,762,2323,0.099099868
Philadelphia,19435,111,4,4,3,11,0.099099099
Madison,53809,4218,177,130,111,418,0.099099099
Miami-Ft. Lauderdale,33313,60616,1843,2072,2091,6006,0.09908275
Topeka,66606,11012,317,398,376,1091,0.099073738
Omaha,68104,36812,1236,1178,1233,3647,0.099070955
Denver,80112,36500,972,1199,1445,3616,0.099068493
Cincinnati,45065,6642,238,208,212,658,0.099066546
Sacramnto-Stkton-Modesto,95912,4987,203,168,123,494,0.09905755
Rockford,61109,26553,794,858,978,2630,0.099047189
Salt Lake City,84045,60683,2564,1668,1778,6010,0.09903927
Phoenix (Prescott),85224,47078,1256,1486,1920,4662,0.099027146
San Angelo,76934,1535,63,45,44,152,0.099022801
Pittsburgh,15108,43082,1307,1696,1263,4266,0.099020473
Tulsa,74112,21026,568,678,836,2082,0.099020261
Dayton,45302,4080,155,140,109,404,0.099019608
Phoenix (Prescott),85053,30257,859,1010,1127,2996,0.099018409
Minneapolis-St. Paul,55409,11594,257,413,478,1148,0.099016733
Grand Rapids-Kalmzoo-B.Crk,49508,42268,1247,1442,1496,4185,0.099011072
Great Falls,59420,202,8,7,5,20,0.099009901
Phoenix (Prescott),85297,43009,1818,1401,1039,4258,0.099002534
Minneapolis-St. Paul,55306,17131,483,625,588,1696,0.09900181
Baltimore,21225,33636,1185,1057,1088,3330,0.09900107
New York,10040,37142,817,1254,1606,3677,0.098998438
San Diego,91932,24708,706,810,930,2446,0.098996277
San Antonio,78253,88155,3278,2786,2663,8727,0.098996086
"Lafayette, LA",70554,6172,223,195,193,611,0.098995463
Idaho Fals-Pocatllo(Jcksn),83436,596,23,19,17,59,0.098993289
Atlanta,30083,59268,1738,1912,2217,5867,0.098991024
Little Rock-Pine Bluff,72571,394,14,13,12,39,0.098984772
"Columbia, SC",29150,39401,1298,1363,1239,3900,0.098982259
Houston,77417,2445,86,83,73,242,0.098977505
New York,7050,34998,1065,1153,1246,3464,0.098977084
Norfolk-Portsmth-Newpt Nws,23453,36221,1166,1185,1234,3585,0.098975732
"Washington, DC (Hagrstwn)",21703,43607,1324,1434,1558,4316,0.098974935
Salt Lake City,84501,12953,489,422,371,1282,0.098973211
Chicago,60438,28860,941,943,972,2856,0.098960499
Chicago,60045,21314,888,925,296,2109,0.098949048
Denver,80241,34453,971,1078,1360,3409,0.098946391
New York,11418,36930,1031,1257,1366,3654,0.098943948
Cincinnati,45239,27248,870,900,926,2696,0.098943042
Sacramnto-Stkton-Modesto,95776,29241,1012,968,913,2893,0.098936425
"Washington, DC (Hagrstwn)",20602,27766,955,878,914,2747,0.098933948
Sacramnto-Stkton-Modesto,95326,10907,393,357,329,1079,0.098927294
Chicago,61068,14809,497,468,500,1465,0.098926329
West Palm Beach-Ft. Pierce,33401,33429,734,1107,1466,3307,0.098926082
Cedar Rapids-Wtrlo-IWC&Dub,50702,20349,597,641,775,2013,0.09892378
Orlando-Daytona Bch-Melbrn,34474,18935,526,669,678,1873,0.098917349
San Antonio,78209,39863,1187,1429,1327,3943,0.09891378
Joplin-Pittsburg,66701,11617,463,370,316,1149,0.098906775
Baton Rouge,70806,27231,686,915,1092,2693,0.098894642
Birmingham (Ann and Tusc),35040,18859,656,588,621,1865,0.098891776
Lubbock,79382,9202,345,308,257,910,0.098891545
Boston (Manchester),2126,21731,687,724,738,2149,0.098890985
Louisville,40214,45253,1326,1536,1613,4475,0.098888471
Sacramnto-Stkton-Modesto,95330,38905,1458,1241,1148,3847,0.098881892
Yuma-El Centro,92250,7919,304,268,211,783,0.098876121
Greensboro-H.Point-W.Salem,27217,40876,1421,1380,1240,4041,0.098859967
Terre Haute,62432,526,26,11,15,52,0.098859316
Salt Lake City,84065,58783,2159,1764,1888,5811,0.098855111
South Bend-Elkhart,46550,12716,487,394,376,1257,0.09885184
Macon,31093,30126,948,1013,1017,2978,0.09885149
"Jackson, MS",39150,4785,151,154,168,473,0.098850575
Memphis,72330,435,16,12,15,43,0.098850575
Little Rock-Pine Bluff,71631,607,28,20,12,60,0.098846787
St. Louis,63601,16025,551,524,509,1584,0.098845554
Grand Rapids-Kalmzoo-B.Crk,49505,31303,732,950,1412,3094,0.098840367
Minneapolis-St. Paul,55112,46763,1570,1638,1414,4622,0.098838826
"Lafayette, LA",70529,13275,443,445,424,1312,0.098832392
Little Rock-Pine Bluff,72205,22635,497,771,969,2237,0.098829247
Austin,78644,23293,836,728,738,2302,0.098827974
Sioux Falls(Mitchell),57340,425,19,15,8,42,0.098823529
Houston,77388,52763,1730,1708,1776,5214,0.098819248
"Springfield, MO",65672,8865,304,288,284,876,0.098815567
Fairbanks,99731,253,4,8,13,25,0.098814229
Los Angeles,91106,23419,385,779,1150,2314,0.09880866
Harrisburg-Lncstr-Leb-York,17113,12894,445,411,418,1274,0.098805646
Miami-Ft. Lauderdale,33023,66121,2167,2192,2174,6533,0.098803708
Houston,77096,35445,1006,1212,1284,3502,0.098800959
Atlanta,30132,54356,2079,1725,1566,5370,0.098793142
Waco-Temple-Bryan,76710,25093,639,836,1004,2479,0.098792492
"Columbus, GA (Opelika, AL)",31833,6873,238,229,212,679,0.098792376
Sacramnto-Stkton-Modesto,95991,43418,1549,1354,1386,4289,0.098783915
Houston,75904,34745,1268,1152,1012,3432,0.098776802
Salt Lake City,84095,39645,1419,1164,1333,3916,0.098776643
Johnstown-Altoona-St Colge,15938,2369,99,82,53,234,0.098775855
Chicago,60433,15905,536,530,505,1571,0.09877397
Memphis,38676,5295,191,186,146,523,0.098772427
Philadelphia,19111,64910,1976,2137,2298,6411,0.098767524
Philadelphia,19151,30233,954,1036,996,2986,0.098766249
"Jackson, MS",39211,24148,617,817,951,2385,0.098765943
El Paso (Las Cruces),87936,405,14,16,10,40,0.098765432
Minneapolis-St. Paul,56379,18408,605,604,609,1818,0.098761408
Terre Haute,47803,21772,668,787,695,2150,0.098750689
Los Angeles,91723,18765,542,618,693,1853,0.098747669
St. Louis,62087,1833,58,59,64,181,0.098745226
Bismarck-Mnt-Dcknsn(Wlstn),58854,9034,239,268,385,892,0.098738101
Cedar Rapids-Wtrlo-IWC&Dub,52337,871,33,32,21,86,0.098737084
Ft. Myers-Naples,33972,16205,595,521,484,1600,0.098734958
Houston,77011,16651,521,583,540,1644,0.098732809
Birmingham (Ann and Tusc),35244,38379,1128,1343,1318,3789,0.098725866
Salt Lake City,84076,466,24,14,8,46,0.098712446
Memphis,38122,25661,863,773,897,2533,0.098710105
Jacksonville,31558,21326,643,703,759,2105,0.098705805
Austin,78665,68822,2222,2230,2341,6793,0.098703903
Honolulu,96707,55409,1825,1703,1941,5469,0.098702377
New Orleans,70403,31310,971,998,1121,3090,0.098690514
Portland-Auburn,4568,456,14,26,5,45,0.098684211
Shreveport,71079,152,5,5,5,15,0.098684211
Sioux City,51002,2959,103,90,99,292,0.098681987
Peoria-Bloomington,61616,5766,143,178,248,569,0.098681929
Burlington-Plattsburgh,13655,4145,140,127,142,409,0.0986731
Charleston-Huntington,25024,527,19,16,17,52,0.098671727
El Paso (Las Cruces),87941,902,32,35,22,89,0.098669623
"Columbus, OH",43231,22003,712,717,742,2171,0.098668363
Charleston-Huntington,25049,598,22,18,19,59,0.098662207
Los Angeles,92870,52604,1590,1786,1814,5190,0.098661699
"Portland, OR",98682,71762,2335,2312,2433,7080,0.098659458
New Orleans,70461,33562,1275,1083,953,3311,0.098653239
Los Angeles,90680,30765,940,1076,1019,3035,0.098651065
Albany-Schenectady-Troy,12427,963,37,28,30,95,0.098650052
Salt Lake City,84085,740,38,22,13,73,0.098648649
Las Vegas,89148,68273,1851,2108,2776,6735,0.098648075
Idaho Fals-Pocatllo(Jcksn),83274,11334,464,373,281,1118,0.098641256
Kansas City,64063,22222,695,740,757,2192,0.098640986
Los Angeles,92705,45884,1433,1572,1521,4526,0.098640049
Buffalo,14813,2352,91,83,58,232,0.098639456
Sherman-Ada,74730,6215,185,173,255,613,0.098632341
Columbus-Tupelo-West Point,39705,13140,309,440,547,1296,0.098630137
Amarillo,79107,36298,1338,1236,1006,3580,0.098628024
Denver,80401,43213,1459,1407,1396,4262,0.098627728
"Jackson, MS",39086,1967,77,60,57,194,0.098627351
New York,11412,37323,1037,1278,1366,3681,0.098625512
Jacksonville,32244,66070,2043,2152,2321,6516,0.098622673
Seattle-Tacoma,98421,2018,23,85,91,199,0.098612488
Harlingen-Wslco-Brnsvl-Mca,78552,41091,1595,1366,1091,4052,0.098610401
Salt Lake City,84790,62763,2315,2032,1842,6189,0.098609053
Detroit,48089,32543,979,1070,1160,3209,0.098607996
Dallas-Ft. Worth,75165,56036,2013,1853,1659,5525,0.09859733
Flint-Saginaw-Bay City,48638,13449,362,443,521,1326,0.098594691
Gainesville,32606,26097,699,899,975,2573,0.098593708
Mankato,56024,3692,118,106,140,364,0.098591549
Lincoln & Hastings-Krny,68975,71,3,2,2,7,0.098591549
Denver,80634,73151,2255,2371,2586,7212,0.098590587
Philadelphia,19079,9281,318,331,266,915,0.098588514
Hartford & New Haven,6117,16199,691,636,270,1597,0.098586332
Los Angeles,91722,35827,1076,1181,1275,3532,0.098584866
Little Rock-Pine Bluff,72501,26790,944,921,776,2641,0.09858156
Pittsburgh,16256,2039,89,62,50,201,0.098577734
Amarillo,79109,42924,1299,1494,1438,4231,0.098569565
New York,11218,75565,2384,2587,2477,7448,0.09856415
Atlanta,30241,26553,896,850,871,2617,0.098557602
Corpus Christi,78411,27204,775,913,993,2681,0.098551684
Indianapolis,46012,18985,593,756,522,1871,0.098551488
Utica,13495,1999,63,58,76,197,0.098549275
Indianapolis,46107,12796,359,409,493,1261,0.098546421
Los Angeles,91411,25034,597,773,1097,2467,0.098545977
Johnstown-Altoona-St Colge,15904,15639,561,609,371,1541,0.098535712
Salt Lake City,84414,34285,1400,1098,880,3378,0.098527053
Cleveland-Akron (Canton),44805,31758,903,1340,886,3129,0.098526356
Montgomery-Selma,36756,4679,198,153,110,461,0.098525326
Atlanta,30078,40093,1518,1293,1139,3950,0.098520939
Sacramnto-Stkton-Modesto,95337,51614,1787,1684,1614,5085,0.098519781
Wichita-Hutchinson Plus,67543,1959,81,61,51,193,0.098519653
Madison,53711,53363,1539,1920,1798,5257,0.098513952
Atlanta,30180,43132,1459,1387,1403,4249,0.098511546
Tyler-Longview(Lfkn&Ncgd),75662,24952,917,831,710,2458,0.098509138
Champaign&Sprngfld-Decatur,61822,27419,734,875,1092,2701,0.098508334
Joplin-Pittsburg,66738,335,13,10,10,33,0.098507463
Tampa-St. Pete (Sarasota),33760,16487,419,561,644,1624,0.09850185
Seattle-Tacoma,98405,28091,594,876,1297,2767,0.098501299
Salt Lake City,84325,2731,147,83,39,269,0.098498718
Greenvll-Spart-Ashevll-And,28719,6914,236,214,231,681,0.098495806
Paducah-Cape Girard-Harsbg,63877,3635,132,126,100,358,0.098486933
Twin Falls,83355,5341,213,173,140,526,0.09848343
Louisville,40211,21588,809,709,608,2126,0.098480637
Waco-Temple-Bryan,76705,31986,1044,1138,968,3150,0.098480585
"Columbus, OH",43227,24210,856,768,760,2384,0.098471706
Toledo,43605,24850,844,836,767,2447,0.098470825
Lake Charles,70605,40390,1121,1395,1461,3977,0.098464967
Cincinnati,45217,5728,158,173,233,564,0.098463687
Wheeling-Steubenville,26050,1300,43,43,42,128,0.098461538
Syracuse,13302,1554,53,51,49,153,0.098455598
New York,10471,24326,958,895,542,2395,0.098454329
Youngstown,44509,11102,355,358,380,1093,0.09845073
Las Vegas,89104,40763,1219,1408,1386,4013,0.098447121
Philadelphia,19702,55138,1618,1722,2088,5428,0.098443904
New York,7721,4683,112,157,192,461,0.09844117
Sacramnto-Stkton-Modesto,95627,3901,137,123,124,384,0.098436298
Shreveport,71112,33819,975,1075,1279,3329,0.098435791
"Washington, DC (Hagrstwn)",20603,32204,1131,1010,1029,3170,0.098434977
Sacramnto-Stkton-Modesto,95765,44854,1807,1514,1094,4415,0.098430463
Harrisonburg,22841,3170,96,97,119,312,0.098422713
San Diego,91977,60590,1976,1994,1993,5963,0.09841558
Los Angeles,90018,49913,1380,1624,1908,4912,0.098411236
Boise,83687,47568,1643,1465,1573,4681,0.098406492
Houston,77450,71530,2588,2388,2063,7039,0.098406263
St. Louis,63137,18129,625,591,568,1784,0.098405869
West Palm Beach-Ft. Pierce,33476,7896,260,249,268,777,0.098404255
Cincinnati,45003,813,18,41,21,80,0.098400984
New York,10022,36366,355,1142,2081,3578,0.098388605
Corpus Christi,78355,6576,240,230,177,647,0.098388078
Ft. Smith-Fay-Sprngdl-Rgrs,72901,21456,594,764,753,2111,0.098387397
Salt Lake City,84037,40342,1943,1218,808,3969,0.098383818
Lincoln & Hastings-Krny,68850,12431,455,433,335,1223,0.098383075
Macon,31047,18296,716,585,499,1800,0.09838216
St. Louis,63120,7156,268,217,219,704,0.098378983
Dallas-Ft. Worth,75137,19274,687,642,567,1896,0.098370862
"Washington, DC (Hagrstwn)",20110,51113,1572,1626,1830,5028,0.098370278
Salt Lake City,83263,10674,416,346,288,1050,0.098369871
Tyler-Longview(Lfkn&Ncgd),75901,28435,948,972,877,2797,0.098364691
San Angelo,76903,31333,990,1024,1068,3082,0.098362749
"Washington, DC (Hagrstwn)",20019,57462,1652,1833,2167,5652,0.098360656
Philadelphia,19607,23536,707,920,688,2315,0.098359959
"Washington, DC (Hagrstwn)",20715,26955,987,1024,640,2651,0.0983491
Greensboro-H.Point-W.Salem,27410,57054,1669,1943,1999,5611,0.098345427
Jacksonville,32216,41742,986,1265,1854,4105,0.098342197
Austin,78660,128981,4276,4043,4365,12684,0.098340066
"Washington, DC (Hagrstwn)",20903,21589,730,705,688,2123,0.098337116
Amarillo,79226,2929,144,96,48,288,0.098327074
Indianapolis,46237,44863,1304,1462,1645,4411,0.098321557
Columbia-Jefferson City,65348,1251,41,43,39,123,0.098321343
Chicago,60419,19998,660,638,668,1966,0.098309831
Los Angeles,92683,90177,2651,3084,3130,8865,0.098306664
Ft. Wayne,46809,8728,240,297,321,858,0.098304308
Detroit,48221,37588,1260,1303,1132,3695,0.09830265
Raleigh-Durham (Fayetvlle),27704,41308,1370,1370,1320,4060,0.098286046
Champaign&Sprngfld-Decatur,61910,4314,148,155,121,424,0.098284655
"Washington, DC (Hagrstwn)",20876,25834,813,829,897,2539,0.098281335
Los Angeles,91741,26720,897,1041,688,2626,0.098278443
Grand Rapids-Kalmzoo-B.Crk,49548,35776,1196,1085,1235,3516,0.098278175
Lubbock,79355,1740,64,61,46,171,0.098275862
Baton Rouge,70392,8059,291,274,227,792,0.09827522
"Jackson, MS",39097,753,24,25,25,74,0.098273572
"Columbia, SC",29169,24241,543,936,903,2382,0.098263273
Syracuse,13208,22757,735,728,773,2236,0.098255482
Sacramnto-Stkton-Modesto,95820,37423,1148,1286,1243,3677,0.098255084
Miami-Ft. Lauderdale,33311,70653,2325,2298,2319,6942,0.098254851
Des Moines-Ames,52577,14493,446,544,434,1424,0.09825433
Tampa-St. Pete (Sarasota),33511,57963,1580,1960,2155,5695,0.098252333
Los Angeles,90606,31277,1007,1014,1052,3073,0.098251111
St. Louis,63362,9720,286,319,350,955,0.098251029
Indianapolis,46032,53567,1707,1771,1785,5263,0.098250789
Jacksonville,32218,74127,2397,2314,2572,7283,0.0982503
"Jackson, MS",39144,1028,32,37,32,101,0.098249027
La Crosse-Eau Claire,54405,3023,120,100,77,297,0.098246775
Watertown,13638,285,10,8,10,28,0.098245614
Albuquerque-Santa Fe,87108,36735,877,1305,1427,3609,0.098244181
"Albany, GA",31788,11259,399,364,343,1106,0.098232525
Cleveland-Akron (Canton),44491,4072,162,121,117,400,0.098231827
Tucson (Sierra Vista),85711,41138,1098,1412,1531,4041,0.098230347
Wilkes Barre-Scranton-Hztn,18232,4174,146,137,127,410,0.09822712
Miami-Ft. Lauderdale,33056,38272,1303,1257,1199,3759,0.098218018
Wichita-Hutchinson Plus,67880,7148,297,205,200,702,0.098209289
San Antonio,78108,48387,1870,1610,1272,4752,0.098208196
Sioux City,68731,2729,101,77,90,268,0.098204471
Hartford & New Haven,6705,26812,825,869,939,2633,0.098202297
New York,10304,46905,1539,1552,1515,4606,0.098198486
Hartford & New Haven,6108,24308,734,827,826,2387,0.098198124
New York,11096,9848,328,333,306,967,0.098192526
Evansville,42354,387,14,11,13,38,0.098191214
Chicago,60618,88511,1972,2665,4054,8691,0.098191185
"Jackson, MS",39218,7445,266,233,232,731,0.098186702
Philadelphia,19806,10582,163,334,542,1039,0.098185598
Mobile-Pensacola (Ft Walt),32536,27224,864,828,981,2673,0.098185425
Houston,77043,26827,729,866,1039,2634,0.098184665
Houston,77339,43971,1429,1435,1453,4317,0.098178345
Salt Lake City,84087,17287,675,533,489,1697,0.098166252
San Diego,91910,78765,2327,2661,2744,7732,0.098165429
"Columbus, OH",43223,26975,917,837,894,2648,0.098164968
Boston (Manchester),2301,70556,2308,2299,2319,6926,0.098163161
Buffalo,14305,16351,509,559,537,1605,0.098159134
"Washington, DC (Hagrstwn)",22304,47770,873,1473,2343,4689,0.09815784
Columbus-Tupelo-West Point,39350,23972,913,768,672,2353,0.098156182
Orlando-Daytona Bch-Melbrn,34744,70663,2385,2287,2264,6936,0.098156036
Seattle-Tacoma,98007,30360,723,940,1317,2980,0.098155468
Twin Falls,83334,2262,94,72,56,222,0.098143236
Los Angeles,92627,57612,1475,1871,2308,5654,0.098139277
Dothan,36303,30959,915,1035,1088,3038,0.098129785
"Portland, OR",97362,4596,155,174,122,451,0.098128808
Houston,77535,41681,1352,1320,1418,4090,0.098126245
Kansas City,66067,16102,521,581,478,1580,0.098124457
Dallas-Ft. Worth,76017,46320,1519,1561,1465,4545,0.098121762
Columbus-Tupelo-West Point,38841,2976,104,101,87,292,0.09811828
Houston,77536,34224,1233,1117,1008,3358,0.09811828
Reno,89506,48901,1547,1521,1730,4798,0.098116603
Houston,77378,17836,653,570,527,1750,0.09811617
Birmingham (Ann and Tusc),35222,8195,119,208,477,804,0.098108603
Norfolk-Portsmth-Newpt Nws,23451,44920,1016,1453,1938,4407,0.098107747
Chicago,46410,39838,1277,1331,1300,3908,0.098097294
Knoxville,37919,31235,747,1139,1178,3064,0.098095086
Lansing,49255,2151,102,60,49,211,0.09809391
Orlando-Daytona Bch-Melbrn,32730,5189,104,172,233,509,0.098092118
"Washington, DC (Hagrstwn)",20020,50438,1640,1590,1717,4947,0.098080812
Amarillo,79005,1611,67,52,39,158,0.098075729
"Columbus, OH",43081,67482,1972,2429,2217,6618,0.098070597
Chicago,46406,9065,292,303,294,889,0.098069498
Rapid City,57623,1856,69,56,57,182,0.098060345
Detroit,48227,40017,1269,1296,1359,3924,0.098058325
Richmond-Petersburg,23225,41306,860,1343,1847,4050,0.09804871
New Orleans,70056,40756,1305,1279,1412,3996,0.098046913
Sacramnto-Stkton-Modesto,95632,31944,1143,1033,956,3132,0.098046582
Burlington-Plattsburgh,5850,51,2,1,2,5,0.098039216
Harrisburg-Lncstr-Leb-York,17034,2601,65,99,91,255,0.098039216
Roanoke-Lynchburg,24539,153,6,4,5,15,0.098039216
Rochestr-Mason City-Austin,50620,51,3,1,1,5,0.098039216
Miami-Ft. Lauderdale,33054,30561,1041,977,978,2996,0.098033441
Phoenix (Prescott),85226,41456,1193,1257,1614,4064,0.098031648
Colorado Springs-Pueblo,80905,18515,433,592,790,1815,0.098028625
Atlanta,30294,42858,1445,1350,1406,4201,0.098021373
Seattle-Tacoma,98030,40114,1214,1287,1431,3932,0.098020641
Nashville,37076,42889,1040,1410,1754,4204,0.098020471
Atlanta,30101,64704,2383,2129,1830,6342,0.098015579
San Diego,92054,39629,911,1286,1687,3884,0.098009034
San Diego,91978,10693,336,343,369,1048,0.098008043
Greenwood-Greenville,38751,10040,358,320,306,984,0.098007968
Tampa-St. Pete (Sarasota),33566,23081,789,765,708,2262,0.098002686
New York,10307,14051,440,478,459,1377,0.098000142
Sacramnto-Stkton-Modesto,95842,34398,1100,1065,1206,3371,0.097999884
Amarillo,88135,1541,66,49,36,151,0.097988319
Mobile-Pensacola (Ft Walt),36481,347,15,11,8,34,0.097982709
"Portland, OR",97024,12533,348,391,489,1228,0.097981329
Colorado Springs-Pueblo,80907,28710,590,989,1234,2813,0.097979798
Los Angeles,90631,68006,2036,2280,2347,6663,0.097976649
"Columbus, OH",43782,939,34,30,28,92,0.097976571
Oklahoma City,73013,57688,2003,2009,1640,5652,0.097975315
Indianapolis,46156,1531,63,41,46,150,0.09797518
Austin,78653,46903,1755,1430,1410,4595,0.097968147
"Lafayette, IN",47909,43801,1383,1391,1517,4291,0.0979658
"Alexandria, LA",71302,13210,471,416,407,1294,0.097956094
Detroit,48207,20877,363,669,1013,2045,0.097954687
San Diego,91945,26983,810,886,947,2643,0.097950561
Kansas City,64068,38224,1359,1314,1071,3744,0.097948933
Kansas City,64014,28617,1054,930,819,2803,0.097948772
Indianapolis,46038,43534,1412,1364,1488,4264,0.097946433
New York,10553,12660,354,419,467,1240,0.097946288
Philadelphia,18087,633,27,15,20,62,0.097946288
Shreveport,71118,23452,767,758,772,2297,0.097944738
Hartford & New Haven,6708,30722,968,1001,1040,3009,0.097942842
El Paso (Las Cruces),79821,6116,219,216,164,599,0.09793983
"Alexandria, LA",71301,19605,631,652,637,1920,0.0979342
Chicago,60173,15236,352,515,625,1492,0.097925965
Anchorage,99507,37795,1107,1204,1390,3701,0.097923006
Buffalo,14706,5821,233,218,119,570,0.097921319
Dallas-Ft. Worth,76179,79306,3030,2429,2306,7765,0.097911886
Dallas-Ft. Worth,75089,34707,1185,1138,1075,3398,0.097905322
Kansas City,65337,2002,72,59,65,196,0.097902098
Chicago,60543,42021,1621,1347,1145,4113,0.097879632
Rapid City,57703,18656,611,583,632,1826,0.097877358
Sacramnto-Stkton-Modesto,95610,46579,1240,1448,1871,4559,0.097876726
San Francisco-Oak-San Jose,95020,68066,2475,2274,1913,6662,0.097875591
Oklahoma City,74868,12026,459,387,331,1177,0.097871279
Honolulu,96818,51190,1225,1743,2042,5010,0.097870678
Watertown,13601,37039,1034,1206,1385,3625,0.097869813
Joplin-Pittsburg,64835,2064,65,74,63,202,0.097868217
Miami-Ft. Lauderdale,33169,42953,1386,1385,1432,4203,0.09785114
Philadelphia,8326,1860,65,60,57,182,0.097849462
Roanoke-Lynchburg,24019,27441,984,996,705,2685,0.097846288
Houston,77551,22087,605,770,786,2161,0.097840359
Topeka,66517,1666,49,45,69,163,0.097839136
Spokane,99037,18473,594,610,603,1807,0.097818438
Topeka,66901,6318,250,207,161,618,0.097815764
Los Angeles,93066,2975,99,97,95,291,0.097815126
Atlanta,30189,41785,1319,1397,1371,4087,0.097810219
Boise,83607,40170,1522,1280,1127,3929,0.09780931
Sioux Falls(Mitchell),57106,51930,1545,1648,1885,5078,0.09778548
Dallas-Ft. Worth,75098,75076,3048,2383,1910,7341,0.097780915
Wilkes Barre-Scranton-Hztn,18508,11599,356,356,422,1134,0.097767049
Indianapolis,46988,716,27,22,21,70,0.097765363
Wichita Falls & Lawton,73528,716,26,25,19,70,0.097765363
Los Angeles,92602,33151,1193,1172,876,3241,0.097764773
Orlando-Daytona Bch-Melbrn,34743,38748,1233,1303,1252,3788,0.097759884
Waco-Temple-Bryan,76801,25206,886,864,714,2464,0.097754503
Detroit,48091,32286,900,1076,1180,3156,0.097751347
Huntsville-Decatur (Flor),35824,9821,172,308,480,960,0.09774972
Las Vegas,89102,34824,1005,1147,1252,3404,0.097748679
Austin,78621,32329,1170,1067,923,3160,0.097745059
Baton Rouge,70811,12605,415,440,377,1232,0.097738992
Amarillo,79347,7091,272,237,184,693,0.097729516
New York,11419,46053,1173,1543,1784,4500,0.097713504
Austin,78130,104267,3125,3380,3683,10188,0.097710685
Seattle-Tacoma,98383,21871,586,657,894,2137,0.097709295
New York,8558,8280,369,274,166,809,0.097705314
New York,7008,25496,774,826,891,2491,0.0977016
Terre Haute,47529,1218,45,35,39,119,0.097701149
Los Angeles,90068,23564,287,733,1282,2302,0.097691394
Chicago,46405,11660,348,386,405,1139,0.097684391
Tampa-St. Pete (Sarasota),33547,32321,1535,1003,619,3157,0.097676433
Columbus-Tupelo-West Point,39743,1802,59,61,56,176,0.097669256
Los Angeles,90041,26632,802,1080,719,2601,0.097664464
Philadelphia,19703,15963,444,551,564,1559,0.097663346
Memphis,72301,23530,805,746,747,2298,0.097662558
Los Angeles,92313,13690,436,412,489,1337,0.097662527
Yakima-Pasco-Rchlnd-Knnwck,98953,7311,271,234,209,714,0.097661059
Joplin-Pittsburg,74354,17184,653,538,487,1678,0.097648976
Dallas-Ft. Worth,75056,76051,2060,2321,3045,7426,0.097645001
Beaumont-Port Arthur,77703,13734,461,455,425,1341,0.097640891
Raleigh-Durham (Fayetvlle),28364,11768,404,399,346,1149,0.097637661
Pittsburgh,15370,13418,464,547,299,1310,0.097630049
Colorado Springs-Pueblo,80909,37277,964,1320,1355,3639,0.097620517
Atlanta,30607,11299,357,368,378,1103,0.097619258
El Paso (Las Cruces),88011,33879,921,1253,1133,3307,0.09761209
"Jackson, MS",39648,21094,714,706,639,2059,0.097610695
Johnstown-Altoona-St Colge,16695,1004,34,36,28,98,0.097609562
Baton Rouge,70706,24345,908,747,721,2376,0.097597043
Atlanta,30701,42981,1449,1402,1343,4194,0.097578
Houston,77056,26133,382,798,1370,2550,0.097577775
Detroit,48021,33882,1127,1111,1068,3306,0.097573933
Rockford,61376,1937,71,66,52,189,0.097573567
Wilkes Barre-Scranton-Hztn,18201,31967,1052,1089,978,3119,0.097569368
"Lafayette, LA",70549,3700,137,112,112,361,0.097567568
"Springfield, MO",65708,12935,451,411,400,1262,0.097564747
Sacramnto-Stkton-Modesto,95961,33630,1289,1062,930,3281,0.097561701
Albuquerque-Santa Fe,88264,41,2,1,1,4,0.097560976
Cincinnati,41035,11440,445,333,338,1116,0.097552448
Erie,16335,26653,791,1037,772,2600,0.097549994
Fargo,58370,1261,56,39,28,123,0.097541634
Seattle-Tacoma,98023,52504,1556,1740,1825,5121,0.097535426
Monroe-El Dorado,71282,9023,293,289,298,880,0.097528538
New York,11516,8090,318,243,228,789,0.097527812
Charleston-Huntington,41501,21471,689,748,657,2094,0.097526897
Albuquerque-Santa Fe,87416,5076,197,145,153,495,0.09751773
Kansas City,64117,15423,447,480,577,1504,0.097516696
Houston,77302,24932,921,802,708,2431,0.097505214
Los Angeles,91606,43743,1090,1412,1763,4265,0.097501314
New Orleans,70043,22000,759,696,690,2145,0.0975
Harrisburg-Lncstr-Leb-York,17501,4667,142,134,179,455,0.097493036
Hattiesburg-Laurel,39643,1354,42,47,43,132,0.097488922
Tallahassee-Thomasville,32308,24178,508,816,1033,2357,0.097485317
Las Vegas,89085,4801,198,142,128,468,0.097479692
Oklahoma City,73773,1785,68,49,57,174,0.097478992
Greenville-N.Bern-Washngtn,28533,277,9,13,5,27,0.097472924
Ottumwa-Kirksville,52552,831,33,26,22,81,0.097472924
"Washington, DC (Hagrstwn)",20706,48210,1582,1585,1532,4699,0.097469405
Atlanta,30114,66424,2302,2218,1954,6474,0.097464772
Macon,31014,12662,462,393,379,1234,0.097456958
Syracuse,13206,16510,430,550,629,1609,0.097456087
Grand Rapids-Kalmzoo-B.Crk,49440,1375,31,44,59,134,0.097454545
Meridian,39320,1570,53,60,40,153,0.097452229
Atlanta,30295,4977,179,159,147,485,0.097448262
Ottumwa-Kirksville,52584,431,19,11,12,42,0.097447796
San Diego,91915,35363,1320,1107,1019,3446,0.097446484
Cincinnati,41011,27082,609,860,1170,2639,0.097444797
Tampa-St. Pete (Sarasota),33830,32081,1120,1029,977,3126,0.097440853
Atlanta,30582,5963,211,269,101,581,0.097434177
Des Moines-Ames,50131,26459,939,766,873,2578,0.097433765
Orlando-Daytona Bch-Melbrn,32703,59996,1983,1878,1984,5845,0.097423162
Macon,31049,1550,53,49,49,151,0.097419355
Green Bay-Appleton,54914,30918,877,1027,1108,3012,0.097418979
Lake Charles,70601,34573,994,1154,1220,3368,0.09741706
Atlanta,30125,25490,934,825,724,2483,0.097410749
Hartford & New Haven,6340,27649,586,910,1197,2693,0.097399544
Philadelphia,19145,46500,1151,1494,1884,4529,0.097397849
Chicago,60628,59142,2011,1940,1809,5760,0.097392716
Salt Lake City,84745,4446,176,143,114,433,0.097390913
St. Louis,62626,7784,264,276,218,758,0.097379239
Philadelphia,19720,59510,1803,1893,2099,5795,0.097378592
Norfolk-Portsmth-Newpt Nws,23690,4005,156,127,107,390,0.097378277
Fargo,56517,267,13,8,5,26,0.097378277
Dallas-Ft. Worth,75160,27060,986,871,778,2635,0.097376201
Raleigh-Durham (Fayetvlle),28326,27884,963,757,995,2715,0.097367666
Harrisburg-Lncstr-Leb-York,17529,4971,189,143,152,484,0.097364715
Champaign&Sprngfld-Decatur,61911,5043,184,151,156,491,0.097362681
Norfolk-Portsmth-Newpt Nws,23357,606,21,19,19,59,0.097359736
Ft. Wayne,46761,13332,524,396,378,1298,0.097359736
Seattle-Tacoma,98134,1058,16,36,51,103,0.097353497
Norfolk-Portsmth-Newpt Nws,23452,58561,1603,1828,2270,5701,0.09735148
Nashville,37221,44592,1015,1364,1962,4341,0.0973493
West Palm Beach-Ft. Pierce,33461,47603,1532,1524,1578,4634,0.097346806
Sioux Falls(Mitchell),57242,452,18,16,10,44,0.097345133
Austin,78731,28446,705,872,1192,2769,0.097342333
Baltimore,21040,25375,909,780,781,2470,0.097339901
"Washington, DC (Hagrstwn)",20866,15072,456,537,474,1467,0.097332803
"Washington, DC (Hagrstwn)",22031,36278,856,1120,1555,3531,0.097331716
Memphis,72315,19193,647,626,595,1868,0.097327151
Atlanta,30024,91722,3826,3054,2047,8927,0.097326705
Macon,31204,30270,945,984,1017,2946,0.097324083
Biloxi-Gulfport,39531,20365,514,640,828,1982,0.09732384
New York,11210,65867,1933,2168,2309,6410,0.097317321
Tulsa,74012,64599,2042,2122,2122,6286,0.097308008
Denver,80022,67847,2489,2134,1979,6602,0.097307176
Los Angeles,91387,47274,1556,1560,1484,4600,0.097305073
New York,10461,51797,1340,1652,2048,5040,0.097302933
Little Rock-Pine Bluff,72527,555,23,17,14,54,0.097297297
St. Louis,63135,19148,665,610,588,1863,0.097294757
"Portland, OR",97236,38720,1242,1281,1244,3767,0.097288223
New Orleans,70039,2837,114,83,79,276,0.097285865
Charleston-Huntington,41166,699,23,24,21,68,0.097281831
Fresno-Visalia,93221,15378,545,498,453,1496,0.097281831
Bakersfield,93312,58094,2172,1811,1668,5651,0.097273385
Miami-Ft. Lauderdale,33196,53211,1690,1735,1751,5176,0.09727312
South Bend-Elkhart,46540,12594,472,392,361,1225,0.097268541
Sioux City,51104,22803,791,748,679,2218,0.097267903
Norfolk-Portsmth-Newpt Nws,23605,13798,378,415,549,1342,0.097260473
Chicago,46408,14714,480,479,472,1431,0.097254316
New York,7306,63658,1258,1894,3039,6191,0.097254076
Lexington,40422,26714,912,1010,676,2598,0.097252377
Los Angeles,92595,34523,1109,1161,1087,3357,0.097239521
New York,12754,7642,256,248,239,743,0.097225857
Salt Lake City,84331,432,19,15,8,42,0.097222222
"Lafayette, LA",70528,2150,84,66,59,209,0.097209302
"Washington, DC (Hagrstwn)",20850,51510,1407,1609,1991,5007,0.097204426
Minneapolis-St. Paul,55343,25956,546,845,1132,2523,0.097202959
Little Rock-Pine Bluff,72173,10319,376,347,280,1003,0.097199341
El Paso (Las Cruces),88005,28500,916,944,910,2770,0.097192982
Tyler-Longview(Lfkn&Ncgd),75704,10896,372,360,327,1059,0.09719163
Beaumont-Port Arthur,77519,1101,41,40,26,107,0.097184378
Odessa-Midland,79731,4456,165,139,129,433,0.097172352
Orlando-Daytona Bch-Melbrn,32810,34856,931,1083,1373,3387,0.097171219
Quincy-Hannibal-Keokuk,62301,31023,953,1063,998,3014,0.097153725
Houston,77068,13712,378,425,529,1332,0.09714119
Ft. Smith-Fay-Sprngdl-Rgrs,72756,42643,1410,1409,1323,4142,0.097132003
Jacksonville,31525,29352,944,977,930,2851,0.097131371
Salt Lake City,84324,1287,61,39,25,125,0.097125097
Los Angeles,93551,55477,1913,1811,1664,5388,0.09712133
Greensboro-H.Point-W.Salem,27260,24856,827,806,781,2414,0.097119408
Memphis,38654,60472,2180,1972,1721,5873,0.097119328
"Albany, GA",31775,3120,101,110,92,303,0.097115385
Nashville,37115,41531,1132,1401,1500,4033,0.097108184
Harlingen-Wslco-Brnsvl-Mca,78580,14273,496,484,406,1386,0.097106425
Memphis,38629,1277,48,41,35,124,0.097102584
Dallas-Ft. Worth,75024,48634,1369,1560,1793,4722,0.097092569
Kansas City,64058,7025,272,226,184,682,0.097081851
Albuquerque-Santa Fe,87041,752,26,23,24,73,0.097074468
Chico-Redding,95963,16802,571,572,488,1631,0.097071777
New York,11236,96930,2688,3254,3467,9409,0.097070051
Shreveport,71105,19214,438,627,800,1865,0.09706464
Atlanta,30011,22091,782,680,682,2144,0.097053099
Ft. Wayne,46785,1525,65,39,44,148,0.09704918
Mobile-Pensacola (Ft Walt),36540,948,33,30,29,92,0.097046414
Oklahoma City,73117,6358,186,182,249,617,0.097043095
Phoenix (Prescott),85286,51690,1890,1591,1535,5016,0.097040046
Fresno-Visalia,93728,16449,494,501,601,1596,0.097027175
Pittsburgh,26546,134,6,4,3,13,0.097014925
Austin,78747,27965,781,790,1142,2713,0.097014125
"Washington, DC (Hagrstwn)",22033,41768,1128,1297,1627,4052,0.097012067
Colorado Springs-Pueblo,80924,21525,903,610,575,2088,0.097003484
New York,7026,31896,924,1066,1104,3094,0.097002759
Jacksonville,32084,38680,1087,1505,1160,3752,0.097001034
New York,10962,5196,177,203,124,504,0.096997691
Los Angeles,90401,7846,88,195,478,761,0.096992098
Colorado Springs-Pueblo,80923,33952,1075,1081,1137,3293,0.096989868
New York,10065,32808,398,811,1973,3182,0.096988539
Dallas-Ft. Worth,76133,51008,1663,1643,1641,4947,0.096984787
Augusta-Aiken,30813,54143,1859,1655,1737,5251,0.096983913
Dayton,45406,20715,711,658,640,2009,0.096982863
Idaho Fals-Pocatllo(Jcksn),83221,30678,1184,960,831,2975,0.096975031
Sacramnto-Stkton-Modesto,94585,28833,915,902,979,2796,0.096972219
"Columbia, SC",29016,27462,991,860,812,2663,0.096970359
La Crosse-Eau Claire,54422,1485,62,49,33,144,0.096969697
New York,6610,23709,717,800,782,2299,0.096967396
Charleston-Huntington,25064,9127,266,331,288,885,0.096965049
Houston,77554,9313,318,308,277,903,0.096961237
Colorado Springs-Pueblo,81050,10530,388,337,296,1021,0.096961064
Birmingham (Ann and Tusc),35212,11242,237,374,479,1090,0.096957837
Dayton,45417,27899,878,853,974,2705,0.09695688
Odessa-Midland,76932,3218,116,102,94,312,0.09695463
Detroit,48220,21145,285,597,1168,2050,0.096949633
San Diego,92124,29944,669,768,1466,2903,0.096947636
Flint-Saginaw-Bay City,48602,27221,853,923,863,2639,0.09694721
Pittsburgh,15202,19062,380,605,863,1848,0.096946805
Denver,80461,7200,225,217,256,698,0.096944444
"Columbus, GA (Opelika, AL)",36867,23282,654,722,881,2257,0.096941843
Knoxville,37841,9645,327,321,287,935,0.09694142
Shreveport,71129,12647,372,385,469,1226,0.096939986
Fargo,56592,392,18,10,10,38,0.096938776
Chicago,46402,5973,204,179,196,579,0.096936213
Ft. Smith-Fay-Sprngdl-Rgrs,72908,14176,444,429,501,1374,0.096924379
Joplin-Pittsburg,64842,877,33,27,25,85,0.096921323
Oklahoma City,73620,877,36,30,19,85,0.096921323
Biloxi-Gulfport,39540,13434,412,388,502,1302,0.096918267
Indianapolis,46113,16839,594,537,501,1632,0.096917869
Tulsa,74578,5613,204,193,147,544,0.096917869
"Washington, DC (Hagrstwn)",20781,13930,382,434,534,1350,0.096913137
Tampa-St. Pete (Sarasota),33853,12063,372,411,386,1169,0.0969079
Sioux Falls(Mitchell),57241,970,39,33,22,94,0.096907216
Houston,77447,33356,1250,974,1008,3232,0.096894112
Orlando-Daytona Bch-Melbrn,32836,28300,848,908,986,2742,0.096890459
Dallas-Ft. Worth,75033,49481,2386,1403,1005,4794,0.096885673
Jacksonville,32210,65359,2093,2052,2187,6332,0.096880307
St. Louis,63033,40597,1298,1348,1287,3933,0.09687908
Albuquerque-Santa Fe,87014,4738,175,146,138,459,0.096876319
Seattle-Tacoma,98404,36119,1259,1107,1133,3499,0.096874221
Kansas City,66030,26437,1038,811,712,2561,0.096871808
Atlanta,30127,72423,2534,2423,2058,7015,0.096861494
San Angelo,76905,13855,499,447,396,1342,0.096860339
Atlanta,30519,60851,2182,1944,1768,5894,0.096859542
Memphis,38108,16427,596,506,489,1591,0.096852742
Lubbock,79311,3459,131,123,81,335,0.0968488
Kansas City,64149,444,19,15,9,43,0.096846847
Sacramnto-Stkton-Modesto,95652,1332,47,45,37,129,0.096846847
San Francisco-Oak-San Jose,95148,44431,1395,1494,1414,4303,0.096846796
Topeka,66605,19877,733,636,556,1925,0.0968456
Houston,77590,29893,1020,943,932,2895,0.096845415
Baltimore,21244,37546,1090,1220,1326,3636,0.096841208
Bakersfield,93224,506,16,14,19,49,0.096837945
"Lafayette, LA",71433,4296,153,137,126,416,0.096834264
Richmond-Petersburg,23234,48693,1557,1493,1665,4715,0.096831167
"Columbus, OH",43128,2303,69,81,73,223,0.096830221
Miami-Ft. Lauderdale,33127,28297,806,989,945,2740,0.096830053
Tampa-St. Pete (Sarasota),33860,25748,947,830,716,2493,0.096823054
Greenville-N.Bern-Washngtn,28539,19068,543,609,694,1846,0.096811412
New York,10941,15526,452,531,520,1503,0.096805359
Odessa-Midland,79766,9938,358,316,288,962,0.096800161
Cincinnati,41075,17573,532,613,556,1701,0.096796221
Los Angeles,92596,40323,1595,1225,1083,3903,0.096793393
Albuquerque-Santa Fe,87144,52948,1991,1695,1439,5125,0.09679308
Cleveland-Akron (Canton),44123,14836,490,493,453,1436,0.096791588
Cincinnati,45240,28268,915,907,914,2736,0.096787887
Albuquerque-Santa Fe,88220,41783,1410,1363,1271,4044,0.096785774
New York,11413,40741,1142,1366,1435,3943,0.096782111
Bismarck-Mnt-Dcknsn(Wlstn),58701,32476,872,1073,1198,3143,0.09677916
Oklahoma City,74601,18372,640,588,550,1778,0.096777705
Cedar Rapids-Wtrlo-IWC&Dub,50664,62,2,2,2,6,0.096774194
Billings,59338,62,2,2,2,6,0.096774194
Twin Falls,83336,6231,228,200,175,603,0.096774194
Sacramnto-Stkton-Modesto,95645,1581,50,62,41,153,0.096774194
Medford-Klamath Falls,97601,23891,717,859,736,2312,0.096772843
Louisville,40219,39785,1180,1305,1365,3850,0.096770139
Minneapolis-St. Paul,55379,52103,1824,1640,1578,5042,0.09676986
Houston,77566,30114,995,961,958,2914,0.096765624
New York,10301,41441,1322,1370,1318,4010,0.096764074
San Francisco-Oak-San Jose,95023,61862,2187,1979,1820,5986,0.096763765
Indianapolis,47374,45385,1422,1579,1390,4391,0.096750028
Ft. Smith-Fay-Sprngdl-Rgrs,72713,28042,896,746,1071,2713,0.096747736
Cleveland-Akron (Canton),44221,29490,687,866,1300,2853,0.096744659
Greenvll-Spart-Ashevll-And,29316,32137,1076,962,1071,3109,0.096742073
Waco-Temple-Bryan,76708,29482,1022,929,901,2852,0.096736992
Chicago,60150,1623,56,51,50,157,0.096734442
Ft. Smith-Fay-Sprngdl-Rgrs,74954,4714,146,153,157,456,0.096733135
Chicago,60502,22630,857,704,628,2189,0.096730004
Roanoke-Lynchburg,24153,38990,1367,1480,924,3771,0.096717107
Corpus Christi,78405,13566,444,444,424,1312,0.096712369
Chicago,60425,8397,279,285,248,812,0.096701203
Madison,53704,49132,1102,1629,2020,4751,0.096698689
San Antonio,78061,10414,350,332,325,1007,0.096696754
Lexington,42533,786,23,24,29,76,0.096692112
"Washington, DC (Hagrstwn)",22026,25618,877,800,800,2477,0.096689827
Seattle-Tacoma,98003,53578,1508,1799,1873,5180,0.096681474
Mobile-Pensacola (Ft Walt),36618,17006,589,555,500,1644,0.096671763
"Washington, DC (Hagrstwn)",20166,15165,407,459,600,1466,0.096669964
New Orleans,70037,15848,531,508,493,1532,0.096668349
Baton Rouge,70737,49398,1640,1546,1589,4775,0.096663833
Salt Lake City,84009,46709,1858,1378,1279,4515,0.096662313
Atlanta,30234,1976,61,68,62,191,0.096659919
Tallahassee-Thomasville,31630,507,18,17,14,49,0.096646943
"Columbus, OH",43014,3984,155,121,109,385,0.096636546
Sioux City,51054,5795,223,188,149,560,0.09663503
Indianapolis,46016,17841,567,580,577,1724,0.096631355
Huntsville-Decatur (Flor),35808,890,38,22,26,86,0.096629213
Wichita Falls & Lawton,76384,11974,419,427,311,1157,0.096626023
Indianapolis,46217,34702,1107,1065,1181,3353,0.096622673
Montgomery-Selma,36107,8549,253,264,309,826,0.096619488
Cincinnati,41048,17481,747,550,392,1689,0.096619187
Bowling Green,42130,207,8,7,5,20,0.096618357
Hartford & New Haven,6110,12783,378,400,457,1235,0.096612689
Bakersfield,93308,55645,1795,1757,1824,5376,0.096612454
Sacramnto-Stkton-Modesto,95354,26334,853,850,841,2544,0.096605149
Des Moines-Ames,50130,1646,62,57,40,159,0.096597813
Cedar Rapids-Wtrlo-IWC&Dub,52776,4907,193,151,130,474,0.096596699
"Columbus, GA (Opelika, AL)",31903,20208,655,632,665,1952,0.096595408
New York,10703,21824,665,730,713,2108,0.096590909
Los Angeles,91103,27022,737,839,1034,2610,0.096587965
Bismarck-Mnt-Dcknsn(Wlstn),58316,5301,205,165,142,512,0.09658555
Lexington,42565,849,35,24,23,82,0.096584217
"Washington, DC (Hagrstwn)",20712,8604,193,265,373,831,0.096582985
Houston,77365,53115,1872,1682,1576,5130,0.096582886
St. Louis,63136,43103,1412,1330,1421,4163,0.096582604
Atlanta,30097,52494,1850,1725,1495,5070,0.096582467
Milwaukee,53403,25709,859,819,805,2483,0.096580964
Waco-Temple-Bryan,77864,7580,281,226,225,732,0.096569921
Louisville,40222,24853,563,802,1035,2400,0.096567819
Boston (Manchester),3106,15585,426,660,419,1505,0.096567212
Reno,89434,28426,738,890,1117,2745,0.096566524
Miami-Ft. Lauderdale,33162,43269,1266,1432,1480,4178,0.096558737
West Palm Beach-Ft. Pierce,33430,20879,716,668,632,2016,0.096556348
Champaign&Sprngfld-Decatur,62551,725,30,25,15,70,0.096551724
Salt Lake City,84307,1709,74,47,44,165,0.096547689
Dallas-Ft. Worth,75002,72162,2873,2356,1738,6967,0.096546659
Memphis,38037,1678,70,43,49,162,0.096543504
Salt Lake City,84032,28754,1134,885,757,2776,0.09654309
Providence-New Bedford,2895,43070,1152,1476,1530,4158,0.096540515
Augusta-Aiken,30906,58960,1994,1840,1858,5692,0.096540027
Albuquerque-Santa Fe,87325,6702,251,211,185,647,0.096538347
Los Angeles,92841,33304,966,1082,1167,3215,0.096534951
San Francisco-Oak-San Jose,95377,39966,1558,1269,1031,3858,0.096532052
"Albany, GA",31768,23247,860,728,656,2244,0.096528584
Oklahoma City,73554,3253,111,114,89,314,0.096526283
New York,12742,259,9,10,6,25,0.096525097
Greenville-N.Bern-Washngtn,28453,3108,115,100,85,300,0.096525097
Duluth-Superior,54806,11966,392,406,357,1155,0.096523483
Orlando-Daytona Bch-Melbrn,33514,2155,79,68,61,208,0.096519722
Raleigh-Durham (Fayetvlle),27513,46866,1292,1446,1785,4523,0.096509196
"Washington, DC (Hagrstwn)",25401,15408,439,485,563,1487,0.096508307
Louisville,40229,39666,1136,1242,1450,3828,0.096505824
Spokane,99357,4549,209,137,93,439,0.096504726
Bismarck-Mnt-Dcknsn(Wlstn),58501,29430,811,911,1118,2840,0.09650017
Chicago,60620,64591,1963,2099,2171,6233,0.096499512
New York,11217,45524,747,1410,2236,4393,0.09649855
Sioux Falls(Mitchell),57064,7793,328,215,209,752,0.096496856
Dallas-Ft. Worth,75081,36779,1015,1130,1404,3549,0.096495283
Terre Haute,47591,24385,829,855,669,2353,0.096493746
Salt Lake City,84025,26230,1177,766,588,2531,0.096492566
Corpus Christi,78330,684,28,20,18,66,0.096491228
Joplin-Pittsburg,64850,25350,934,773,739,2446,0.096489152
Baton Rouge,70734,8644,390,253,191,834,0.09648311
Wilmington,28401,23227,508,715,1018,2241,0.096482542
Mobile-Pensacola (Ft Walt),36587,11671,417,378,331,1126,0.096478451
Myrtle Beach-Florence,28360,11610,392,394,334,1120,0.096468562
Sherman-Ada,75092,28602,792,954,1013,2759,0.096461786
Shreveport,71111,46113,1508,1446,1494,4448,0.096458699
"Columbus, GA (Opelika, AL)",31904,36732,1064,1181,1298,3543,0.096455407
Chicago,46409,6843,247,201,212,660,0.096448926
Raleigh-Durham (Fayetvlle),28333,10628,369,336,320,1025,0.096443357
Savannah,31406,34270,1008,1070,1227,3305,0.096440035
Hattiesburg-Laurel,39481,1908,69,61,54,184,0.096436059
"Jackson, MS",39662,1514,61,46,39,146,0.096433289
Chicago,46394,11438,351,350,402,1103,0.096432943
Odessa-Midland,79705,48117,1460,1316,1864,4640,0.096431615
Wichita-Hutchinson Plus,67204,21987,773,717,630,2120,0.096420612
Sacramnto-Stkton-Modesto,95219,31010,1009,982,999,2990,0.09642051
Chicago,60430,19551,660,674,551,1885,0.096414506
Los Angeles,91502,10953,223,351,482,1056,0.096411942
Des Moines-Ames,52590,1504,57,41,47,145,0.096409574
Los Angeles,93560,22343,757,670,727,2154,0.096406033
Jacksonville,32209,36243,1192,1219,1083,3494,0.096404823
Ft. Wayne,46741,4533,171,145,121,437,0.096404147
Meridian,39307,15736,594,506,417,1517,0.096403152
Los Angeles,92562,64386,2248,2011,1948,6207,0.096402945
Louisville,47150,49677,1442,1580,1767,4789,0.096402762
Jacksonville,32063,14658,501,459,453,1413,0.096397871
Chicago,60503,16837,687,506,430,1623,0.096394845
Detroit,48131,8403,263,267,280,810,0.096394145
Bangor,4401,45169,1242,1492,1620,4354,0.096393544
Greenvll-Spart-Ashevll-And,29690,24370,939,876,534,2349,0.096389003
Lincoln & Hastings-Krny,68506,28437,797,1047,897,2741,0.096388508
Portland-Auburn,4573,664,20,37,7,64,0.096385542
Phoenix (Prescott),85172,1079,48,34,22,104,0.096385542
Norfolk-Portsmth-Newpt Nws,23707,13852,361,479,495,1335,0.096375975
Phoenix (Prescott),85340,39160,1525,1227,1022,3774,0.096373851
Odessa-Midland,79782,4763,202,150,107,459,0.096367835
Kansas City,66106,23753,844,734,711,2289,0.096366775
Lexington,40740,2854,94,91,90,275,0.096355992
St. Louis,63019,4411,147,134,144,425,0.096350034
Rochestr-Mason City-Austin,55985,2024,74,66,55,195,0.096343874
Denver,80220,37470,987,1185,1438,3610,0.096343742
Omaha,68122,13712,481,426,414,1321,0.096338973
Tampa-St. Pete (Sarasota),33544,30746,1038,998,926,2962,0.096337735
Peoria-Bloomington,61530,6550,224,271,136,631,0.096335878
Sherman-Ada,73446,8076,275,256,247,778,0.096334819
Albuquerque-Santa Fe,87109,38461,942,1225,1538,3705,0.096331349
"Washington, DC (Hagrstwn)",22314,37124,427,1126,2023,3576,0.096325827
"Washington, DC (Hagrstwn)",20747,36979,1047,1196,1319,3562,0.096324941
Colorado Springs-Pueblo,81004,25923,763,874,860,2497,0.096323728
Philadelphia,8066,8586,255,251,321,827,0.09631959
Rockford,61103,23194,689,771,774,2234,0.096318013
San Diego,92084,51717,1616,1668,1697,4981,0.096312624
Los Angeles,91739,40359,1493,1317,1077,3887,0.096310612
Norfolk-Portsmth-Newpt Nws,23324,25224,827,767,835,2429,0.096297177
Greenwood-Greenville,38930,22140,778,669,685,2132,0.096296296
Birmingham (Ann and Tusc),35114,7882,301,256,202,759,0.096295357
Cleveland-Akron (Canton),44052,30635,966,978,1006,2950,0.096295087
Dallas-Ft. Worth,75142,23293,863,740,640,2243,0.096295024
Flint-Saginaw-Bay City,48603,27386,744,929,964,2637,0.096290075
Atlanta,30005,40877,1603,1358,975,3936,0.096288867
Houston,77304,43785,1221,1256,1739,4216,0.096288683
Orlando-Daytona Bch-Melbrn,32824,63240,2035,1978,2076,6089,0.096283997
"Columbus, OH",43224,41731,1218,1308,1492,4018,0.096283339
Phoenix (Prescott),85140,52025,1999,1557,1453,5009,0.096280634
"Portland, OR",97062,28864,846,980,953,2779,0.096279102
Indianapolis,46218,31379,1042,947,1032,3021,0.096274579
Milwaukee,53405,24993,824,784,798,2406,0.096266955
Cedar Rapids-Wtrlo-IWC&Dub,52339,4550,154,151,133,438,0.096263736
Wilmington,28432,1444,50,47,42,139,0.096260388
Seattle-Tacoma,98373,27540,845,783,1023,2651,0.096259985
Columbia-Jefferson City,63534,748,36,21,15,72,0.096256684
Anchorage,99518,9589,222,330,371,923,0.096256127
"Columbus, GA (Opelika, AL)",36852,3231,117,102,92,311,0.096255029
Lansing,48808,5901,173,172,223,568,0.096254872
"Washington, DC (Hagrstwn)",20634,7636,236,233,266,735,0.096254584
Twin Falls,83318,19885,731,638,545,1914,0.096253457
Minneapolis-St. Paul,55077,14680,458,478,477,1413,0.096253406
New Orleans,70092,7283,257,242,202,701,0.096251545
Columbia-Jefferson City,65050,613,27,16,16,59,0.096247961
Corpus Christi,78374,20126,688,613,636,1937,0.096243665
Chicago,60185,34602,1194,1136,1000,3330,0.096237212
Lansing,48894,2338,86,79,60,225,0.096236099
"Washington, DC (Hagrstwn)",22192,61405,2041,1967,1901,5909,0.096229949
Wichita Falls & Lawton,73572,3336,119,108,94,321,0.096223022
Tulsa,74003,13926,415,450,475,1340,0.096222892
"Albany, GA",39813,1403,50,47,38,135,0.096222381
Monroe-El Dorado,71291,34483,1075,1109,1134,3318,0.096221326
Omaha,68154,23893,588,684,1027,2299,0.09622065
Raleigh-Durham (Fayetvlle),27534,30473,869,967,1096,2932,0.096216323
Grand Rapids-Kalmzoo-B.Crk,49452,1954,64,69,55,188,0.096212897
Los Angeles,92591,46325,1563,1500,1394,4457,0.096211549
Boise,83642,69580,2409,2054,2231,6694,0.096205806
Wichita-Hutchinson Plus,67460,16091,565,558,425,1548,0.096202846
Houston,77079,36207,1205,1129,1149,3483,0.096196868
Omaha,68112,11321,406,379,304,1089,0.096192916
Erie,16434,3223,124,101,85,310,0.09618368
Grand Rapids-Kalmzoo-B.Crk,49037,22728,698,732,756,2186,0.096180922
Lexington,40509,45833,1345,1430,1633,4408,0.096175245
New York,11706,66737,2072,2191,2155,6418,0.096168542
Cleveland-Akron (Canton),44710,8746,269,278,294,841,0.096158244
Youngstown,44450,1976,77,64,49,190,0.096153846
Amarillo,79085,52,2,1,2,5,0.096153846
Burlington-Plattsburgh,5851,6313,227,222,158,607,0.0961508
Sherman-Ada,73448,6251,194,222,185,601,0.096144617
Philadelphia,8012,38288,1136,1227,1318,3681,0.096139783
St. Louis,63133,5929,214,184,172,570,0.096137629
New York,7083,57499,1849,1902,1776,5527,0.096123411
Lincoln & Hastings-Krny,68522,14908,440,497,496,1433,0.096122887
New York,7208,34113,1054,1079,1146,3279,0.096121713
Charlotte,28601,54391,1693,1965,1570,5228,0.096118843
El Paso (Las Cruces),79901,10373,336,337,324,997,0.096114914
Oklahoma City,73853,489,20,14,13,47,0.096114519
"Washington, DC (Hagrstwn)",22553,17939,600,617,507,1724,0.096103462
Roanoke-Lynchburg,24594,1488,60,43,40,143,0.096102151
Los Angeles,90019,60312,1395,1836,2565,5796,0.096100279
Hattiesburg-Laurel,39483,5484,205,169,153,527,0.096097739
"Jackson, MS",39045,1280,39,47,37,123,0.09609375
Atlanta,30311,32699,990,994,1158,3142,0.096088565
Shreveport,75601,16371,492,529,552,1573,0.09608454
Kansas City,64155,29340,973,945,901,2819,0.096080436
Cincinnati,41045,1301,40,37,48,125,0.096079939
Albuquerque-Santa Fe,87566,3518,139,105,94,338,0.096077317
Richmond-Petersburg,23876,458,16,15,13,44,0.096069869
Houston,77541,16468,593,524,465,1582,0.096065096
Salt Lake City,84094,28399,890,885,953,2728,0.09605972
Joplin-Pittsburg,66720,10556,435,308,271,1014,0.096059113
Joplin-Pittsburg,64804,38768,1110,1207,1407,3724,0.096058605
Greenville-N.Bern-Washngtn,27888,2155,82,63,62,207,0.096055684
Burlington-Plattsburgh,5819,9089,361,282,230,873,0.096050171
Detroit,48051,18524,595,621,563,1779,0.096037573
Sioux City,51201,6352,245,178,187,610,0.096032746
Los Angeles,91304,50764,1444,1675,1756,4875,0.096032622
Tulsa,74359,302,14,7,8,29,0.09602649
Butte-Bozeman,59601,32263,973,1137,988,3098,0.096023308
Chicago,60131,17767,576,575,555,1706,0.096020713
Huntsville-Decatur (Flor),35758,52167,1737,1748,1524,5009,0.096018556
Sioux Falls(Mitchell),57436,552,22,15,16,53,0.096014493
Las Vegas,89118,26486,528,882,1133,2543,0.096012988
Los Angeles,92544,50129,1795,1622,1396,4813,0.096012288
Pittsburgh,15110,5239,165,168,170,503,0.096010689
Philadelphia,17527,7093,246,211,224,681,0.096010151
Dothan,36330,40527,1344,1305,1242,3891,0.096010067
New York,11434,66839,1852,2204,2361,6417,0.096006822
Greenville-N.Bern-Washngtn,28547,13770,276,661,385,1322,0.09600581
Detroit,48237,29259,821,916,1072,2809,0.096004648
"Springfield, MO",65738,22541,794,677,693,2164,0.096002839
Nashville,37160,38866,1346,1184,1201,3731,0.095996501
Atlanta,30034,47721,1404,1451,1726,4581,0.095995474
Providence-New Bedford,2740,45774,1317,1517,1560,4394,0.095993359
"Washington, DC (Hagrstwn)",20877,36555,1035,1199,1275,3509,0.09599234
San Diego,92116,32070,378,864,1836,3078,0.095977549
Salt Lake City,84744,323,12,11,8,31,0.095975232
Columbus-Tupelo-West Point,38849,5887,216,173,176,565,0.09597418
"Washington, DC (Hagrstwn)",22408,33854,1149,1052,1048,3249,0.095970934
Lake Charles,70637,521,19,17,14,50,0.09596929
Dallas-Ft. Worth,76249,10660,387,341,295,1023,0.095966229
Panama City,32442,3637,114,125,110,349,0.095958207
Richmond-Petersburg,23875,12339,425,390,369,1184,0.095955912
Los Angeles,90012,35913,427,1118,1901,3446,0.095954111
Spokane,99001,9641,234,369,322,925,0.095944404
Lubbock,79342,271,11,8,7,26,0.095940959
Harrisburg-Lncstr-Leb-York,17536,2783,104,89,74,267,0.095939633
Corpus Christi,78375,3127,112,100,88,300,0.095938599
Greenwood-Greenville,38778,1157,43,33,35,111,0.09593777
Memphis,38672,18127,649,571,519,1739,0.095934242
Wichita-Hutchinson Plus,67206,16897,506,629,486,1621,0.09593419
Hartford & New Haven,6081,1303,45,43,37,125,0.095932464
Atlanta,30268,11112,395,351,320,1066,0.095932325
New York,10470,16804,390,484,738,1612,0.095929541
Bismarck-Mnt-Dcknsn(Wlstn),58367,1793,69,58,45,172,0.095928611
Peoria-Bloomington,61704,37228,1072,1218,1281,3571,0.095922424
Tucson (Sierra Vista),85713,47101,1494,1524,1500,4518,0.09592153
Providence-New Bedford,2911,16579,396,561,633,1590,0.095904457
San Francisco-Oak-San Jose,94541,68522,1962,2145,2464,6571,0.095896209
Austin,78746,28573,1081,917,742,2740,0.095894726
Evansville,62835,1314,30,72,24,126,0.095890411
Baltimore,21632,6299,215,208,181,604,0.095888236
Cincinnati,41018,29608,923,912,1004,2839,0.095886247
Beaumont-Port Arthur,77706,30392,848,968,1098,2914,0.095880495
La Crosse-Eau Claire,54771,4715,198,139,115,452,0.095864263
Miami-Ft. Lauderdale,33185,28259,969,920,820,2709,0.095863265
Milwaukee,53094,18579,713,515,553,1781,0.095860918
Lincoln & Hastings-Krny,68524,6374,255,179,177,611,0.095858174
Oklahoma City,74801,22367,748,707,689,2144,0.095855501
Chattanooga,37363,45590,1341,1780,1249,4370,0.095854354
Omaha,68117,8409,273,260,273,806,0.095849685
Milwaukee,53143,21891,705,716,677,2098,0.095838472
Tulsa,74403,28685,971,912,866,2749,0.09583406
Jacksonville,31520,22770,672,765,745,2182,0.095827844
Denver,80209,27132,351,774,1475,2600,0.095827805
Cincinnati,45227,18909,503,564,745,1812,0.095827384
Baltimore,21075,37245,1211,1186,1172,3569,0.095824943
Houston,77328,18586,685,602,494,1781,0.095824814
Paducah-Cape Girard-Harsbg,63852,1221,50,36,31,117,0.095823096
"Washington, DC (Hagrstwn)",20724,21029,628,632,755,2015,0.095820058
Tucson (Sierra Vista),85741,33439,911,1085,1208,3204,0.095816262
Bangor,4929,908,34,29,24,87,0.095814978
St. Louis,63111,19048,590,574,661,1825,0.095810584
West Palm Beach-Ft. Pierce,33440,20071,741,648,534,1923,0.095809875
Macon,31220,14936,461,459,511,1431,0.095808784
Youngstown,44506,1670,56,53,51,160,0.095808383
Memphis,63830,6012,199,206,171,576,0.095808383
Raleigh-Durham (Fayetvlle),27545,34760,1154,1072,1104,3330,0.09579977
Houston,77511,54931,1825,1761,1676,5262,0.095792904
Baltimore,21221,43533,1259,1414,1497,4170,0.095789401
Lexington,40511,38137,1100,1164,1389,3653,0.095786244
Los Angeles,90042,54810,1234,1675,2341,5250,0.095785441
Columbus-Tupelo-West Point,38876,1399,50,49,35,134,0.095782702
"Washington, DC (Hagrstwn)",20879,26813,834,831,903,2568,0.095774438
Hattiesburg-Laurel,39345,5513,190,182,156,528,0.095773626
San Antonio,78250,53366,1689,1625,1797,5111,0.095772589
Los Angeles,93501,5628,185,181,173,539,0.095771144
Tallahassee-Thomasville,31636,10630,375,332,311,1018,0.095766698
Champaign&Sprngfld-Decatur,62618,7247,255,228,211,694,0.095763764
Little Rock-Pine Bluff,72023,39703,1337,1240,1225,3802,0.095761026
"Portland, OR",98665,30556,913,910,1103,2926,0.095758607
Los Angeles,92592,79381,3077,2544,1980,7601,0.095753392
"Columbus, GA (Opelika, AL)",31906,21118,630,661,731,2022,0.095747703
Nashville,37020,5713,210,182,155,547,0.095746543
Detroit,48234,31051,1016,978,979,2973,0.095745709
Little Rock-Pine Bluff,71944,752,26,30,16,72,0.095744681
Detroit,48174,33882,1045,1053,1146,3244,0.095744053
Mobile-Pensacola (Ft Walt),36571,16524,543,511,528,1582,0.09573953
Atlanta,30157,54017,1842,1671,1658,5171,0.095729122
Columbus-Tupelo-West Point,38801,29388,989,937,887,2813,0.095719341
Buffalo,14005,1797,71,56,45,172,0.095715081
Tampa-St. Pete (Sarasota),33897,34864,1109,991,1237,3337,0.095714777
Los Angeles,90047,48990,1443,1614,1632,4689,0.095713411
"Columbus, OH",43026,66398,2147,2090,2118,6355,0.095710714
Norfolk-Portsmth-Newpt Nws,23691,606,19,18,21,58,0.095709571
Phoenix (Prescott),85296,54530,2002,1609,1608,5219,0.095708784
Denver,82718,25976,972,759,755,2486,0.095703727
Columbia-Jefferson City,65301,35350,1137,1128,1118,3383,0.095700141
Los Angeles,92880,76364,2868,2389,2051,7308,0.095699544
"Columbus, GA (Opelika, AL)",36870,19959,666,601,643,1910,0.095696177
"Washington, DC (Hagrstwn)",21767,1463,47,51,42,140,0.09569378
Nashville,42280,627,26,17,17,60,0.09569378
New York,12747,1902,64,70,48,182,0.095688749
Milwaukee,53214,33757,939,1130,1161,3230,0.095683858
"Columbia, SC",29053,20202,694,648,591,1933,0.095683596
"Portland, OR",97317,26046,831,827,834,2492,0.095676879
Denver,82716,17162,624,512,506,1642,0.095676495
"Jackson, MS",39208,36007,1034,1114,1297,3445,0.095675841
San Diego,92059,1526,62,47,37,146,0.095674967
Salt Lake City,84010,48968,1564,1498,1623,4685,0.095674726
Omaha,68164,28796,766,871,1118,2755,0.09567301
Savannah,29902,20152,781,591,556,1928,0.095672886
Indianapolis,46041,24105,835,772,699,2306,0.0956648
Phoenix (Prescott),85022,54817,1326,1740,2178,5244,0.095663754
Boston (Manchester),1832,25508,788,821,831,2440,0.095656265
"Jackson, MS",39074,13946,505,406,423,1334,0.095654668
"Albany, GA",31512,2300,76,73,71,220,0.095652174
Wichita Falls & Lawton,73553,115,5,3,3,11,0.095652174
Lexington,40769,18557,655,610,510,1775,0.095651237
Joplin-Pittsburg,64867,1401,49,47,38,134,0.095645967
"Washington, DC (Hagrstwn)",22306,33029,1059,1027,1073,3159,0.095643223
Little Rock-Pine Bluff,72534,1307,55,40,30,125,0.095638868
Orlando-Daytona Bch-Melbrn,32701,22210,478,709,937,2124,0.095632598
Minneapolis-St. Paul,55113,40291,1121,1354,1378,3853,0.095629297
Savannah,30421,3064,110,107,76,293,0.095626632
Philadelphia,18052,29240,834,958,1004,2796,0.095622435
Seattle-Tacoma,98375,34816,1252,1030,1047,3329,0.095616958
Houston,77437,18022,630,596,497,1723,0.095605371
Wichita-Hutchinson Plus,67215,7667,296,236,201,733,0.095604539
Chico-Redding,96021,17437,653,557,457,1667,0.095601308
Columbus-Tupelo-West Point,39702,22134,730,698,688,2116,0.09559953
"Washington, DC (Hagrstwn)",20785,42575,1210,1333,1527,4070,0.095596007
Champaign&Sprngfld-Decatur,61821,28129,736,891,1062,2689,0.095595293
St. Louis,62882,2155,74,67,65,206,0.095591647
New York,11368,113096,3590,3518,3703,10811,0.095591356
Baltimore,21222,59118,1824,1917,1910,5651,0.095588484
New York,7006,26447,926,991,611,2528,0.095587401
Houston,77565,9814,279,349,310,938,0.095577746
South Bend-Elkhart,46619,20455,740,620,595,1955,0.095575654
Little Rock-Pine Bluff,72201,1130,13,35,60,108,0.095575221
Grand Rapids-Kalmzoo-B.Crk,49047,14785,442,596,375,1413,0.095569834
Albuquerque-Santa Fe,88210,18563,677,575,522,1774,0.095566449
Tampa-St. Pete (Sarasota),33841,7953,282,251,227,760,0.095561423
San Francisco-Oak-San Jose,94561,49208,1752,1529,1421,4702,0.095553569
New York,11220,101893,3004,3100,3632,9736,0.095551215
Atlanta,30680,51962,1751,1596,1618,4965,0.095550595
Baton Rouge,70710,7797,285,229,231,745,0.09554957
San Francisco-Oak-San Jose,95127,60046,1809,1948,1980,5737,0.095543417
Dallas-Ft. Worth,75058,3925,163,125,87,375,0.095541401
Denver,80423,157,5,6,4,15,0.095541401
Miami-Ft. Lauderdale,33301,23519,214,783,1250,2247,0.095539776
Seattle-Tacoma,98092,51666,1819,1566,1551,4936,0.095536717
Columbia-Jefferson City,65085,1120,42,34,31,107,0.095535714
Evansville,42301,45052,1522,1453,1329,4304,0.09553405
Minneapolis-St. Paul,56027,806,26,24,27,77,0.095533499
Des Moines-Ames,50021,30963,907,1003,1048,2958,0.095533379
Houston,77562,11954,416,361,365,1142,0.095532876
Orlando-Daytona Bch-Melbrn,32812,35088,871,1151,1330,3352,0.095531236
Sacramnto-Stkton-Modesto,95624,67990,2359,2218,1918,6495,0.095528754
Denver,80111,33405,1141,1082,968,3191,0.095524622
Jacksonville,32254,15368,519,494,455,1468,0.095523165
New York,7960,45811,1179,1525,1672,4376,0.095522909
Rochestr-Mason City-Austin,50460,335,14,8,10,32,0.095522388
Omaha,68025,31513,1010,1073,927,3010,0.095516136
New York,10523,9245,227,338,318,883,0.095511087
Salt Lake City,83126,534,23,19,9,51,0.095505618
Rochestr-Mason City-Austin,55927,4115,147,141,105,393,0.095504253
Ottumwa-Kirksville,63532,1288,48,35,40,123,0.095496894
Tampa-St. Pete (Sarasota),33712,26713,741,903,907,2551,0.095496575
San Antonio,78210,33824,1102,1059,1069,3230,0.095494324
Ft. Myers-Naples,33913,39417,1441,1593,730,3764,0.095491793
Yakima-Pasco-Rchlnd-Knnwck,98923,1508,60,55,29,144,0.095490716
Cleveland-Akron (Canton),44125,29082,1024,868,885,2777,0.095488618
Dallas-Ft. Worth,75115,57038,1897,1800,1749,5446,0.095480206
Quincy-Hannibal-Keokuk,63463,597,27,16,14,57,0.095477387
Houston,77375,71546,2596,2231,2004,6831,0.095477036
Dallas-Ft. Worth,75751,17712,548,654,489,1691,0.095471996
New Orleans,70466,9490,288,276,342,906,0.095468915
Ft. Wayne,45832,2776,110,82,73,265,0.095461095
Austin,78634,51237,1819,1552,1520,4891,0.09545836
Nashville,42204,660,25,20,18,63,0.095454545
Chicago,46368,41059,1196,1352,1371,3919,0.095448014
Houston,77833,30375,1275,933,691,2899,0.095440329
Yakima-Pasco-Rchlnd-Knnwck,97862,11463,380,364,350,1094,0.095437495
Philadelphia,19027,19196,606,622,604,1832,0.095436549
Hartford & New Haven,6256,2651,70,98,85,253,0.095435685
Des Moines-Ames,50860,241,9,7,7,23,0.095435685
Ottumwa-Kirksville,63539,241,9,8,6,23,0.095435685
"Jackson, MS",39038,4957,193,157,123,473,0.095420617
Chicago,60422,9642,323,340,257,920,0.095415889
Charlottesville,22902,22020,456,712,933,2101,0.095413261
Albuquerque-Santa Fe,87507,53579,1790,1727,1595,5112,0.095410515
Duluth-Superior,55803,18165,535,672,526,1733,0.095403248
Philadelphia,8060,26541,807,827,898,2532,0.09539957
West Palm Beach-Ft. Pierce,33415,53649,1756,1696,1666,5118,0.095397864
Detroit,48125,21962,658,654,783,2095,0.095392041
New Orleans,70068,32435,1102,1051,941,3094,0.095390782
Lubbock,79345,954,35,32,24,91,0.095387841
Miami-Ft. Lauderdale,33015,64256,1834,2129,2166,6129,0.095384089
Savannah,30452,1667,55,49,55,159,0.095380924
Yakima-Pasco-Rchlnd-Knnwck,98933,1017,43,28,26,97,0.095378564
New York,10034,34685,801,1061,1446,3308,0.095372639
Wichita-Hutchinson Plus,67951,4603,183,156,100,439,0.095372583
Joplin-Pittsburg,64834,10978,428,354,265,1047,0.095372563
Rapid City,57622,409,12,13,14,39,0.095354523
North Platte,69123,818,32,25,21,78,0.095354523
Paducah-Cape Girard-Harsbg,63837,1248,44,38,37,119,0.095352564
Greenwood-Greenville,38748,3377,120,107,95,322,0.095350903
Minneapolis-St. Paul,55321,5412,229,150,137,516,0.095343681
Fargo,58401,17799,612,646,439,1697,0.095342435
Greenvll-Spart-Ashevll-And,29662,16310,481,505,569,1555,0.095340282
Parkersburg,45750,25939,809,931,733,2473,0.095339065
Sioux Falls(Mitchell),57042,8045,229,346,192,767,0.09533872
Paducah-Cape Girard-Harsbg,63857,11748,423,366,331,1120,0.095335376
"Portland, OR",97383,10332,313,373,299,985,0.095334882
Charlotte,28110,59056,2100,1824,1706,5630,0.095333243
Charleston-Huntington,41232,514,21,14,14,49,0.095330739
"Albany, GA",31763,28984,1078,939,746,2763,0.095328457
"Portland, OR",97080,48779,1488,1572,1590,4650,0.095327908
Chicago,60458,13648,435,416,450,1301,0.095325322
Memphis,38114,23593,695,697,857,2249,0.095324884
Los Angeles,91335,76395,2109,2457,2716,7282,0.095320374
New York,12543,3137,95,113,91,299,0.095313994
Utica,13350,9411,339,295,263,897,0.095313994
Harrisburg-Lncstr-Leb-York,17404,39177,1223,1289,1222,3734,0.095311024
Birmingham (Ann and Tusc),35967,17480,615,530,521,1666,0.095308924
Las Vegas,89121,68830,1884,2230,2446,6560,0.095307279
San Francisco-Oak-San Jose,94607,33687,562,1001,1647,3210,0.095288984
Seattle-Tacoma,98502,36471,932,1192,1351,3475,0.095281182
Birmingham (Ann and Tusc),35085,9845,338,312,288,938,0.09527679
Salt Lake City,84320,2519,108,70,62,240,0.095275903
Detroit,48439,52217,1625,1669,1681,4975,0.095275485
Dallas-Ft. Worth,76084,14684,523,454,422,1399,0.095273767
Twin Falls,83330,6854,262,208,183,653,0.095272833
New York,10462,81712,2334,2597,2853,7784,0.095261406
Atlanta,30047,72203,2561,2377,1940,6878,0.0952592
New York,11724,2887,115,97,63,275,0.09525459
Chicago,60473,20745,712,641,623,1976,0.095251868
Greenvll-Spart-Ashevll-And,28806,47171,1250,1431,1812,4493,0.0952492
Champaign&Sprngfld-Decatur,61866,13155,444,389,420,1253,0.095248955
Atlanta,30094,33838,1130,1088,1005,3223,0.095247946
Atlanta,30017,26248,1012,825,663,2500,0.095245352
Charleston-Huntington,25672,42,2,1,1,4,0.095238095
Mobile-Pensacola (Ft Walt),36615,21,1,1,0,2,0.095238095
Montgomery-Selma,36773,378,12,15,9,36,0.095238095
Toledo,45897,84,3,3,2,8,0.095238095
Wichita-Hutchinson Plus,67515,21,1,0,1,2,0.095238095
San Antonio,78677,21,1,1,0,2,0.095238095
Salt Lake City,84333,3339,148,92,78,318,0.095238095
Spokane,99170,1092,48,31,25,104,0.095238095
Seattle-Tacoma,98226,48914,1257,1545,1856,4658,0.09522836
Albuquerque-Santa Fe,87001,4096,149,126,115,390,0.095214844
New Orleans,70075,5598,219,152,162,533,0.095212576
Huntsville-Decatur (Flor),35988,1838,64,58,53,175,0.095212187
Atlanta,30110,15125,525,473,442,1440,0.095206612
"Columbus, OH",43040,39137,1144,1187,1395,3726,0.095204027
Phoenix (Prescott),85234,51332,1883,1588,1416,4887,0.095203772
Houston,77057,41419,772,1183,1988,3943,0.095197856
Memphis,38674,1061,40,34,27,101,0.095193214
Chicago,60033,13625,474,454,369,1297,0.095192661
Boston (Manchester),2151,60900,1604,1855,2338,5797,0.095188834
Sacramnto-Stkton-Modesto,95202,6871,152,226,276,654,0.095182652
Wichita-Hutchinson Plus,67037,30395,993,953,947,2893,0.095180128
"Washington, DC (Hagrstwn)",22207,33749,1422,1005,785,3212,0.09517319
Houston,77303,25155,831,795,768,2394,0.095169946
New York,6854,30935,926,1003,1015,2944,0.095167286
Kansas City,64154,13724,403,403,500,1306,0.09516176
Baton Rouge,70714,18474,616,595,547,1758,0.095160766
Cleveland-Akron (Canton),44865,2890,97,83,95,275,0.095155709
Odessa-Midland,88252,2291,91,56,71,218,0.095154954
Tampa-St. Pete (Sarasota),33634,21649,559,657,844,2060,0.095154511
New York,11232,31202,765,1043,1161,2969,0.095154157
Des Moines-Ames,50111,19401,677,591,578,1846,0.095149735
"Charleston, SC",29445,63185,2003,2066,1943,6012,0.095149165
Cleveland-Akron (Canton),44310,24215,660,795,849,2304,0.095147636
West Palm Beach-Ft. Pierce,33414,59698,2157,1929,1594,5680,0.095145566
Miami-Ft. Lauderdale,33128,9208,187,279,410,876,0.095134666
Nashville,37214,32208,626,1037,1401,3064,0.095131644
New York,11420,45937,1173,1461,1736,4370,0.095130287
Little Rock-Pine Bluff,71652,862,31,26,25,82,0.09512761
Nashville,37069,21382,908,713,413,2034,0.095126742
Harrisburg-Lncstr-Leb-York,17572,3406,107,103,114,324,0.095126248
San Francisco-Oak-San Jose,94590,39169,1136,1240,1350,3726,0.095126248
Monroe-El Dorado,71378,2050,68,67,60,195,0.095121951
Macon,31005,21152,799,633,580,2012,0.095121029
Portland-Auburn,4256,3091,104,98,92,294,0.09511485
Dallas-Ft. Worth,75801,17169,605,543,485,1633,0.095113286
Lubbock,79403,16349,572,551,432,1555,0.095112851
Baton Rouge,70726,63694,2200,1943,1915,6058,0.095110999
New Orleans,70364,28704,964,885,881,2730,0.095108696
Charlotte,27229,3291,116,101,96,313,0.09510787
Little Rock-Pine Bluff,72802,23165,827,711,665,2203,0.095100367
"Washington, DC (Hagrstwn)",20745,31358,893,944,1145,2982,0.09509535
"Washington, DC (Hagrstwn)",20874,64305,1995,2013,2107,6115,0.095093694
Grand Rapids-Kalmzoo-B.Crk,49428,28551,1082,903,730,2715,0.095092991
Cedar Rapids-Wtrlo-IWC&Dub,52162,3439,142,104,81,327,0.095085781
Birmingham (Ann and Tusc),35188,3092,113,100,81,294,0.095084088
Chico-Redding,96035,3271,114,104,93,311,0.095077958
New York,11215,65231,1252,1918,3032,6202,0.095077494
Seattle-Tacoma,98310,22140,520,676,909,2105,0.095076784
Providence-New Bedford,2723,16431,462,567,533,1562,0.095064208
Hartford & New Haven,6451,24595,724,792,822,2338,0.095059972
Ft. Myers-Naples,34116,30602,1032,990,887,2909,0.095059146
Dallas-Ft. Worth,76031,18758,649,612,522,1783,0.095052777
Joplin-Pittsburg,64859,1494,53,50,39,142,0.095046854
Cleveland-Akron (Canton),44108,19138,588,579,652,1819,0.095046504
Macon,31027,10206,348,321,301,970,0.095042132
Phoenix (Prescott),85363,7039,235,223,211,669,0.095041909
Sacramnto-Stkton-Modesto,95841,22781,578,629,958,2165,0.095035336
San Francisco-Oak-San Jose,94578,41332,1121,1291,1516,3928,0.095035324
Greensboro-H.Point-W.Salem,27265,54667,1682,1894,1619,5195,0.095029908
Ft. Smith-Fay-Sprngdl-Rgrs,72769,1368,49,45,36,130,0.09502924
Atlanta,30240,30160,969,954,943,2866,0.095026525
Columbus-Tupelo-West Point,38627,1347,49,39,40,128,0.095025984
Great Falls,59440,221,8,7,6,21,0.095022624
Quincy-Hannibal-Keokuk,63563,442,15,15,12,42,0.095022624
Amarillo,79018,442,16,11,15,42,0.095022624
Spokane,83501,37886,1205,1274,1121,3600,0.095021908
Atlanta,30705,34014,1157,1083,992,3232,0.095019698
San Francisco-Oak-San Jose,94606,38446,832,1143,1678,3653,0.095016387
Knoxville,37892,1905,57,65,59,181,0.095013123
Twin Falls,83342,1263,53,36,31,120,0.095011876
Boston (Manchester),2136,32492,952,1022,1113,3087,0.095008002
Lima,45805,22578,692,715,738,2145,0.095003986
Honolulu,96826,27757,550,1053,1034,2637,0.095003062
Albuquerque-Santa Fe,87024,2421,91,66,73,230,0.095002065
San Antonio,78204,13463,376,403,500,1279,0.095001114
Sioux Falls(Mitchell),57440,600,24,16,17,57,0.095
San Antonio,78017,5400,178,204,131,513,0.095
Miami-Ft. Lauderdale,33071,41495,1442,1314,1186,3942,0.094999398
La Crosse-Eau Claire,54488,1179,43,36,33,112,0.094995759
Los Angeles,90746,25939,764,856,844,2464,0.094992097
Des Moines-Ames,50801,9033,337,267,254,858,0.094985055
Biloxi-Gulfport,39532,36260,1166,1133,1145,3444,0.094980695
St. Louis,63031,47663,1526,1502,1499,4527,0.094979334
Gainesville,32605,23616,538,731,974,2243,0.094977981
Flint-Saginaw-Bay City,48507,29555,899,881,1027,2807,0.094975469
Los Angeles,92656,53572,1662,1727,1699,5088,0.094974987
Syracuse,13215,14836,577,467,365,1409,0.09497169
Houston,77016,31202,1145,902,916,2963,0.094961861
Terre Haute,47568,1190,50,32,31,113,0.094957983
Boston (Manchester),1731,1506,50,37,56,143,0.094953519
Houston,77379,90341,3309,2829,2440,8578,0.094951351
Meridian,39363,1327,46,41,39,126,0.094951017
San Diego,92021,68472,2181,2141,2179,6501,0.094943919
Omaha,68147,10891,348,350,336,1034,0.094940777
New Orleans,70062,16421,501,546,512,1559,0.094939407
Albuquerque-Santa Fe,87062,1580,67,45,38,150,0.094936709
New York,7003,54569,1396,1754,2030,5180,0.09492569
Youngstown,44507,4551,146,142,144,432,0.094924192
Philadelphia,19428,20534,322,557,1070,1949,0.094915749
Pittsburgh,26554,42977,1404,1407,1268,4079,0.094911232
South Bend-Elkhart,46544,31441,893,966,1125,2984,0.094907923
Tampa-St. Pete (Sarasota),33567,12581,435,413,346,1194,0.094905015
New Orleans,70087,7239,250,215,222,687,0.094902611
Seattle-Tacoma,98465,8093,159,254,355,768,0.094896824
Roanoke-Lynchburg,24551,27293,878,951,761,2590,0.094896127
Jacksonville,32221,34323,1183,1027,1047,3257,0.094892638
Kansas City,66224,14016,548,464,318,1330,0.094891553
Dallas-Ft. Worth,76058,22531,790,732,616,2138,0.094891483
Spokane,99138,1370,58,45,27,130,0.094890511
Little Rock-Pine Bluff,72076,38372,1124,1236,1281,3641,0.094886897
Greenvll-Spart-Ashevll-And,29646,26096,879,778,819,2476,0.094880441
Phoenix (Prescott),85045,8158,323,291,160,774,0.094876195
Miami-Ft. Lauderdale,33193,44005,1306,1458,1411,4175,0.094875582
"Tri-Cities, TN-VA",37665,4944,147,153,169,469,0.09486246
Lansing,48873,1518,61,48,35,144,0.09486166
Grand Rapids-Kalmzoo-B.Crk,49424,49740,1534,1552,1632,4718,0.094853237
Greenville-N.Bern-Washngtn,28590,30574,1024,996,880,2900,0.094851835
Albany-Schenectady-Troy,12008,369,11,9,15,35,0.094850949
Birmingham (Ann and Tusc),35068,8952,235,251,363,849,0.094839142
New Orleans,70001,38859,879,1249,1557,3685,0.094830027
Sioux Falls(Mitchell),57435,232,7,7,8,22,0.094827586
Denver,80013,72808,2321,2169,2414,6904,0.094824745
Cincinnati,45044,56475,1913,1728,1714,5355,0.094820717
Tampa-St. Pete (Sarasota),33880,45117,1431,1414,1433,4278,0.094820134
Seattle-Tacoma,98503,42556,1275,1334,1426,4035,0.094816242
Philadelphia,8302,47938,1716,1516,1313,4545,0.094809963
Joplin-Pittsburg,67330,1445,63,44,30,137,0.094809689
Atlanta,30666,12257,432,382,348,1162,0.09480297
Nashville,37067,33786,971,1038,1194,3203,0.094802581
Salt Lake City,84080,327,13,10,8,31,0.094801223
Mobile-Pensacola (Ft Walt),36509,1846,60,57,58,175,0.094799567
Detroit,48034,14283,267,462,625,1354,0.094798012
Birmingham (Ann and Tusc),35474,8619,293,263,261,817,0.094790579
Miami-Ft. Lauderdale,33156,33780,1045,1068,1089,3202,0.094789816
Sioux Falls(Mitchell),57201,26522,824,899,791,2514,0.094789232
Joplin-Pittsburg,66749,7492,293,234,183,710,0.094767752
Waco-Temple-Bryan,76559,6458,219,182,211,612,0.094766181
Monroe-El Dorado,71280,4791,160,146,148,454,0.09476101
New York,10930,11566,440,340,316,1096,0.094760505
Chattanooga,37406,12748,403,404,401,1208,0.094759962
Dallas-Ft. Worth,75232,29517,1016,936,845,2797,0.094758952
Topeka,66422,496,21,16,10,47,0.094758065
New York,7086,19292,336,595,897,1828,0.094754302
Milwaukee,53081,43154,1284,1350,1455,4089,0.094753673
Corpus Christi,78372,5699,200,189,151,540,0.094753466
Tyler-Longview(Lfkn&Ncgd),75791,15051,567,447,412,1426,0.094744535
Tyler-Longview(Lfkn&Ncgd),75705,2586,93,76,76,245,0.094740913
Chicago,60177,23929,864,744,659,2267,0.094738602
Dayton,45506,13511,434,454,392,1280,0.094737621
Rapid City,57547,190,6,7,5,18,0.094736842
St. Louis,62220,18537,601,612,543,1756,0.09472946
Orlando-Daytona Bch-Melbrn,34769,29023,949,944,856,2749,0.094717982
New York,10923,9344,304,315,266,885,0.094713185
Cincinnati,45135,5258,181,162,155,498,0.094712819
Salt Lake City,84635,813,39,17,21,77,0.094710947
Phoenix (Prescott),85233,39574,1111,1173,1464,3748,0.094708647
Boise,83639,3284,121,112,78,311,0.094701583
Tampa-St. Pete (Sarasota),33812,15871,506,513,484,1503,0.094701027
Odessa-Midland,79706,30232,1098,873,892,2863,0.094700979
Louisville,40272,37795,1159,1179,1241,3579,0.094695065
Sioux City,51027,1225,51,38,27,116,0.094693878
New Orleans,70052,3010,99,96,90,285,0.094684385
Boise,83647,23193,683,705,808,2196,0.094683741
Birmingham (Ann and Tusc),35961,6168,209,202,173,584,0.094682231
Bismarck-Mnt-Dcknsn(Wlstn),58601,30576,896,934,1065,2895,0.094682104
Roanoke-Lynchburg,24017,24398,796,732,782,2310,0.094679892
Atlanta,30328,42142,781,1171,2038,3990,0.094679892
Chicago,60645,46051,1433,1460,1467,4360,0.09467764
Raleigh-Durham (Fayetvlle),27560,47131,1229,1320,1913,4462,0.094672296
Peoria-Bloomington,61528,3264,128,113,68,309,0.094669118
New Orleans,70363,23662,789,725,726,2240,0.094666554
Providence-New Bedford,2721,28565,843,876,985,2704,0.094661299
"Jackson, MS",39189,3877,147,106,114,367,0.09466082
Myrtle Beach-Florence,29547,2694,98,82,75,255,0.094654788
Dallas-Ft. Worth,76651,3423,124,105,95,324,0.094653812
Atlanta,30518,63814,2374,1965,1701,6040,0.094650077
Wichita Falls & Lawton,76309,12784,366,448,396,1210,0.094649562
Chicago,60649,47227,1127,1438,1905,4470,0.094649247
"Columbus, OH",43119,31317,951,969,1044,2964,0.094645081
Minneapolis-St. Paul,56297,803,27,23,26,76,0.094645081
"Rochester, NY",14485,4068,131,130,124,385,0.094641101
Waco-Temple-Bryan,76502,54914,1827,1707,1663,5197,0.09463889
Lexington,40915,634,24,21,15,60,0.094637224
Burlington-Plattsburgh,3784,4417,81,113,224,418,0.094634367
"Columbus, GA (Opelika, AL)",36877,13337,428,431,403,1262,0.094623978
Las Vegas,89122,55822,1597,1774,1911,5282,0.094622192
San Antonio,78254,87645,3133,2590,2570,8293,0.094620343
Los Angeles,91724,26274,687,866,933,2486,0.094618254
New York,7070,19860,622,644,613,1879,0.094612286
New York,11356,28084,778,886,993,2657,0.09460903
Wichita Falls & Lawton,73521,20051,625,667,605,1897,0.094608748
Louisville,40601,52586,1660,1744,1571,4975,0.09460693
Houston,77523,35368,1339,1066,941,3346,0.094605293
Ottumwa-Kirksville,63538,296,11,10,7,28,0.094594595
Tulsa,74055,50289,1688,1496,1573,4757,0.094593251
Baltimore,21901,18881,607,570,609,1786,0.094592447
Flint-Saginaw-Bay City,48504,23406,731,714,769,2214,0.09459113
Detroit,48444,9631,304,322,285,911,0.094590385
Miami-Ft. Lauderdale,33351,37932,1138,1217,1233,3588,0.09459032
Cincinnati,41086,2643,93,82,75,250,0.094589482
Savannah,31324,39457,1602,1166,964,3732,0.094583977
Baltimore,21017,7348,191,249,255,695,0.09458356
"Jackson, MS",39083,9008,340,270,242,852,0.094582593
Harrisburg-Lncstr-Leb-York,17201,28780,843,959,920,2722,0.094579569
Lubbock,79358,1438,45,49,42,136,0.0945758
Atlanta,30022,65461,2374,2127,1690,6191,0.094575396
Salt Lake City,84774,1935,76,63,44,183,0.094573643
Youngstown,44515,26943,620,830,1098,2548,0.094570018
Salt Lake City,84642,3849,167,120,77,364,0.094570018
Buffalo,14303,5985,190,174,202,566,0.094569758
Chicago,60901,32772,1052,1013,1034,3099,0.094562431
Dayton,45416,5055,165,166,147,478,0.094559842
Denver,80031,41393,1095,1305,1514,3914,0.094557051
Las Vegas,89128,38497,1012,1264,1364,3640,0.094552822
Grand Rapids-Kalmzoo-B.Crk,49318,1523,57,43,44,144,0.09455023
Boston (Manchester),1550,18551,514,600,640,1754,0.094550159
Yakima-Pasco-Rchlnd-Knnwck,99354,26221,764,851,864,2479,0.094542542
Hattiesburg-Laurel,39482,12123,483,338,325,1146,0.094531057
Philadelphia,19026,29948,838,912,1081,2831,0.09453052
Cleveland-Akron (Canton),44137,22956,807,707,656,2170,0.094528664
Little Rock-Pine Bluff,71943,4380,149,143,122,414,0.094520548
Sacramnto-Stkton-Modesto,95758,65460,2112,2076,1999,6187,0.094515735
Houston,77382,38248,1817,1154,644,3615,0.094514746
Raleigh-Durham (Fayetvlle),27576,24452,875,762,674,2311,0.094511696
San Antonio,78231,8581,224,288,299,811,0.094511129
San Francisco-Oak-San Jose,94124,37342,1017,1134,1378,3529,0.094504847
Lake Charles,70654,582,20,20,15,55,0.094501718
Anchorage,99517,16657,390,579,605,1574,0.094494807
Huntsville-Decatur (Flor),35654,8382,309,251,232,792,0.094488189
Sioux Falls(Mitchell),57466,127,4,4,4,12,0.094488189
Omaha,51501,34608,1093,1040,1137,3270,0.094486824
Los Angeles,91306,46177,1276,1456,1631,4363,0.094484267
"Columbus, OH",43207,48284,1484,1471,1607,4562,0.094482644
Ft. Wayne,46797,4022,149,120,111,380,0.094480358
Grand Rapids-Kalmzoo-B.Crk,49316,25573,1049,818,549,2416,0.094474641
New York,11430,561,8,20,25,53,0.094474153
Lima,45804,13951,457,423,438,1318,0.094473514
Los Angeles,90035,31120,628,825,1487,2940,0.094473008
Philadelphia,19038,31766,1185,1104,712,3001,0.094472077
New York,11105,37440,570,1018,1949,3537,0.094471154
Providence-New Bedford,2910,21541,591,688,756,2035,0.094471009
Phoenix (Prescott),85213,35102,1165,1090,1061,3316,0.094467552
New York,7002,77500,2113,2476,2731,7320,0.094451613
Denver,69361,16993,563,561,481,1605,0.094450656
Nashville,37318,1927,70,58,54,182,0.094447327
South Bend-Elkhart,46504,3187,107,92,102,301,0.094446188
Columbia-Jefferson City,65276,1620,59,45,49,153,0.094444444
Dallas-Ft. Worth,76446,8524,277,273,255,805,0.09443923
Shreveport,71030,1419,47,50,37,134,0.094432699
Savannah,31326,25648,896,792,734,2422,0.094432314
Tampa-St. Pete (Sarasota),33510,30138,884,937,1025,2846,0.094432278
Wichita Falls & Lawton,76301,15283,455,487,501,1443,0.094418635
Boston (Manchester),2038,33522,1216,1129,820,3165,0.094415608
Indianapolis,47341,2076,87,59,50,196,0.094412331
Dayton,45363,1843,72,54,48,174,0.094411286
Charlotte,28173,70089,3375,2103,1139,6617,0.094408538
Indianapolis,46131,34532,1174,1121,965,3260,0.094405189
Salt Lake City,84648,8061,303,233,225,761,0.094405161
Boston (Manchester),2186,28696,1147,1052,510,2709,0.094403401
St. Louis,63107,8665,278,266,274,818,0.09440277
Minneapolis-St. Paul,56425,8718,292,299,232,823,0.094402386
Los Angeles,91355,32955,951,1124,1036,3111,0.094401457
Greenvll-Spart-Ashevll-And,29678,24057,656,909,706,2271,0.094400798
Detroit,48219,45763,1461,1350,1509,4320,0.094399406
"Washington, DC (Hagrstwn)",22407,66412,2188,2044,2037,6269,0.094395591
Shreveport,75503,25319,807,838,745,2390,0.094395513
Spokane,98832,339,13,9,10,32,0.09439528
Houston,77433,129106,5087,3849,3250,12186,0.094387558
New York,7204,14113,427,455,450,1332,0.094381067
Macon,31019,2437,84,73,73,230,0.094378334
Houston,77429,94897,3533,2969,2454,8956,0.094376008
Houston,77461,12853,487,394,332,1213,0.094374854
Los Angeles,91791,34247,942,1106,1184,3232,0.09437323
"Washington, DC (Hagrstwn)",22406,29671,1015,932,853,2800,0.094368238
New York,7606,2734,79,79,100,258,0.094367228
"Portland, OR",97266,36443,1021,1131,1287,3439,0.094366545
St. Louis,63048,4366,154,134,124,412,0.094365552
Los Angeles,90014,8584,51,247,512,810,0.094361603
Louisville,47129,20730,559,660,737,1956,0.094356006
Fresno-Visalia,93611,47279,1583,1479,1399,4461,0.094354788
Detroit,48060,39301,1146,1293,1269,3708,0.094348744
Corpus Christi,78357,2671,88,88,76,252,0.094346687
Charleston-Huntington,25705,19916,521,589,769,1879,0.094346254
Richmond-Petersburg,23831,40173,1279,1220,1291,3790,0.094341971
Joplin-Pittsburg,64836,25323,928,791,670,2389,0.094341113
Green Bay-Appleton,54123,318,12,9,9,30,0.094339623
St. Louis,65439,265,7,8,10,25,0.094339623
Lincoln & Hastings-Krny,68753,106,4,4,2,10,0.094339623
Lubbock,79424,55544,1733,1724,1783,5240,0.094339623
Ottumwa-Kirksville,52641,12858,399,498,316,1213,0.094338155
Honolulu,96717,5491,170,179,169,518,0.094336186
Beaumont-Port Arthur,77707,17279,547,521,562,1630,0.094334163
Cincinnati,45123,8587,316,262,232,810,0.094328636
Los Angeles,90630,49010,1528,1603,1492,4623,0.094327688
Chicago,60641,65930,1822,2019,2378,6219,0.094327317
Wichita Falls & Lawton,76310,20102,623,630,643,1896,0.094318973
Indianapolis,46902,36430,996,1187,1253,3436,0.09431787
Colorado Springs-Pueblo,80912,827,29,24,25,78,0.094316808
Billings,82435,12873,473,403,338,1214,0.094305912
St. Louis,63114,35366,1017,1088,1230,3335,0.09429961
Amarillo,79118,29651,993,911,892,2796,0.094296988
Columbus-Tupelo-West Point,38828,4857,172,144,142,458,0.094296891
New York,7042,27658,816,864,928,2608,0.094294598
Greenvll-Spart-Ashevll-And,28754,8856,290,352,193,835,0.09428636
Dallas-Ft. Worth,75019,44832,1599,1421,1207,4227,0.094285332
Twin Falls,83352,3585,139,105,94,338,0.094281729
Tallahassee-Thomasville,31792,24586,789,768,761,2318,0.094281298
Wichita-Hutchinson Plus,67020,1591,66,46,38,150,0.094280327
Bowling Green,42103,24778,719,720,897,2336,0.094277181
Atlanta,30030,34336,1305,1141,791,3237,0.094274231
Baltimore,21157,39417,1315,1419,982,3716,0.094274044
Dallas-Ft. Worth,76131,59636,2141,1752,1729,5622,0.094271916
Memphis,38863,20961,729,646,601,1976,0.094270312
Knoxville,37917,25725,553,795,1077,2425,0.094266278
Wichita-Hutchinson Plus,67052,9505,404,282,210,896,0.094266176
Columbia-Jefferson City,65048,244,10,7,6,23,0.094262295
Phoenix (Prescott),85338,73151,2552,2203,2140,6895,0.094257085
"Columbus, OH",43050,29994,975,1100,752,2827,0.094252184
Tallahassee-Thomasville,32305,19151,626,621,558,1805,0.094250953
Kansas City,64133,35036,1019,1133,1150,3302,0.094245918
Los Angeles,91406,53457,1423,1646,1969,5038,0.094243972
San Diego,92057,57598,1677,1890,1861,5428,0.094239383
New York,11223,85500,2492,2743,2822,8057,0.094233918
Little Rock-Pine Bluff,72833,3746,128,123,102,353,0.094233849
Detroit,48180,61985,1705,1897,2239,5841,0.094232476
Baton Rouge,70725,1889,74,57,47,178,0.094229751
Joplin-Pittsburg,64866,1369,56,39,34,129,0.094229364
Ft. Wayne,46750,26457,873,891,729,2493,0.094228371
Los Angeles,92543,40509,1282,1234,1301,3817,0.094225974
"Portland, OR",97015,25821,742,790,901,2433,0.09422563
Las Vegas,89147,55782,1419,1728,2109,5256,0.094223943
Greensboro-H.Point-W.Salem,27214,13330,496,398,362,1256,0.094223556
Monterey-Salinas,93960,25451,906,813,679,2398,0.094220266
Los Angeles,91709,77389,2236,2499,2556,7291,0.094212356
Des Moines-Ames,50220,9914,359,319,256,934,0.094210208
Monterey-Salinas,93451,5095,193,150,137,480,0.09421001
"Columbia, SC",29063,37280,1303,1192,1017,3512,0.094206009
Denver,80701,16517,565,521,470,1556,0.09420597
Phoenix (Prescott),85345,63701,1978,1987,2036,6001,0.094205742
"Alexandria, LA",71303,22239,704,716,675,2095,0.094203876
San Antonio,78830,414,14,14,11,39,0.094202899
Greenvll-Spart-Ashevll-And,29334,18323,572,562,592,1726,0.094198548
Norfolk-Portsmth-Newpt Nws,23509,12410,265,350,554,1169,0.094198227
Memphis,72442,4523,140,146,140,426,0.094185275
Montgomery-Selma,36767,1582,52,55,42,149,0.094184576
San Antonio,78261,30282,1138,909,805,2852,0.094181362
Wilmington,28399,1667,52,57,48,157,0.094181164
Montgomery-Selma,36054,15672,496,468,512,1476,0.094180704
Joplin-Pittsburg,74333,1168,43,35,32,110,0.094178082
Charlotte,28214,47391,1602,1422,1439,4463,0.094173999
New York,12763,892,36,22,26,84,0.094170404
"Jackson, MS",39654,4949,176,153,137,466,0.094160436
Twin Falls,83314,839,30,27,22,79,0.094159714
Harrisburg-Lncstr-Leb-York,17240,3590,115,116,107,338,0.094150418
Oklahoma City,74030,4546,167,142,119,428,0.094148702
New York,7666,42104,1305,1397,1262,3964,0.094147824
Wilmington,28405,33713,830,1080,1264,3174,0.094147658
Terre Haute,62413,393,12,16,9,37,0.094147583
Seattle-Tacoma,98273,32652,1064,1011,999,3074,0.09414431
Lansing,48906,25698,726,802,891,2419,0.094131839
Nashville,42234,2231,81,70,59,210,0.094128194
Los Angeles,90094,11729,135,270,699,1104,0.094125671
Detroit,48184,17636,497,530,633,1660,0.094125652
Sioux City,51040,3421,113,115,94,322,0.094124525
Columbia-Jefferson City,65063,3761,135,108,111,354,0.094123903
Twin Falls,83323,2263,99,64,50,213,0.094122846
"Portland, OR",97219,42041,1364,1350,1243,3957,0.094122404
Lincoln & Hastings-Krny,68512,14779,474,463,454,1391,0.094120035
Houston,77532,37091,1309,1104,1078,3491,0.094119867
Philadelphia,8081,51351,1606,1598,1629,4833,0.09411696
"Columbus, OH",43017,44022,1496,1424,1223,4143,0.094112035
Des Moines-Ames,50009,23377,780,673,747,2200,0.094109595
Seattle-Tacoma,98002,39934,1190,1267,1301,3758,0.094105274
Chicago,60633,12976,391,406,424,1221,0.094096794
Des Moines-Ames,50263,32467,1117,993,945,3055,0.094095543
Wilkes Barre-Scranton-Hztn,17929,1541,39,50,56,145,0.094094744
Minneapolis-St. Paul,55443,38388,1320,1203,1089,3612,0.094091904
Austin,78727,31597,566,903,1504,2973,0.094091211
Albuquerque-Santa Fe,87045,1201,41,38,34,113,0.09408826
Sacramnto-Stkton-Modesto,95901,37125,1182,1097,1214,3493,0.094087542
Norfolk-Portsmth-Newpt Nws,23435,35372,1125,1060,1143,3328,0.094085718
San Antonio,78201,39041,1142,1268,1263,3673,0.094080582
Kansas City,64156,8461,320,236,240,796,0.094078714
Sacramnto-Stkton-Modesto,95692,5134,159,168,156,483,0.094078691
Minneapolis-St. Paul,56387,7802,180,230,324,734,0.094078441
Los Angeles,92833,51714,1570,1640,1655,4865,0.094075105
"Washington, DC (Hagrstwn)",22556,30274,1124,947,777,2848,0.094074123
Raleigh-Durham (Fayetvlle),27505,7473,258,242,203,703,0.094071993
Colorado Springs-Pueblo,80921,32933,1182,1010,906,3098,0.094069778
Wichita-Hutchinson Plus,67060,13513,529,418,324,1271,0.094057574
Omaha,68124,15342,425,423,595,1443,0.094055534
Salt Lake City,84780,35267,1295,1041,981,3317,0.094053931
Mobile-Pensacola (Ft Walt),36575,20946,716,624,630,1970,0.09405137
Chicago,60431,28623,996,845,851,2692,0.094050239
New York,7046,4923,203,168,92,463,0.094048345
Cleveland-Akron (Canton),44305,20649,605,617,720,1942,0.094048138
Birmingham (Ann and Tusc),35080,21840,847,659,548,2054,0.094047619
Springfield-Holyoke,1040,37599,1053,1197,1286,3536,0.094045054
"Columbus, GA (Opelika, AL)",39823,8645,304,274,235,813,0.094042799
New York,11435,59431,1454,1920,2215,5589,0.09404183
Louisville,40258,27020,823,841,877,2541,0.094041451
"Washington, DC (Hagrstwn)",20616,8624,281,264,266,811,0.094039889
Cedar Rapids-Wtrlo-IWC&Dub,52561,1021,35,32,29,96,0.094025465
Augusta-Aiken,29829,13933,468,391,451,1310,0.094021388
Mobile-Pensacola (Ft Walt),36507,21251,717,666,615,1998,0.094019105
Chicago,60466,21093,652,698,633,1983,0.094012232
Los Angeles,90211,8031,205,222,328,755,0.094010709
Houston,77009,37839,953,1119,1485,3557,0.094003541
Atlanta,30145,8351,257,269,259,785,0.094000718
Little Rock-Pine Bluff,71654,4117,145,117,125,387,0.094000486
Syracuse,13090,30468,860,975,1029,2864,0.094000263
Bowling Green,42729,1681,61,49,48,158,0.093991672
New York,11422,31918,784,1018,1198,3000,0.093990852
St. Louis,62082,2213,89,51,68,208,0.093990059
Chico-Redding,95917,3160,99,116,82,297,0.093987342
New York,11367,44018,1241,1380,1516,4137,0.093984279
Waco-Temple-Bryan,76537,20356,675,585,653,1913,0.093977206
Binghamton,13790,18507,451,671,617,1739,0.093964446
Cedar Rapids-Wtrlo-IWC&Dub,52045,2799,95,81,87,263,0.093962129
Charleston-Huntington,41203,149,5,6,3,14,0.093959732
Grand Rapids-Kalmzoo-B.Crk,49418,31985,900,988,1117,3005,0.093950289
Harrisburg-Lncstr-Leb-York,17237,1586,41,46,62,149,0.093947037
Cincinnati,45216,9559,301,297,300,898,0.093942881
Wichita Falls & Lawton,73538,6983,278,222,156,656,0.093942432
Hattiesburg-Laurel,39366,1352,50,41,36,127,0.093934911
Austin,78725,12382,410,364,389,1163,0.093926668
Harrisonburg,24401,40256,1268,1272,1241,3781,0.093923887
Dallas-Ft. Worth,76262,47901,1795,1440,1264,4499,0.093922883
Columbus-Tupelo-West Point,39739,2385,75,79,70,224,0.093920335
San Francisco-Oak-San Jose,95117,31943,859,987,1154,3000,0.09391729
San Antonio,78140,3599,132,125,81,338,0.093914976
"Washington, DC (Hagrstwn)",20623,2481,82,70,81,233,0.093913744
Greenwood-Greenville,38703,12469,419,397,355,1171,0.093912904
Lexington,40906,10595,320,363,312,995,0.093912223
Tulsa,74960,10713,394,336,276,1006,0.093904602
"Washington, DC (Hagrstwn)",20004,1821,4,52,115,171,0.093904448
Portland-Auburn,4092,20980,514,642,814,1970,0.093898951
Dallas-Ft. Worth,76645,11587,411,362,315,1088,0.093898334
Phoenix (Prescott),85308,66296,1974,1947,2304,6225,0.093897068
Cleveland-Akron (Canton),44301,13483,363,423,480,1266,0.093896017
Colorado Springs-Pueblo,80951,6028,197,158,211,566,0.093895156
Corpus Christi,78408,10576,350,341,302,993,0.093891831
Houston,77469,71391,2372,2154,2177,6703,0.093891387
Raleigh-Durham (Fayetvlle),27804,28661,850,935,906,2691,0.093890653
Ottumwa-Kirksville,63549,2258,82,70,60,212,0.093888397
"Albany, GA",31771,6103,216,195,162,573,0.093888252
Rockford,61080,11173,387,350,312,1049,0.093887049
Atlanta,30206,3398,124,106,89,319,0.093878752
Sherman-Ada,74843,245,8,7,8,23,0.093877551
San Antonio,78116,245,9,8,6,23,0.093877551
Dallas-Ft. Worth,75189,53773,1962,1592,1494,5048,0.093876109
Wilmington,28384,11036,406,330,300,1036,0.093874592
Corpus Christi,78361,4666,192,145,101,438,0.093870553
Sacramnto-Stkton-Modesto,95357,14371,505,438,406,1349,0.093869598
Harrisburg-Lncstr-Leb-York,17030,799,34,25,16,75,0.093867334
New York,10928,5380,139,168,198,505,0.093866171
Savannah,31408,11965,307,358,458,1123,0.093857083
"Jackson, MS",39082,1513,56,43,43,142,0.093853272
Philadelphia,8015,19841,609,604,649,1862,0.093846076
Austin,78613,91024,3212,2773,2557,8542,0.093843382
Atlanta,30120,45801,1498,1425,1375,4298,0.093840746
Baltimore,21227,35359,974,1048,1296,3318,0.093837495
Victoria,77904,29446,943,912,908,2763,0.093832779
West Palm Beach-Ft. Pierce,33444,22999,527,763,868,2158,0.093830167
Ft. Smith-Fay-Sprngdl-Rgrs,72734,9123,330,277,249,856,0.093828784
Yakima-Pasco-Rchlnd-Knnwck,97875,2803,88,92,83,263,0.093828041
Lake Charles,70652,2750,107,81,70,258,0.093818182
Seattle-Tacoma,98112,23045,467,610,1085,2162,0.093816446
Boise,83713,31499,1080,950,925,2955,0.093812502
Charleston-Huntington,41264,501,22,13,12,47,0.093812375
Huntsville-Decatur (Flor),35653,12312,470,368,317,1155,0.093810916
Charlotte,28210,45145,1044,1443,1748,4235,0.093808838
Waco-Temple-Bryan,76635,1066,37,35,28,100,0.09380863
Omaha,68137,26299,793,836,838,2467,0.093805848
Detroit,48044,58003,1934,1831,1676,5441,0.093805493
Cheyenne-Scottsbluff,82001,37057,1008,1165,1303,3476,0.093801441
Birmingham (Ann and Tusc),36250,4307,130,129,145,404,0.093800789
Chicago,46319,18114,508,530,661,1699,0.093794855
New York,11951,13615,467,405,405,1277,0.09379361
Wheeling-Steubenville,43977,2175,71,59,74,204,0.093793103
Dayton,45420,24842,644,736,950,2330,0.09379277
Los Angeles,91504,25909,738,822,870,2430,0.093789803
Jonesboro,72433,2655,95,78,76,249,0.093785311
Sacramnto-Stkton-Modesto,95678,44528,1293,1378,1505,4176,0.093783687
Raleigh-Durham (Fayetvlle),27527,38527,1525,1152,936,3613,0.093778389
Albuquerque-Santa Fe,87402,11475,415,366,295,1076,0.093769063
Miami-Ft. Lauderdale,33187,19443,605,622,596,1823,0.093761251
Seattle-Tacoma,98087,39816,948,1142,1643,3733,0.093756279
Denver,81637,10602,370,321,303,994,0.093755895
Providence-New Bedford,2815,96,3,3,3,9,0.09375
Pittsburgh,15276,160,3,6,6,15,0.09375
Philadelphia,18917,2240,63,69,78,210,0.09375
Baltimore,21644,64,2,2,2,6,0.09375
Charleston-Huntington,25544,32,1,1,1,3,0.09375
Birmingham (Ann and Tusc),35457,96,3,3,3,9,0.09375
Birmingham (Ann and Tusc),35490,5536,180,156,183,519,0.09375
Chicago,60101,36224,1132,1135,1129,3396,0.09375
St. Louis,63014,800,28,25,22,75,0.09375
St. Louis,65062,32,1,1,1,3,0.09375
Columbia-Jefferson City,65443,96,4,3,2,9,0.09375
Topeka,66533,1792,69,54,45,168,0.09375
Wichita-Hutchinson Plus,67868,224,9,7,5,21,0.09375
Shreveport,71831,64,2,2,2,6,0.09375
Salt Lake City,84313,160,5,6,4,15,0.09375
Salt Lake City,84525,960,37,26,27,90,0.09375
Seattle-Tacoma,98390,11979,378,349,396,1123,0.093747391
Chattanooga,37421,52738,1343,1584,2017,4944,0.093746445
New York,12571,10358,336,397,238,971,0.093743966
Miami-Ft. Lauderdale,33028,27554,914,850,819,2583,0.093743195
New York,12701,12865,356,380,470,1206,0.093742713
Wichita-Hutchinson Plus,67110,8374,303,261,221,785,0.093742536
Cincinnati,41095,3382,111,104,102,317,0.09373152
St. Louis,62205,6412,186,209,206,601,0.093730505
Atlanta,30263,63960,2011,2066,1918,5995,0.093730457
Cleveland-Akron (Canton),44855,1131,39,32,35,106,0.09372237
Norfolk-Portsmth-Newpt Nws,23703,26003,716,827,894,2437,0.093719955
Champaign&Sprngfld-Decatur,61756,2006,74,66,48,188,0.093718843
Memphis,38133,21650,711,671,647,2029,0.093718245
Pittsburgh,26508,38755,1067,1375,1190,3632,0.09371694
Norfolk-Portsmth-Newpt Nws,23663,13446,426,396,438,1260,0.093708166
Roanoke-Lynchburg,24503,19881,647,680,536,1863,0.09370756
Reno,89523,37128,987,1109,1383,3479,0.093702866
Nashville,37043,59861,1858,1861,1890,5609,0.093700406
"Portland, OR",97078,29649,856,899,1023,2778,0.093696246
Ottumwa-Kirksville,63548,1142,34,39,34,107,0.093695271
Wilkes Barre-Scranton-Hztn,18702,43023,1157,1419,1455,4031,0.093694071
Atlanta,30753,6660,225,194,205,624,0.093693694
Montgomery-Selma,36728,555,18,18,16,52,0.093693694
Tampa-St. Pete (Sarasota),33615,47645,1161,1463,1840,4464,0.093692937
Los Angeles,90232,17484,347,504,787,1638,0.093685655
Green Bay-Appleton,54150,950,38,27,24,89,0.093684211
Monroe-El Dorado,71432,950,31,31,27,89,0.093684211
Billings,59089,459,18,14,11,43,0.093681917
Tulsa,74361,16951,566,522,500,1588,0.093681789
Dallas-Ft. Worth,76247,30540,1151,887,823,2861,0.093680419
Indianapolis,47327,4206,148,128,118,394,0.093675701
Dayton,45304,7270,290,201,190,681,0.093672627
"Albany, GA",31701,17636,489,532,631,1652,0.093672034
Buffalo,14132,5530,224,165,129,518,0.093670886
Mobile-Pensacola (Ft Walt),32506,35945,1023,1128,1216,3367,0.093670886
Boston (Manchester),1718,758,22,27,22,71,0.093667546
Terre Haute,47802,35137,892,1229,1170,3291,0.093661952
New York,8502,11446,481,328,263,1072,0.093657173
Louisville,47102,6951,225,225,201,651,0.093655589
Memphis,72395,961,28,27,35,90,0.093652445
Anchorage,99501,17736,409,575,677,1661,0.093651331
Idaho Fals-Pocatllo(Jcksn),83210,3150,129,99,67,295,0.093650794
Los Angeles,92688,44335,1394,1449,1309,4152,0.093650615
Salisbury,19960,7037,246,227,186,659,0.093647861
"Portland, OR",97008,28853,776,894,1032,2702,0.093647108
"Columbia, SC",29118,15078,483,449,480,1412,0.093646372
Milwaukee,53142,32623,1110,992,953,3055,0.093645587
Minneapolis-St. Paul,55121,10465,245,305,430,980,0.093645485
Los Angeles,90048,21689,218,476,1337,2031,0.093641938
Austin,78730,7689,255,238,227,720,0.093640265
Albuquerque-Santa Fe,87031,46939,1644,1444,1307,4395,0.093632161
Orlando-Daytona Bch-Melbrn,34772,40340,1418,1247,1112,3777,0.093629152
Phoenix (Prescott),85122,63069,2206,1922,1777,5905,0.093627614
Salisbury,19956,16780,548,520,503,1571,0.093623361
Macon,31217,17357,592,519,514,1625,0.09362217
Omaha,68133,13437,491,451,316,1258,0.093622088
Las Vegas,89120,24931,634,799,901,2334,0.093618387
Shreveport,75650,10394,402,315,256,973,0.093611699
Champaign&Sprngfld-Decatur,62561,5149,191,171,120,482,0.09361041
"Washington, DC (Hagrstwn)",20619,14486,476,418,462,1356,0.093607621
"Washington, DC (Hagrstwn)",22712,10801,384,320,307,1011,0.093602444
Eureka,95551,1688,53,56,49,158,0.093601896
Ft. Wayne,46740,4968,190,145,130,465,0.093599034
Hartford & New Haven,6266,406,11,13,14,38,0.093596059
Wilmington,28412,47323,1191,1561,1677,4429,0.093590854
Kansas City,64057,15761,422,492,561,1475,0.093585432
Montgomery-Selma,36067,27996,929,858,833,2620,0.093584798
Chattanooga,37416,15078,409,478,524,1411,0.09358005
Jonesboro,72443,3174,102,105,90,297,0.093572779
Phoenix (Prescott),85085,32692,1020,880,1159,3059,0.093570292
Bluefield-Beckley-Oak Hill,25060,171,7,5,4,16,0.093567251
Hattiesburg-Laurel,39475,13392,470,395,388,1253,0.093563321
Dallas-Ft. Worth,75790,4564,158,150,119,427,0.093558282
Miami-Ft. Lauderdale,33331,23334,927,772,484,2183,0.09355447
Norfolk-Portsmth-Newpt Nws,23301,1753,64,56,44,164,0.093553908
Cedar Rapids-Wtrlo-IWC&Dub,50701,29780,763,918,1105,2786,0.09355272
"Springfield, MO",65721,35415,1192,1101,1020,3313,0.093547932
Minneapolis-St. Paul,55308,9621,380,298,222,900,0.09354537
Baltimore,21723,449,16,14,12,42,0.093541203
Dallas-Ft. Worth,75054,17554,725,501,416,1642,0.093539934
Bismarck-Mnt-Dcknsn(Wlstn),58570,588,22,19,14,55,0.093537415
Memphis,38004,11600,432,351,302,1085,0.093534483
Amarillo,73950,1732,70,49,43,162,0.093533487
Dallas-Ft. Worth,76036,41077,1409,1246,1187,3842,0.09353166
Denver,80020,55394,1596,1600,1985,5181,0.093529985
Baltimore,21113,40116,1094,1168,1490,3752,0.093528767
Corpus Christi,78343,4373,172,126,111,409,0.09352847
Detroit,48103,55828,1402,1762,2057,5221,0.093519381
Cleveland-Akron (Canton),44628,1080,39,37,25,101,0.093518519
Jacksonville,32206,18221,556,627,521,1704,0.093518468
Great Falls,59427,4962,183,148,133,464,0.093510681
Cincinnati,45215,31066,960,985,960,2905,0.09351059
"Columbus, GA (Opelika, AL)",31719,8812,304,272,248,824,0.093508852
Orlando-Daytona Bch-Melbrn,34761,46564,1499,1391,1464,4354,0.093505713
Dallas-Ft. Worth,75407,44265,1541,1322,1276,4139,0.093505027
Monterey-Salinas,93901,29400,931,946,872,2749,0.093503401
San Diego,92061,2278,91,63,59,213,0.093503073
Lincoln & Hastings-Krny,68726,631,25,14,20,59,0.093502377
New York,6810,55165,1542,1799,1817,5158,0.093501314
Tulsa,74434,9241,357,292,215,864,0.093496375
Hartford & New Haven,6118,26345,739,810,914,2463,0.093490226
Cedar Rapids-Wtrlo-IWC&Dub,50641,1658,52,57,46,155,0.093486128
Dallas-Ft. Worth,75013,56023,2130,1699,1408,5237,0.093479464
New York,10805,18807,563,664,531,1758,0.093475833
Eugene,97402,57117,1446,1727,2166,5339,0.093474797
Los Angeles,90731,59503,1719,1876,1967,5562,0.093474279
St. Louis,63113,10518,322,353,308,983,0.093458832
Atlanta,30103,16810,556,494,521,1571,0.093456276
Houston,77384,29973,835,866,1100,2801,0.093450772
Baltimore,21213,26560,871,802,809,2482,0.093448795
Albuquerque-Santa Fe,87312,931,35,25,27,87,0.093447905
Greensboro-H.Point-W.Salem,27282,16353,463,507,558,1528,0.093438513
Memphis,38663,11537,366,384,328,1078,0.093438502
Rockford,61008,33082,1079,1085,927,3091,0.093434496
Los Angeles,92584,67087,2282,1940,2046,6268,0.093430918
Memphis,38606,15178,511,474,433,1418,0.093424694
Miami-Ft. Lauderdale,33309,38171,1100,1239,1227,3566,0.093421708
Chico-Redding,95973,39210,1166,1166,1331,3663,0.093420046
Montgomery-Selma,36112,1413,15,68,49,132,0.093418259
St. Louis,62221,28860,893,921,882,2696,0.093416493
Huntsville-Decatur (Flor),35601,35467,1047,1119,1147,3313,0.093410776
Milwaukee,53048,3533,126,103,101,330,0.093405038
Albuquerque-Santa Fe,87532,19175,638,602,551,1791,0.093402868
Milwaukee,53182,9818,305,308,304,917,0.093399878
Buffalo,14301,11789,380,323,398,1101,0.093392145
Richmond-Petersburg,22974,5675,132,159,239,530,0.09339207
Chicago,60619,60831,1621,1952,2108,5681,0.093389883
Grand Junction-Montrose,81505,12550,355,377,440,1172,0.093386454
Cincinnati,41094,16107,591,468,445,1504,0.093375551
Greenwood-Greenville,38921,4573,168,130,129,427,0.093374153
St. Joseph,64503,11332,350,349,359,1058,0.093363925
Beaumont-Port Arthur,77713,15381,437,444,555,1436,0.09336194
Baltimore,21044,46786,1177,1479,1712,4368,0.093361262
San Antonio,78023,29552,1055,903,801,2759,0.093360855
Grand Rapids-Kalmzoo-B.Crk,49091,19580,683,578,567,1828,0.093360572
Macon,30474,16785,571,511,485,1567,0.093357164
Columbia-Jefferson City,65322,632,25,16,18,59,0.09335443
Little Rock-Pine Bluff,72176,9148,293,266,295,854,0.093353739
Dothan,36322,8109,231,272,254,757,0.093353064
Philadelphia,18020,23846,839,798,589,2226,0.093348989
Philadelphia,19405,5635,176,167,183,526,0.093345164
Wichita-Hutchinson Plus,67056,3139,123,95,75,293,0.093341829
Las Vegas,89084,42706,1361,1248,1377,3986,0.093335831
Detroit,48111,43553,1124,1363,1578,4065,0.093334558
"Washington, DC (Hagrstwn)",20151,26089,877,841,717,2435,0.093334355
El Paso (Las Cruces),79839,1200,39,47,26,112,0.093333333
New Orleans,70360,27193,861,847,830,2538,0.093332843
Baltimore,21220,44841,1341,1332,1512,4185,0.093329765
Sacramnto-Stkton-Modesto,95323,1318,39,45,39,123,0.093323217
Greenwood-Greenville,38701,19813,639,609,601,1849,0.093322566
Little Rock-Pine Bluff,72117,13803,449,424,415,1288,0.093313048
Houston,77494,156209,6747,4412,3417,14576,0.093310885
Eugene,97405,46319,1215,1816,1291,4322,0.093309441
Flint-Saginaw-Bay City,48829,3333,118,99,94,311,0.093309331
Memphis,38042,761,24,27,20,71,0.093298292
Clarksburg-Weston,26404,611,18,14,25,57,0.093289689
"Tri-Cities, TN-VA",41815,611,20,19,18,57,0.093289689
Indianapolis,46228,16101,495,513,494,1502,0.093286131
"Albany, GA",31632,15340,570,425,436,1431,0.093285528
Tulsa,74347,2755,95,81,81,257,0.093284936
Toledo,43610,4095,144,134,104,382,0.093284493
La Crosse-Eau Claire,54670,1876,70,54,51,175,0.093283582
Little Rock-Pine Bluff,72824,1608,60,54,36,150,0.093283582
"Lafayette, LA",70647,13422,489,396,367,1252,0.09327969
Memphis,72376,1726,65,56,40,161,0.093279258
New York,7740,32602,946,977,1118,3041,0.093276486
Minneapolis-St. Paul,56270,922,37,26,23,86,0.093275488
San Antonio,78052,7998,274,253,219,746,0.093273318
Indianapolis,47201,47691,1527,1372,1549,4448,0.093267073
Bluefield-Beckley-Oak Hill,24985,579,18,13,23,54,0.093264249
"Washington, DC (Hagrstwn)",20120,40993,1272,1298,1253,3823,0.093259825
Charleston-Huntington,41238,1083,35,34,32,101,0.093259464
Mobile-Pensacola (Ft Walt),36576,5662,178,173,177,528,0.093253267
West Palm Beach-Ft. Pierce,33460,37812,1102,1172,1252,3526,0.09325082
Dallas-Ft. Worth,75442,12161,459,360,315,1134,0.09324891
New York,11003,43830,1197,1384,1506,4087,0.093246635
Jacksonville,32205,29645,711,869,1184,2764,0.093236633
San Francisco-Oak-San Jose,94513,70490,2623,2196,1753,6572,0.093233083
Beaumont-Port Arthur,77701,12893,419,398,385,1202,0.093228884
Dayton,45332,590,25,17,13,55,0.093220339
Denver,80705,944,30,27,31,88,0.093220339
Charleston-Huntington,25702,7123,162,194,308,664,0.093219149
Cleveland-Akron (Canton),44878,3433,129,90,101,320,0.093212933
Sacramnto-Stkton-Modesto,95822,45212,1407,1419,1388,4214,0.093205344
Rochestr-Mason City-Austin,55912,29988,1060,906,829,2795,0.093203948
Paducah-Cape Girard-Harsbg,63869,3251,112,85,106,303,0.093202092
Sacramnto-Stkton-Modesto,95830,912,34,28,23,85,0.093201754
Seattle-Tacoma,98801,46559,1446,1509,1384,4339,0.093193582
Medford-Klamath Falls,97501,47315,1378,1454,1577,4409,0.09318398
Birmingham (Ann and Tusc),35456,4443,153,126,135,414,0.093180284
Atlanta,30182,3048,101,93,90,284,0.093175853
Los Angeles,92585,28474,943,856,854,2653,0.093172719
Odessa-Midland,79756,9960,353,318,257,928,0.093172691
Atlanta,30179,20124,659,574,642,1875,0.093172332
Boston (Manchester),2170,19717,460,570,807,1837,0.093168332
Los Angeles,93536,73115,2406,2290,2116,6812,0.093168297
Wichita Falls & Lawton,73507,21747,636,704,686,2026,0.093162275
Champaign&Sprngfld-Decatur,62526,30582,851,970,1028,2849,0.093159375
New York,7205,21964,643,664,739,2046,0.093152431
Savannah,30410,1986,73,63,49,185,0.093152064
Birmingham (Ann and Tusc),35007,29342,1021,904,808,2733,0.093142935
Phoenix (Prescott),85546,20850,655,630,657,1942,0.093141487
"Washington, DC (Hagrstwn)",20852,53092,1148,1580,2217,4945,0.093140209
Cleveland-Akron (Canton),44128,27089,759,837,927,2523,0.093137436
San Diego,92020,61181,1832,1890,1976,5698,0.093133489
Harrisburg-Lncstr-Leb-York,17519,6722,235,200,191,626,0.093127046
Lansing,49252,2706,83,87,82,252,0.093126386
Augusta-Aiken,30907,53552,1543,1621,1823,4987,0.09312444
Harrisburg-Lncstr-Leb-York,17518,1396,51,39,40,130,0.093123209
Corpus Christi,78416,13799,477,439,369,1285,0.09312269
New York,11378,37007,1020,1171,1255,3446,0.093117518
Bangor,4630,1278,60,31,28,119,0.093114241
Great Falls,59401,13221,324,437,470,1231,0.093109447
Austin,78655,2975,94,99,84,277,0.093109244
Tulsa,74106,17099,573,538,481,1592,0.09310486
New York,8902,43364,1259,1343,1435,4037,0.093095655
Hattiesburg-Laurel,39465,23181,810,688,660,2158,0.093093482
"Lafayette, LA",70570,39115,1366,1173,1102,3641,0.093084494
"Alexandria, LA",71360,35217,1151,1089,1038,3278,0.093080047
Kansas City,66111,8627,258,288,257,803,0.093079866
Cedar Rapids-Wtrlo-IWC&Dub,52777,1343,48,40,37,125,0.093075205
Seattle-Tacoma,98276,1343,49,40,36,125,0.093075205
Myrtle Beach-Florence,29536,14816,503,447,429,1379,0.093075054
Greensboro-H.Point-W.Salem,27301,11088,361,349,322,1032,0.093073593
Champaign&Sprngfld-Decatur,61723,2310,83,74,58,215,0.093073593
"Washington, DC (Hagrstwn)",20872,12206,413,370,353,1136,0.093068982
Little Rock-Pine Bluff,72015,30140,1003,899,903,2805,0.093065693
Denver,80227,34148,779,1095,1304,3178,0.09306548
Phoenix (Prescott),85395,43340,1219,1233,1581,4033,0.093054915
Wichita-Hutchinson Plus,67042,17710,640,523,485,1648,0.093054771
Kansas City,64050,21140,626,687,654,1967,0.093046358
Lake Charles,70615,13789,471,419,393,1283,0.093045181
Salisbury,19941,3235,121,100,80,301,0.093044822
Louisville,40216,43078,1362,1314,1332,4008,0.093040531
Harrisburg-Lncstr-Leb-York,17109,24571,605,754,927,2286,0.093036506
Phoenix (Prescott),85142,107407,4404,3105,2483,9992,0.093029318
Los Angeles,90066,53736,940,1412,2647,4999,0.093028882
"Springfield, MO",65790,688,25,23,16,64,0.093023256
Denver,80528,26596,1022,731,721,2474,0.093021507
Albuquerque-Santa Fe,87410,16115,561,503,435,1499,0.093018926
Ft. Smith-Fay-Sprngdl-Rgrs,72745,15653,538,456,462,1456,0.093017313
Lansing,48875,10880,362,332,318,1012,0.093014706
Los Angeles,91401,40177,946,1209,1582,3737,0.093013416
New York,11429,24460,669,760,846,2275,0.093008994
Flint-Saginaw-Bay City,48601,31402,979,959,982,2920,0.092987708
Greensboro-H.Point-W.Salem,27103,35919,899,1109,1332,3340,0.092986999
St. Louis,63368,47137,1712,1498,1173,4383,0.09298428
Eugene,97477,38383,973,1170,1426,3569,0.092983873
Dallas-Ft. Worth,76065,53461,1997,1626,1348,4971,0.09298367
Cleveland-Akron (Canton),44144,20606,533,667,716,1916,0.092982626
New York,7801,27016,758,858,896,2512,0.092981937
Las Vegas,89002,38244,1352,1195,1009,3556,0.092981906
Houston,77354,49731,1812,1587,1225,4624,0.092980234
New York,11366,13638,344,438,486,1268,0.09297551
Tulsa,74016,6120,212,184,173,569,0.092973856
Grand Rapids-Kalmzoo-B.Crk,49459,1409,54,40,37,131,0.09297374
New York,11203,81454,2187,2501,2885,7573,0.092972721
Los Angeles,91351,35474,1101,1150,1047,3298,0.092969499
Rockford,61101,18942,645,565,551,1761,0.092968008
Memphis,38039,1635,54,56,42,152,0.092966361
Grand Rapids-Kalmzoo-B.Crk,49450,3270,118,100,86,304,0.092966361
Philadelphia,8610,32883,976,1016,1065,3057,0.09296597
New York,11726,20298,593,644,650,1887,0.092964824
St. Louis,65566,796,24,23,27,74,0.092964824
Lake Charles,70665,12564,424,393,351,1168,0.092964024
Lubbock,79404,10241,353,320,279,952,0.092959672
"Springfield, MO",65667,3464,125,88,109,322,0.09295612
Miami-Ft. Lauderdale,33325,31317,1050,1001,860,2911,0.092952709
Atlanta,30542,44338,1400,1323,1398,4121,0.092945104
Grand Rapids-Kalmzoo-B.Crk,49048,25080,689,738,904,2331,0.092942584
Columbus-Tupelo-West Point,38827,2733,81,89,84,254,0.092938163
Nashville,37174,57319,2036,1665,1626,5327,0.092936025
Chicago,60156,27901,1022,839,732,2593,0.092935737
Tampa-St. Pete (Sarasota),33579,54468,2048,1548,1466,5062,0.092935301
Cincinnati,41098,1797,63,67,37,167,0.092932666
Seattle-Tacoma,98201,33058,726,1069,1277,3072,0.092927582
Greenvll-Spart-Ashevll-And,29670,9836,263,284,367,914,0.092923953
St. Louis,63132,14604,424,443,490,1357,0.092919748
Greenvll-Spart-Ashevll-And,29605,38991,1187,1180,1256,3623,0.092918879
Ft. Wayne,46814,16886,692,539,338,1569,0.09291721
Memphis,38665,2400,89,75,59,223,0.092916667
"Springfield, MO",72638,7609,265,235,207,707,0.092916283
New York,7062,15736,476,483,503,1462,0.092907982
Champaign&Sprngfld-Decatur,62656,18330,450,547,706,1703,0.092907801
Los Angeles,92307,41398,1405,1239,1202,3846,0.092903039
Watertown,13619,10485,314,324,336,974,0.092894611
Macon,31075,2519,86,83,65,234,0.092894006
Ft. Wayne,46804,29873,870,956,949,2775,0.092893248
San Antonio,78064,16363,558,486,476,1520,0.092892501
Chicago,46404,15018,484,422,489,1395,0.092888534
New York,12428,7073,228,230,199,657,0.092888449
Hartford & New Haven,6418,12284,341,387,413,1141,0.092885054
"Lafayette, LA",70526,16655,543,545,459,1547,0.09288502
Greenvll-Spart-Ashevll-And,29611,34247,1093,1034,1054,3181,0.092884048
Nashville,37035,4102,134,134,113,381,0.092881521
Albuquerque-Santa Fe,87415,1475,62,42,33,137,0.092881356
"Springfield, MO",65679,2584,76,76,88,240,0.092879257
Billings,59102,50485,1464,1605,1620,4689,0.092879073
Atlanta,30147,4156,135,128,123,386,0.092877767
San Francisco-Oak-San Jose,95401,36812,1038,1135,1246,3419,0.092877323
"Rochester, NY",14609,40765,1167,1187,1432,3786,0.092873789
Rockford,61065,11080,400,344,285,1029,0.092870036
Dayton,43318,3338,121,107,82,310,0.092869982
Philadelphia,8360,42438,1473,1294,1174,3941,0.092864885
Los Angeles,90670,17413,484,562,571,1617,0.092861655
Seattle-Tacoma,98354,7463,196,218,279,693,0.0928581
Lincoln & Hastings-Krny,69134,280,9,11,6,26,0.092857143
"Washington, DC (Hagrstwn)",21702,50853,1509,1560,1653,4722,0.092855879
Atlanta,30511,3177,104,98,93,295,0.092854895
San Antonio,78154,44338,1469,1349,1299,4117,0.092854887
New York,11428,18933,477,578,703,1758,0.092853747
Ft. Wayne,46755,15627,457,523,471,1451,0.092852115
"Washington, DC (Hagrstwn)",20902,52333,1495,1564,1800,4859,0.092847725
Salt Lake City,84040,27713,987,818,768,2573,0.092844513
Chicago,46403,11558,351,349,373,1073,0.092836131
Atlanta,30079,4061,112,125,140,377,0.092834277
Pittsburgh,15214,13982,403,423,472,1298,0.092833643
Charlotte,28025,61381,2118,1864,1716,5698,0.092830029
Philadelphia,8312,8575,262,266,268,796,0.092827988
New York,10465,43134,1198,1468,1338,4004,0.092827004
Corpus Christi,78332,27115,954,804,759,2517,0.092826849
Tyler-Longview(Lfkn&Ncgd),75693,6550,246,189,173,608,0.092824427
West Palm Beach-Ft. Pierce,34950,16946,535,500,538,1573,0.092824265
Cincinnati,45251,21837,679,660,688,2027,0.092824106
Wichita-Hutchinson Plus,67156,14199,491,466,361,1318,0.092823438
"Charleston, SC",29555,5850,205,187,151,543,0.092820513
Paducah-Cape Girard-Harsbg,63740,5236,159,178,149,486,0.092818946
Corpus Christi,78370,4773,164,155,124,443,0.092813744
Los Angeles,91792,28401,747,871,1018,2636,0.092813633
Colorado Springs-Pueblo,81008,12326,322,386,436,1144,0.092811942
Sacramnto-Stkton-Modesto,95827,21690,628,631,754,2013,0.092807746
Los Angeles,91204,16304,313,473,727,1513,0.092799313
New York,7022,15561,441,465,538,1444,0.092796093
Denver,80621,15378,506,504,417,1427,0.092794902
Denver,80501,44002,1212,1371,1500,4083,0.092791237
Champaign&Sprngfld-Decatur,62517,194,5,7,6,18,0.092783505
Atlanta,30116,25242,844,747,751,2342,0.092781871
New York,11580,41768,1209,1281,1385,3875,0.092774373
Minneapolis-St. Paul,55432,34160,945,1043,1181,3169,0.092769321
Fresno-Visalia,93641,636,20,18,21,59,0.092767296
Salt Lake City,84624,6091,258,157,150,565,0.09275981
Houston,77577,1229,45,42,27,114,0.09275834
Dallas-Ft. Worth,76108,49421,1591,1444,1549,4584,0.092754092
Billings,59105,34317,1122,1072,989,3183,0.092752863
"Charleston, SC",29560,12205,406,381,345,1132,0.092748873
Toledo,43460,6081,179,197,188,564,0.092747903
Philadelphia,19012,6976,219,227,201,647,0.09274656
Madison,53590,46277,1461,1376,1455,4292,0.092745856
Omaha,68144,25243,686,754,901,2341,0.092738581
"Washington, DC (Hagrstwn)",20886,35886,1111,1100,1117,3328,0.092738115
Lubbock,79364,8055,274,252,221,747,0.09273743
San Antonio,78026,6017,213,188,157,558,0.092737244
Tallahassee-Thomasville,31631,550,20,17,14,51,0.092727273
Pittsburgh,15071,11960,430,367,312,1109,0.092725753
New York,8852,18539,606,607,506,1719,0.092723448
Savannah,31560,2815,112,79,70,261,0.092717584
Evansville,62850,453,17,11,14,42,0.092715232
Detroit,48204,21701,670,660,682,2012,0.092714621
Boise,97913,5997,217,192,147,556,0.092713023
Chicago,60659,39672,1191,1207,1280,3678,0.092710224
Chicago,46342,32306,970,981,1044,2995,0.092707237
Davenport-R.Island-Moline,61401,31573,989,1150,788,2927,0.092705793
Seattle-Tacoma,98446,13365,346,340,553,1239,0.092704826
Nashville,37180,3096,110,88,89,287,0.092700258
Greenvll-Spart-Ashevll-And,29376,9148,302,285,261,848,0.092697857
Hartford & New Haven,6040,35817,963,1114,1243,3320,0.092693414
Memphis,72354,2039,59,78,52,189,0.092692496
Atlanta,30292,6592,229,206,176,611,0.092688107
Salt Lake City,84006,1176,30,56,23,109,0.092687075
Tampa-St. Pete (Sarasota),33759,18331,434,612,653,1699,0.092684523
Salt Lake City,84712,205,8,6,5,19,0.092682927
Minneapolis-St. Paul,55352,10509,407,316,251,974,0.092682463
Greensboro-H.Point-W.Salem,27344,17695,643,555,442,1640,0.092681548
Charlotte,28135,4629,85,141,203,429,0.092676604
Huntsville-Decatur (Flor),35810,29738,959,914,883,2756,0.092676037
Rochestr-Mason City-Austin,55955,2838,113,95,55,263,0.092670895
Green Bay-Appleton,53926,1910,69,61,47,177,0.092670157
New York,11949,14332,460,465,403,1328,0.092659782
Seattle-Tacoma,98277,42480,1027,1226,1683,3936,0.092655367
South Bend-Elkhart,46514,42223,1299,1231,1382,3912,0.092650925
Phoenix (Prescott),85138,62342,2319,1765,1692,5776,0.09265022
Amarillo,79040,1673,64,52,39,155,0.092647938
Sacramnto-Stkton-Modesto,95757,59960,2334,1763,1458,5555,0.092645097
Salt Lake City,84336,421,16,14,9,39,0.09263658
Augusta-Aiken,30830,15254,513,483,417,1413,0.092631441
Los Angeles,90501,42189,1207,1250,1451,3908,0.092630781
Lansing,48917,31696,771,937,1228,2936,0.092629985
Raleigh-Durham (Fayetvlle),27703,67970,1742,1965,2589,6296,0.092629101
Indianapolis,46143,66158,2206,1946,1976,6128,0.092626742
"Washington, DC (Hagrstwn)",21701,42159,1189,1329,1387,3905,0.092625537
Chicago,60490,22363,835,701,535,2071,0.092608326
Ft. Wayne,45863,1285,46,30,43,119,0.092607004
Oklahoma City,73750,7419,284,222,181,687,0.092600081
Little Rock-Pine Bluff,72118,22268,701,690,671,2062,0.092599246
Ft. Smith-Fay-Sprngdl-Rgrs,74937,4849,169,151,129,449,0.092596412
Little Rock-Pine Bluff,72011,4903,183,140,131,454,0.09259637
Charlottesville,22725,54,2,1,2,5,0.092592593
Idaho Fals-Pocatllo(Jcksn),83215,54,2,2,1,5,0.092592593
Salt Lake City,84069,432,17,13,10,40,0.092592593
South Bend-Elkhart,46746,4493,156,126,134,416,0.092588471
Jonesboro,72450,41120,1314,1245,1248,3807,0.092582685
Joplin-Pittsburg,64862,3262,108,112,82,302,0.092581239
Honolulu,96706,75395,2348,2250,2382,6980,0.092579083
Detroit,48166,13448,407,391,447,1245,0.092578822
Davenport-R.Island-Moline,52806,28876,874,833,966,2673,0.092568223
Seattle-Tacoma,98031,44424,1265,1342,1505,4112,0.092562579
"Columbus, OH",43230,59453,1610,1795,2098,5503,0.09256051
Biloxi-Gulfport,39503,56874,1870,1693,1701,5264,0.092555474
Shreveport,71841,994,35,33,24,92,0.092555332
Watertown,13612,2766,82,92,82,256,0.092552422
Philadelphia,19401,44289,1300,1335,1464,4099,0.092551198
Columbus-Tupelo-West Point,39090,12512,462,377,319,1158,0.092551151
Joplin-Pittsburg,66754,443,19,13,9,41,0.09255079
Salt Lake City,84035,832,41,25,11,77,0.092548077
Kansas City,64052,22476,659,678,743,2080,0.092543157
Greenvll-Spart-Ashevll-And,28704,26788,716,825,938,2479,0.092541436
"Columbus, OH",43016,46500,1182,1258,1863,4303,0.092537634
Wichita-Hutchinson Plus,67401,49376,1534,1544,1491,4569,0.092534835
Los Angeles,91770,57319,1495,1873,1936,5304,0.092534762
Huntsville-Decatur (Flor),35963,1902,64,58,54,176,0.092534175
Hartford & New Haven,6042,24391,517,727,1013,2257,0.092534131
Fresno-Visalia,93723,15000,515,420,453,1388,0.092533333
Hattiesburg-Laurel,39330,2864,107,84,74,265,0.092527933
Las Vegas,89129,56006,1659,1788,1735,5182,0.092525801
Baltimore,20723,36445,1258,1105,1009,3372,0.09252298
New York,7644,26437,667,822,957,2446,0.092521844
New York,11234,86285,2487,2795,2701,7983,0.092518978
Sacramnto-Stkton-Modesto,95620,23563,743,740,697,2180,0.092517931
Louisville,40118,10344,326,315,316,957,0.092517401
Providence-New Bedford,2904,30211,834,959,1002,2795,0.092515971
Hattiesburg-Laurel,39462,962,25,30,34,89,0.092515593
Fargo,58078,40882,1234,1089,1459,3782,0.092510151
Augusta-Aiken,30815,39954,1329,1218,1149,3696,0.092506382
Twin Falls,83350,13383,492,372,374,1238,0.092505417
Knoxville,37849,28247,916,895,802,2613,0.092505399
Evansville,42220,6724,233,196,193,622,0.092504462
Philadelphia,8205,28313,791,857,971,2619,0.092501678
Sioux City,51240,1827,70,48,51,169,0.092501368
Lexington,41365,400,14,12,11,37,0.0925
Topeka,66510,800,31,22,21,74,0.0925
Cincinnati,45154,9741,356,288,257,901,0.092495637
Seattle-Tacoma,98445,34672,1044,1017,1146,3207,0.092495385
New York,10037,20231,438,584,849,1871,0.092481835
Harrisonburg,22939,6942,221,233,188,642,0.092480553
Los Angeles,90701,15982,434,497,547,1478,0.092479039
Charlotte,28081,31954,1016,961,978,2955,0.092476685
Oklahoma City,73857,638,22,20,17,59,0.092476489
Miami-Ft. Lauderdale,33332,10803,491,303,205,999,0.092474313
Detroit,48187,52231,1600,1615,1615,4830,0.092473818
Meridian,39301,22786,701,724,682,2107,0.09246906
Tulsa,74126,10555,403,303,270,976,0.092468025
Tampa-St. Pete (Sarasota),33765,14297,346,488,488,1322,0.092466951
Lexington,40949,584,17,19,18,54,0.092465753
Atlanta,30265,38805,1239,1186,1163,3588,0.092462312
Burlington-Plattsburgh,5403,20679,452,665,795,1912,0.092460951
"Tri-Cities, TN-VA",24340,5116,185,171,117,473,0.092455043
Baltimore,21001,28209,823,876,909,2608,0.092452763
Meridian,39051,15792,546,476,438,1460,0.092451874
Tallahassee-Thomasville,39828,15922,550,484,438,1472,0.092450697
Los Angeles,92672,39697,951,1486,1233,3670,0.092450311
Ottumwa-Kirksville,63536,887,26,27,29,82,0.092446449
Richmond-Petersburg,23237,25961,835,811,754,2400,0.092446362
Philadelphia,8068,6631,191,205,217,613,0.092444578
"Lafayette, LA",70583,12105,430,346,343,1119,0.09244114
Raleigh-Durham (Fayetvlle),27529,62052,1932,1896,1908,5736,0.0924386
Houston,77372,14497,534,448,358,1340,0.092432917
Cincinnati,41042,55955,1681,1698,1793,5172,0.092431418
Myrtle Beach-Florence,29505,24862,793,729,776,2298,0.092430215
Los Angeles,90247,47009,1285,1468,1592,4345,0.092429109
Norfolk-Portsmth-Newpt Nws,23325,17592,490,541,595,1626,0.092428377
Chicago,60482,11490,308,363,391,1062,0.092428198
Charlotte,28227,62146,1930,1927,1887,5744,0.092427509
Topeka,66603,1439,41,46,46,133,0.092425295
Idaho Fals-Pocatllo(Jcksn),83404,27482,972,874,694,2540,0.092424132
Los Angeles,90710,26238,749,827,849,2425,0.092423203
Raleigh-Durham (Fayetvlle),27614,35251,1224,1136,898,3258,0.09242291
Philadelphia,19406,30005,600,899,1274,2773,0.09241793
Honolulu,96732,29162,924,919,852,2695,0.092414786
Tampa-St. Pete (Sarasota),33755,27855,801,863,910,2574,0.092407108
Atlanta,30115,56078,1929,1752,1501,5182,0.092407005
Sacramnto-Stkton-Modesto,95215,26957,954,824,713,2491,0.092406425
Eureka,95501,23538,559,694,922,2175,0.092403773
New York,10511,2446,77,71,78,226,0.092395748
New York,7307,44062,1001,1216,1854,4071,0.092392538
Phoenix (Prescott),85044,39906,994,1194,1499,3687,0.092392121
Jonesboro,72414,368,14,12,8,34,0.092391304
San Antonio,78155,58080,1972,1821,1573,5366,0.092389807
Shreveport,75686,13238,413,440,370,1223,0.092385557
Traverse City-Cadillac,49336,4081,140,125,112,377,0.092379319
Indianapolis,47330,5445,198,166,139,503,0.092378329
Salt Lake City,82930,13986,478,440,374,1292,0.092378092
"Portland, OR",98664,24563,625,777,867,2269,0.09237471
Topeka,66436,5835,205,176,158,539,0.092373608
Seattle-Tacoma,98387,51509,1748,1452,1558,4758,0.092372207
Omaha,51439,877,24,27,30,81,0.092360319
Lansing,49241,2382,76,78,66,220,0.092359362
"Albany, GA",31620,11163,386,329,316,1031,0.092358685
Wichita Falls & Lawton,76306,15116,463,473,460,1396,0.092352474
Yuma-El Centro,85365,52940,1648,1705,1536,4889,0.09234983
Savannah,31545,16600,568,499,466,1533,0.092349398
Quincy-Hannibal-Keokuk,62311,758,23,24,23,70,0.092348285
New York,12586,13276,416,369,441,1226,0.092347092
Dallas-Ft. Worth,75025,53765,1983,1669,1313,4965,0.092346322
Richmond-Petersburg,23836,15258,507,458,444,1409,0.092344999
Las Vegas,89144,19190,649,642,481,1772,0.09233976
Los Angeles,91203,16591,254,421,857,1532,0.09233922
Des Moines-Ames,50046,1527,55,46,40,141,0.092337917
Nashville,38575,1083,43,32,25,100,0.092336103
San Francisco-Oak-San Jose,94589,31954,941,1026,983,2950,0.09232021
"Washington, DC (Hagrstwn)",20136,31869,1329,947,666,2942,0.092315416
Oklahoma City,73005,7908,280,238,212,730,0.092311583
Utica,13417,3315,78,103,125,306,0.092307692
"Washington, DC (Hagrstwn)",21733,1170,39,36,33,108,0.092307692
Birmingham (Ann and Tusc),36776,1235,32,39,43,114,0.092307692
Fargo,56568,130,6,4,2,12,0.092307692
"Springfield, MO",65781,10075,346,320,264,930,0.092307692
Dallas-Ft. Worth,75439,910,29,30,25,84,0.092307692
Green Bay-Appleton,54913,25210,746,734,847,2327,0.092304641
Boston (Manchester),1607,9642,244,282,364,890,0.092304501
"Washington, DC (Hagrstwn)",25404,23715,733,680,776,2189,0.092304449
"Jackson, TN",38059,7519,245,237,212,694,0.092299508
Charleston-Huntington,25260,1701,37,42,78,157,0.092298648
New Orleans,70460,23067,777,692,660,2129,0.092296354
Denver,80102,7693,256,216,238,710,0.092291694
Detroit,48066,46918,1253,1409,1668,4330,0.092288674
Cleveland-Akron (Canton),43019,9687,356,286,252,894,0.092288634
Detroit,48185,48752,1071,1495,1933,4499,0.092283394
Salt Lake City,84055,1257,47,39,30,116,0.092283214
Jacksonville,32219,16872,554,512,491,1557,0.092283073
Columbus-Tupelo-West Point,38850,3381,121,103,88,312,0.09228039
"Washington, DC (Hagrstwn)",22701,39111,1338,1181,1090,3609,0.09227583
Rockford,61349,932,36,27,23,86,0.092274678
Milwaukee,53221,39480,1277,1227,1139,3643,0.092274569
Los Angeles,91737,23745,697,778,716,2191,0.092272057
Philadelphia,19076,6481,171,199,228,598,0.092269711
Los Angeles,91210,1073,16,25,58,99,0.092264678
Philadelphia,19015,16269,488,486,527,1501,0.092261356
Flint-Saginaw-Bay City,48607,1615,33,54,62,149,0.092260062
New York,7032,43107,1169,1378,1430,3977,0.092258798
Dayton,45845,3371,110,83,118,311,0.09225749
Topeka,67468,271,10,8,7,25,0.092250923
New Orleans,70076,271,8,8,9,25,0.092250923
Spokane,99217,20130,572,592,693,1857,0.092250373
San Francisco-Oak-San Jose,94514,1019,39,30,25,94,0.092247301
Wichita-Hutchinson Plus,67147,11014,443,321,252,1016,0.092246232
New York,11423,31124,825,980,1066,2871,0.092243928
Mobile-Pensacola (Ft Walt),36583,683,22,18,23,63,0.092240117
"Columbus, OH",45646,412,14,13,11,38,0.09223301
Ft. Wayne,46721,4944,152,153,151,456,0.09223301
Norfolk-Portsmth-Newpt Nws,27909,40929,1321,1358,1096,3775,0.092232891
Wausau-Rhinelander,54467,15190,413,468,520,1401,0.092231731
Dayton,45505,19148,597,556,613,1766,0.092228953
Madison,53598,4001,111,141,117,369,0.092226943
"Lafayette, LA",70657,5389,191,168,138,497,0.092224903
Sioux City,51048,553,28,14,9,51,0.092224231
St. Louis,62234,30817,835,934,1073,2842,0.092221826
Memphis,38001,4717,156,139,140,435,0.092219631
Houston,77094,11950,339,315,448,1102,0.092217573
New York,10604,12959,392,377,426,1195,0.092213905
Birmingham (Ann and Tusc),35171,3427,107,106,103,316,0.092208929
Huntsville-Decatur (Flor),35802,23903,522,796,886,2204,0.092205999
Boston (Manchester),1835,14804,431,490,444,1365,0.09220481
Kansas City,66213,32667,849,1065,1098,3012,0.092203141
Raleigh-Durham (Fayetvlle),27613,46464,1430,1334,1520,4284,0.092200413
Minneapolis-St. Paul,56170,564,21,21,10,52,0.092198582
Sioux Falls(Mitchell),57337,141,5,5,3,13,0.092198582
San Antonio,78225,12148,421,380,319,1120,0.092196246
Sioux City,68748,2983,110,86,79,275,0.092189071
Buffalo,14767,1920,78,61,38,177,0.0921875
Hattiesburg-Laurel,39322,1779,53,59,52,164,0.092186622
San Antonio,78629,12193,427,398,299,1124,0.09218404
"Washington, DC (Hagrstwn)",20705,31297,780,983,1122,2885,0.092181359
"Washington, DC (Hagrstwn)",20841,11402,417,354,280,1051,0.092176811
Los Angeles,90043,45772,1319,1399,1501,4219,0.092174255
Greenville-N.Bern-Washngtn,28341,3906,147,121,92,360,0.092165899
Houston,77584,94287,3341,2866,2483,8690,0.09216541
Austin,78612,16525,569,499,455,1523,0.092163389
Boston (Manchester),2302,36567,1184,1099,1087,3370,0.092159597
Tulsa,74445,2767,121,82,52,255,0.092157571
Dallas-Ft. Worth,76476,3353,123,106,80,309,0.092156278
Wilkes Barre-Scranton-Hztn,18504,20932,603,656,670,1929,0.092155551
Omaha,68046,36559,1330,1121,918,3369,0.092152411
Little Rock-Pine Bluff,72167,1758,65,47,50,162,0.092150171
Cleveland-Akron (Canton),44241,17439,462,488,657,1607,0.092149779
Phoenix (Prescott),85337,2496,96,69,65,230,0.092147436
Milwaukee,53154,37006,1044,1081,1285,3410,0.092147219
San Antonio,78161,955,33,28,27,88,0.092146597
Beaumont-Port Arthur,77619,16984,553,484,528,1565,0.092145549
Chicago,61342,8324,283,268,216,767,0.0921432
Anchorage,99502,23800,697,736,760,2193,0.092142857
Los Angeles,90046,48870,443,1131,2929,4503,0.092142419
Atlanta,30004,69474,2606,2196,1599,6401,0.092135187
Baton Rouge,70791,30228,1112,883,790,2785,0.092133122
Oklahoma City,74859,5351,171,157,165,493,0.092132312
Pittsburgh,15641,521,18,15,15,48,0.092130518
Paducah-Cape Girard-Harsbg,63901,34224,1165,995,993,3153,0.092128331
Wichita-Hutchinson Plus,67002,17378,741,522,338,1601,0.092127978
New York,11967,26649,858,768,829,2455,0.092123532
Louisville,47265,20223,665,608,590,1863,0.09212283
Salt Lake City,84052,1498,63,49,26,138,0.09212283
Tyler-Longview(Lfkn&Ncgd),75925,4125,154,115,111,380,0.092121212
Mobile-Pensacola (Ft Walt),36611,6112,208,165,190,563,0.092113874
La Crosse-Eau Claire,54612,6047,226,181,150,557,0.092111791
Shreveport,71837,5222,177,168,136,481,0.092110303
Sioux Falls(Mitchell),57301,18913,576,569,597,1742,0.092105959
Houston,77345,27197,1078,876,551,2505,0.092105747
"Lafayette, LA",70517,26275,905,743,772,2420,0.092102759
Colorado Springs-Pueblo,80911,34353,1037,957,1170,3164,0.092102582
Sacramnto-Stkton-Modesto,95355,62095,1976,1861,1882,5719,0.092100813
Dayton,45846,4354,159,127,115,401,0.092099219
Buffalo,14220,23281,599,719,826,2144,0.092092264
Columbus-Tupelo-West Point,39773,14683,492,460,400,1352,0.092079275
Ft. Wayne,46774,18278,623,530,530,1683,0.092077908
Baton Rouge,70785,23024,809,677,634,2120,0.092077832
St. Louis,62803,858,35,26,18,79,0.092074592
Atlanta,30176,7581,235,237,226,698,0.092072286
Des Moines-Ames,50265,32997,909,1001,1128,3038,0.092068976
Mobile-Pensacola (Ft Walt),36605,24200,795,720,713,2228,0.092066116
Charlotte,28054,41514,1168,1250,1404,3822,0.092065327
New York,7603,9841,294,295,317,906,0.092063815
Dallas-Ft. Worth,76009,23886,835,732,632,2199,0.092062296
Sacramnto-Stkton-Modesto,95829,33206,1119,1064,874,3057,0.092061676
"Columbus, GA (Opelika, AL)",36869,21464,646,625,705,1976,0.092061126
Oklahoma City,73141,2683,83,83,81,247,0.092061126
Spokane,83540,2292,79,62,70,211,0.092059337
Cincinnati,41017,42485,1356,1295,1260,3911,0.09205602
Mobile-Pensacola (Ft Walt),39367,14687,486,442,424,1352,0.092054198
Wilkes Barre-Scranton-Hztn,18334,4052,118,130,125,373,0.092053307
Sacramnto-Stkton-Modesto,95948,11211,405,312,315,1032,0.092052448
Sioux City,51023,3422,135,104,76,315,0.092051432
Evansville,47648,4378,145,127,131,403,0.092051165
Minneapolis-St. Paul,55445,13547,463,398,386,1247,0.0920499
Philadelphia,19363,18230,640,554,484,1678,0.092046078
"Alexandria, LA",71328,8193,292,238,224,754,0.092029782
Salt Lake City,84766,163,6,5,4,15,0.09202454
Des Moines-Ames,50317,38056,1194,1139,1169,3502,0.092022283
New Orleans,70359,9563,331,283,266,880,0.092021332
St. Louis,63146,31667,608,988,1318,2914,0.092020084
"Jackson, MS",39146,2619,87,80,74,241,0.092019855
Ft. Smith-Fay-Sprngdl-Rgrs,72956,34058,1146,990,998,3134,0.092019496
Flint-Saginaw-Bay City,48503,21615,629,648,712,1989,0.092019431
Lexington,40360,7216,231,212,221,664,0.092017738
Albuquerque-Santa Fe,88201,26106,868,819,715,2402,0.0920095
Wichita-Hutchinson Plus,67637,2565,94,66,76,236,0.092007797
Detroit,48466,1576,44,53,48,145,0.092005076
Sacramnto-Stkton-Modesto,95615,750,25,22,22,69,0.092
Buffalo,14206,21458,593,657,724,1974,0.091993662
Colorado Springs-Pueblo,80922,31872,1050,885,997,2932,0.091992972
Missoula,59821,2435,88,57,79,224,0.091991786
Pittsburgh,15104,7479,212,236,240,688,0.091990908
Monterey-Salinas,93907,23601,768,711,692,2171,0.091987628
Louisville,40242,9458,210,291,369,870,0.091985621
Detroit,48235,43366,1370,1310,1309,3989,0.091984504
Miami-Ft. Lauderdale,33147,48574,1415,1539,1514,4468,0.091983366
Boston (Manchester),1606,21330,547,687,728,1962,0.091983122
"Portland, OR",97701,46209,1216,1365,1669,4250,0.091973425
Dallas-Ft. Worth,76067,21289,688,614,656,1958,0.09197238
New York,6615,18734,540,592,591,1723,0.091971816
Philadelphia,17555,7122,243,221,191,655,0.091968548
Indianapolis,47978,10732,338,334,315,987,0.091967946
"Springfield, MO",65534,946,34,30,23,87,0.091966173
Sacramnto-Stkton-Modesto,95694,10406,351,334,272,957,0.091966173
Chicago,60455,16093,499,480,501,1480,0.091965451
Chicago,60415,12407,317,374,450,1141,0.091964214
Savannah,30436,11722,397,336,345,1078,0.091963829
Salt Lake City,84312,5263,212,155,117,484,0.091962759
Idaho Fals-Pocatllo(Jcksn),83444,1468,57,46,32,135,0.091961853
Pittsburgh,15212,26881,524,751,1197,2472,0.091960865
Ottumwa-Kirksville,52537,7612,282,217,201,700,0.091960063
Memphis,38019,14996,505,428,446,1379,0.091957855
New York,7723,1305,47,42,31,120,0.091954023
Ft. Wayne,47381,87,2,2,4,8,0.091954023
Palm Springs,92234,51874,1587,1682,1501,4770,0.09195358
New York,11228,46665,1304,1481,1506,4291,0.091953284
Tallahassee-Thomasville,32311,24361,617,714,909,2240,0.091950248
Ft. Myers-Naples,33935,24015,833,716,659,2208,0.091942536
Salt Lake City,84747,968,35,25,29,89,0.091942149
Atlanta,30327,24549,779,778,700,2257,0.091938572
Charleston-Huntington,41267,1327,38,43,41,122,0.091936699
Cleveland-Akron (Canton),44902,4710,133,150,150,433,0.091932059
New York,11411,18862,506,584,644,1734,0.091930866
Amarillo,79084,2317,90,66,57,213,0.091929219
Joplin-Pittsburg,64831,6266,203,194,179,576,0.091924673
Terre Haute,47512,3949,138,112,113,363,0.091922006
"Albany, GA",31721,19736,588,630,596,1814,0.091913255
San Antonio,78118,4809,154,131,157,442,0.091911
Indianapolis,46239,36952,1358,1065,973,3396,0.091903009
Houston,77002,22328,92,701,1259,2052,0.091902544
Charlotte,28073,5680,192,153,177,522,0.091901408
Milwaukee,53083,22580,868,644,563,2075,0.091895483
Peoria-Bloomington,61604,28479,800,853,964,2617,0.091892271
New York,12751,740,31,18,19,68,0.091891892
Lake Charles,70663,29114,969,881,825,2675,0.091880195
Philadelphia,8608,751,23,20,26,69,0.091877497
Detroit,48317,28148,668,802,1116,2586,0.091871536
Shreveport,75935,12681,436,388,341,1165,0.091869726
Monroe-El Dorado,71292,22305,742,684,623,2049,0.091862811
"Washington, DC (Hagrstwn)",20190,22610,405,668,1004,2077,0.091862008
Houston,77957,9079,313,263,258,834,0.091860337
Denver,80113,22175,467,631,939,2037,0.091860203
Charlotte,28147,27445,866,866,789,2521,0.09185644
Little Rock-Pine Bluff,72103,14207,502,428,375,1305,0.091856127
Montgomery-Selma,36092,22525,701,667,701,2069,0.091853496
Knoxville,37752,5596,133,168,213,514,0.091851322
Tampa-St. Pete (Sarasota),33827,3386,128,99,84,311,0.091848789
Tampa-St. Pete (Sarasota),33844,55733,1840,1685,1594,5119,0.091848635
North Platte,69163,871,36,27,17,80,0.09184845
Sacramnto-Stkton-Modesto,95356,35330,1086,1101,1058,3245,0.091848288
Watertown,13685,2134,54,81,61,196,0.091846298
Los Angeles,92865,20317,542,597,727,1866,0.091844268
Huntsville-Decatur (Flor),35756,26524,967,781,688,2436,0.091841351
Cleveland-Akron (Canton),44129,27330,656,794,1060,2510,0.091840468
Cedar Rapids-Wtrlo-IWC&Dub,50703,18652,590,551,572,1713,0.091840017
Atlanta,30622,11651,441,351,278,1070,0.091837611
Augusta-Aiken,30810,1960,61,58,61,180,0.091836735
Ft. Wayne,46819,9016,250,255,323,828,0.091836735
Flint-Saginaw-Bay City,48458,19502,601,556,634,1791,0.091836735
Minneapolis-St. Paul,56237,490,19,14,12,45,0.091836735
Phoenix (Prescott),86036,98,2,4,3,9,0.091836735
Charlotte,28345,11477,361,341,352,1054,0.091835846
Greenville-N.Bern-Washngtn,28464,2069,69,62,59,190,0.091831803
Oklahoma City,73099,93259,3201,2634,2729,8564,0.091830279
Corpus Christi,78387,9975,355,292,269,916,0.091829574
Phoenix (Prescott),85212,56769,2092,1721,1400,5213,0.091828287
Oklahoma City,73030,4574,160,143,117,420,0.091823349
Atlanta,30102,46949,1468,1354,1489,4311,0.091823042
Cincinnati,41005,24613,829,692,739,2260,0.091821395
Colorado Springs-Pueblo,81003,15030,379,443,558,1380,0.091816367
New York,7105,51582,1531,1565,1640,4736,0.091814974
Albany-Schenectady-Troy,12047,23493,566,709,882,2157,0.091814583
Cincinnati,45014,45375,1273,1439,1454,4166,0.091812672
Kansas City,66062,79707,2788,2530,1999,7317,0.091798713
Kansas City,64157,24393,1092,709,438,2239,0.091788628
Memphis,38620,3116,102,105,79,286,0.091784339
Green Bay-Appleton,54140,8553,231,269,285,785,0.091780662
Chicago,60410,13914,497,419,361,1277,0.091778065
Los Angeles,90249,26837,727,865,871,2463,0.091776279
Wilkes Barre-Scranton-Hztn,18617,1787,50,56,58,164,0.091773923
St. Louis,63380,948,26,28,33,87,0.091772152
"Jackson, MS",39046,29781,952,913,868,2733,0.09176992
Chicago,60018,28888,865,928,858,2651,0.091768208
"Portland, OR",97218,14962,412,469,492,1373,0.091765807
"Springfield, MO",65710,1177,45,34,29,108,0.091758709
Dallas-Ft. Worth,76240,29720,1027,850,850,2727,0.091756393
Chicago,60638,54986,1786,1654,1605,5045,0.091750627
Indianapolis,46234,28371,893,847,863,2603,0.091748617
Wilmington,28423,1853,62,57,51,170,0.091743119
Ft. Smith-Fay-Sprngdl-Rgrs,74940,2616,93,68,79,240,0.091743119
West Palm Beach-Ft. Pierce,33406,28155,868,844,871,2583,0.091742142
Chattanooga,37412,22378,572,628,853,2053,0.091741889
Ft. Wayne,45849,1101,40,29,32,101,0.091734787
Minneapolis-St. Paul,55053,883,30,32,19,81,0.091732729
"Columbia, SC",29113,1330,44,39,39,122,0.091729323
Macon,31079,2660,77,94,73,244,0.091729323
Miami-Ft. Lauderdale,33067,28313,980,886,731,2597,0.091724649
Little Rock-Pine Bluff,72858,3576,142,91,95,328,0.091722595
Cleveland-Akron (Canton),44231,8275,265,281,213,759,0.091722054
Detroit,48067,25174,355,661,1293,2309,0.091721618
Philadelphia,18073,11317,476,301,261,1038,0.091720421
Fargo,58068,338,13,8,10,31,0.091715976
Albuquerque-Santa Fe,87120,65758,1991,1957,2083,6031,0.091715076
Knoxville,37701,8690,265,251,281,797,0.091714614
Toledo,43620,5016,144,157,159,460,0.091706539
Raleigh-Durham (Fayetvlle),27557,9247,307,279,262,848,0.091705418
New York,10595,5714,152,200,172,524,0.091704585
Raleigh-Durham (Fayetvlle),27520,52528,1715,1544,1558,4817,0.091703472
"Columbia, SC",29107,2748,97,76,79,252,0.091703057
Evansville,42337,1832,67,54,47,168,0.091703057
Dallas-Ft. Worth,76148,24045,753,696,756,2205,0.091703057
Columbus-Tupelo-West Point,39766,2759,96,74,83,253,0.091699891
Dayton,43343,1265,41,42,33,116,0.091699605
Dallas-Ft. Worth,76227,76972,2746,2096,2216,7058,0.091695682
Honolulu,96795,10765,328,332,327,987,0.09168602
Denver,80435,8235,194,260,301,755,0.091681846
Ft. Wayne,46743,2247,82,62,62,206,0.091677793
Orlando-Daytona Bch-Melbrn,34759,49206,1673,1543,1295,4511,0.091675812
"Jackson, MS",39059,11748,377,345,355,1077,0.091675179
Joplin-Pittsburg,64843,3327,116,103,86,305,0.091674181
Fargo,56529,4789,169,149,121,439,0.091668407
Dayton,45424,50945,1540,1486,1644,4670,0.091667485
Syracuse,14881,240,6,6,10,22,0.091666667
Wichita-Hutchinson Plus,67953,120,4,4,3,11,0.091666667
Amarillo,79088,5160,198,147,128,473,0.091666667
Oklahoma City,73550,2051,88,57,43,188,0.091662604
Champaign&Sprngfld-Decatur,60952,611,24,15,17,56,0.091653028
Mobile-Pensacola (Ft Walt),36460,9460,301,288,278,867,0.091649049
Baton Rouge,70769,50596,1880,1456,1301,4637,0.091647561
Providence-New Bedford,2724,18146,511,516,636,1663,0.091645542
Philadelphia,19074,5576,175,163,173,511,0.091642755
Myrtle Beach-Florence,28383,6820,219,220,186,625,0.091642229
Tampa-St. Pete (Sarasota),33570,40539,1420,1184,1111,3715,0.091640149
Raleigh-Durham (Fayetvlle),27542,9701,342,288,259,889,0.091640037
Tampa-St. Pete (Sarasota),33584,30751,970,940,908,2818,0.091639296
"Portland, OR",97325,7366,250,237,188,675,0.091637252
New York,10606,17744,504,534,588,1626,0.09163661
Los Angeles,91602,18094,270,476,912,1658,0.091632585
Houston,77581,49655,1659,1509,1382,4550,0.091632263
Sherman-Ada,75459,6057,192,184,179,555,0.09162952
Champaign&Sprngfld-Decatur,62627,884,24,27,30,81,0.091628959
"Columbus, OH",43015,64984,2232,2237,1485,5954,0.091622553
"Jackson, MS",39180,28357,906,844,848,2598,0.09161759
Baton Rouge,70341,3340,122,102,82,306,0.091616766
Oklahoma City,73852,1954,84,46,49,179,0.09160696
"Charleston, SC",29410,21112,668,592,674,1934,0.091606669
Buffalo,14218,21800,603,664,730,1997,0.091605505
Evansville,42328,1310,42,42,36,120,0.091603053
Odessa-Midland,79783,131,5,4,3,12,0.091603053
Los Angeles,92359,9181,290,279,272,841,0.091602222
Grand Rapids-Kalmzoo-B.Crk,49022,29389,924,915,853,2692,0.091598898
Chattanooga,37409,2784,67,68,120,255,0.091594828
"Columbus, OH",43147,48606,1757,1500,1195,4452,0.09159363
Albany-Schenectady-Troy,12304,21552,628,650,696,1974,0.091592428
Dayton,43311,20373,638,609,619,1866,0.091591813
Shreveport,74745,9455,315,273,278,866,0.09159175
Greensboro-H.Point-W.Salem,27302,36347,1121,1061,1147,3329,0.091589402
Tampa-St. Pete (Sarasota),33635,18409,483,544,659,1686,0.091585637
Wichita-Hutchinson Plus,67877,2151,74,67,56,197,0.091585309
Milwaukee,53222,25213,722,779,808,2309,0.091579741
Harrisburg-Lncstr-Leb-York,17566,13770,477,405,379,1261,0.09157589
Chicago,60544,29375,1037,878,775,2690,0.091574468
"Washington, DC (Hagrstwn)",20904,56841,1694,1790,1721,5205,0.091571225
"Washington, DC (Hagrstwn)",20129,699,28,22,14,64,0.091559371
Champaign&Sprngfld-Decatur,62704,38074,920,1201,1365,3486,0.091558544
Los Angeles,93021,36982,1162,1145,1079,3386,0.091558055
Salt Lake City,89825,983,22,37,31,90,0.09155646
Philadelphia,19802,26029,782,830,771,2383,0.091551731
Chattanooga,37312,38230,1063,1162,1275,3500,0.091551138
Youngstown,44490,710,22,19,24,65,0.091549296
Memphis,72373,994,38,25,28,91,0.091549296
Denver,80735,426,21,9,9,39,0.091549296
Dallas-Ft. Worth,75088,30520,887,872,1035,2794,0.091546527
San Antonio,78151,1300,45,37,37,119,0.091538462
"Columbus, GA (Opelika, AL)",36854,16474,485,504,519,1508,0.091538181
Orlando-Daytona Bch-Melbrn,32724,44528,1514,1515,1047,4076,0.091537909
St. Louis,62018,3190,89,87,116,292,0.09153605
Charlotte,28079,43022,1490,1270,1178,3938,0.091534564
Memphis,72384,874,33,23,24,80,0.091533181
Greensboro-H.Point-W.Salem,27209,3791,125,125,97,347,0.091532577
New Orleans,70443,11013,379,333,296,1008,0.091528194
"Alexandria, LA",71446,22136,632,655,739,2026,0.091525117
Baltimore,21921,46591,1374,1393,1497,4264,0.091519821
Macon,31011,896,30,31,21,82,0.091517857
"Lafayette, LA",70560,38038,1184,1138,1159,3481,0.091513749
Harrisburg-Lncstr-Leb-York,17563,3759,114,117,113,344,0.0915137
Amarillo,73945,2262,82,59,66,207,0.091511936
New York,7470,53403,1851,1759,1277,4887,0.091511713
New Orleans,70377,3497,132,107,81,320,0.091507006
"Springfield, MO",65704,3803,124,111,113,348,0.091506705
Syracuse,13120,2437,72,64,87,223,0.09150595
Phoenix (Prescott),85381,27048,725,844,906,2475,0.091503993
Des Moines-Ames,50558,612,23,15,18,56,0.091503268
Little Rock-Pine Bluff,71651,153,5,5,4,14,0.091503268
Denver,81435,5224,133,120,225,478,0.091500766
Raleigh-Durham (Fayetvlle),27504,19585,640,593,559,1792,0.091498596
New York,8540,48254,1638,1453,1324,4415,0.091495006
Rapid City,57750,623,20,21,16,57,0.091492777
Las Vegas,89146,19641,481,607,709,1797,0.091492287
Amarillo,79092,1410,59,44,26,129,0.091489362
Cleveland-Akron (Canton),44120,34007,956,1063,1092,3111,0.091481166
Kansas City,64015,33145,1148,1010,874,3032,0.091476844
Atlanta,30528,24662,753,856,647,2256,0.091476766
Lansing,49232,2886,98,86,80,264,0.091476091
Dallas-Ft. Worth,76028,80964,2925,2358,2123,7406,0.091472753
"Springfield, MO",65746,9205,345,257,240,842,0.091472026
Cleveland-Akron (Canton),44127,4056,138,106,127,371,0.091469428
Sacramnto-Stkton-Modesto,95350,55331,1638,1629,1794,5061,0.091467712
Chicago,46407,9785,310,287,298,895,0.09146653
Houston,77423,18204,649,533,483,1665,0.091463415
"Springfield, MO",65619,9393,298,275,286,859,0.091451081
New Orleans,70114,22406,680,695,674,2049,0.091448719
Houston,77336,15517,539,473,407,1419,0.091448089
Yuma-El Centro,92251,27207,959,795,734,2488,0.091447054
Oklahoma City,73095,1859,66,58,46,170,0.091447015
Cleveland-Akron (Canton),44288,3390,105,107,98,310,0.091445428
"Washington, DC (Hagrstwn)",20814,36473,830,1048,1457,3335,0.091437502
Champaign&Sprngfld-Decatur,61929,689,20,24,19,63,0.091436865
Nashville,38567,864,30,24,25,79,0.091435185
San Diego,92130,63970,2490,1879,1480,5849,0.091433484
Philadelphia,19713,31214,833,892,1129,2854,0.091433331
Green Bay-Appleton,54162,9887,335,315,254,904,0.091433195
Birmingham (Ann and Tusc),35452,4528,155,126,133,414,0.091431095
Charlotte,29550,29367,992,945,748,2685,0.091429155
New York,11796,3500,108,120,92,320,0.091428571
Savannah,30417,11124,367,346,304,1017,0.091423948
Birmingham (Ann and Tusc),36260,4299,143,128,122,393,0.091416609
Birmingham (Ann and Tusc),35447,3271,78,97,124,299,0.091409355
Greensboro-H.Point-W.Salem,27104,30369,788,912,1076,2776,0.091409003
Kansas City,64601,11750,334,320,420,1074,0.091404255
Mobile-Pensacola (Ft Walt),36544,11674,392,347,328,1067,0.091399692
Oklahoma City,73669,1674,57,55,41,153,0.091397849
Shreveport,75631,2440,92,82,49,223,0.091393443
Phoenix (Prescott),85027,37727,888,1043,1517,3448,0.091393432
Joplin-Pittsburg,67337,11478,457,342,250,1049,0.091392229
Salt Lake City,84129,38968,1222,1197,1142,3561,0.091382673
Waco-Temple-Bryan,77859,7321,267,220,182,669,0.091380959
New York,7203,22872,646,686,758,2090,0.091378104
Denver,80304,27151,721,872,888,2481,0.09137785
Milwaukee,53525,4082,138,114,121,373,0.091376776
Wichita-Hutchinson Plus,67855,1751,60,50,50,160,0.091376356
Champaign&Sprngfld-Decatur,61832,30380,968,921,887,2776,0.091375905
Norfolk-Portsmth-Newpt Nws,23321,39157,1347,1182,1049,3578,0.091375744
El Paso (Las Cruces),79847,197,6,5,7,18,0.091370558
Panama City,32405,29222,877,906,887,2670,0.091369516
Detroit,48238,25491,798,732,799,2329,0.09136558
Wichita-Hutchinson Plus,67869,1401,46,40,42,128,0.091363312
Oklahoma City,74865,1817,67,45,54,166,0.091359384
Chicago,60104,18281,558,547,565,1670,0.091351677
Oklahoma City,73074,1029,36,33,25,94,0.091350826
Dothan,36350,8451,254,243,275,772,0.091350136
Baltimore,21207,45643,1248,1380,1541,4169,0.091339307
Knoxville,40965,12492,368,358,415,1141,0.091338457
Des Moines-Ames,50312,15295,332,416,649,1397,0.091337038
Grand Rapids-Kalmzoo-B.Crk,49024,30678,903,872,1027,2802,0.091335811
Cleveland-Akron (Canton),44704,3690,113,103,121,337,0.091327913
Shreveport,71101,6110,138,194,226,558,0.091325696
Burlington-Plattsburgh,5826,876,27,34,19,80,0.091324201
Ft. Smith-Fay-Sprngdl-Rgrs,72747,219,7,7,6,20,0.091324201
Hartford & New Haven,6066,30135,668,888,1196,2752,0.091322383
Sherman-Ada,73459,1555,45,42,55,142,0.091318328
Lubbock,79363,6702,257,208,147,612,0.091316025
Hartford & New Haven,6450,36051,1068,1042,1182,3292,0.091315081
Davenport-R.Island-Moline,61282,7622,240,214,242,696,0.091314616
Dayton,45439,11893,312,345,429,1086,0.091314218
"Charleston, SC",29486,49796,1713,1428,1406,4547,0.091312555
Philadelphia,8234,47650,1543,1470,1338,4351,0.091311647
Shreveport,74736,1139,37,27,40,104,0.091308165
Shreveport,75487,1369,48,41,36,125,0.091307524
Las Vegas,89149,44773,1284,1314,1490,4088,0.091305028
Salt Lake City,84647,5312,222,145,118,485,0.091302711
Baltimore,21607,471,14,15,14,43,0.091295117
Erie,16510,24558,788,795,659,2242,0.091294079
Kansas City,64029,20977,789,609,517,1915,0.091290461
Baton Rouge,70342,4535,164,120,130,414,0.091289967
Green Bay-Appleton,54304,28503,786,898,918,2602,0.091288636
Salt Lake City,84739,482,17,16,11,44,0.091286307
Miami-Ft. Lauderdale,33177,57687,1724,1839,1703,5266,0.091285732
Topeka,66411,1216,48,34,29,111,0.091282895
Boston (Manchester),1531,975,30,28,31,89,0.091282051
"Washington, DC (Hagrstwn)",22305,16904,421,483,639,1543,0.09128017
Bangor,4654,3451,122,109,84,315,0.09127789
Cleveland-Akron (Canton),44907,15305,393,509,495,1397,0.09127736
Houston,77539,59544,1914,1716,1805,5435,0.091277039
New York,11377,84819,2048,2502,3192,7742,0.091276719
New York,10280,6431,108,177,302,587,0.091276629
New York,11520,44798,1329,1385,1375,4089,0.091276396
"Albany, GA",31716,2487,88,69,70,227,0.091274628
Sacramnto-Stkton-Modesto,95821,39508,1127,1101,1378,3606,0.091272654
Missoula,59864,8031,277,233,223,733,0.091271324
Birmingham (Ann and Tusc),35150,17618,532,546,530,1608,0.091270292
Cleveland-Akron (Canton),44720,40276,1283,1338,1055,3676,0.091270235
Ft. Wayne,46818,26208,855,768,769,2392,0.091269841
Butte-Bozeman,59714,24773,760,684,817,2261,0.09126872
Grand Rapids-Kalmzoo-B.Crk,49330,5577,205,163,141,509,0.091267707
Kansas City,64082,19306,789,597,376,1762,0.091266964
Kansas City,64152,32466,1224,999,740,2963,0.091264708
Wilkes Barre-Scranton-Hztn,17976,6399,199,202,183,584,0.09126426
Las Vegas,89139,49824,1509,1351,1687,4547,0.09126124
Topeka,66609,7758,256,260,192,708,0.091260634
Evansville,42303,42494,1301,1317,1260,3878,0.091259943
Harrisburg-Lncstr-Leb-York,17036,25170,791,715,791,2297,0.091259436
Biloxi-Gulfport,39560,18771,627,530,556,1713,0.091257791
Minneapolis-St. Paul,55376,19648,818,575,400,1793,0.091256107
Baton Rouge,70715,1052,29,36,31,96,0.091254753
Hattiesburg-Laurel,39332,1589,56,44,45,145,0.09125236
Salt Lake City,84654,2674,103,70,71,244,0.091249065
Montgomery-Selma,36722,537,15,14,20,49,0.091247672
Grand Rapids-Kalmzoo-B.Crk,49057,6181,202,191,171,564,0.091247371
Shreveport,71107,30916,1042,903,876,2821,0.091247251
Albuquerque-Santa Fe,87123,45011,1255,1425,1427,4107,0.091244362
Minneapolis-St. Paul,55428,31291,896,978,981,2855,0.091240293
Chicago,60169,32980,910,985,1114,3009,0.091237113
Wichita-Hutchinson Plus,67950,1951,69,56,53,178,0.091235264
Toledo,44830,18425,540,582,559,1681,0.091234735
Sacramnto-Stkton-Modesto,95389,559,12,16,23,51,0.091234347
Louisville,40202,6818,90,238,294,622,0.091229099
Nashville,38478,18766,606,598,508,1712,0.091228818
Dothan,36034,285,10,9,7,26,0.09122807
Seattle-Tacoma,98526,285,12,7,7,26,0.09122807
West Palm Beach-Ft. Pierce,34953,88889,2970,2631,2508,8109,0.091226136
Sacramnto-Stkton-Modesto,95336,48243,1551,1527,1323,4401,0.09122567
"Washington, DC (Hagrstwn)",20176,54406,2063,1619,1281,4963,0.091221556
Houston,77665,6994,237,227,174,638,0.091221047
Terre Haute,47562,5635,200,151,163,514,0.091215617
Indianapolis,47274,33561,1068,995,998,3061,0.091207056
Dallas-Ft. Worth,76092,31415,1397,990,478,2865,0.091198472
Corpus Christi,78407,1590,55,49,41,145,0.091194969
Savannah,30425,1294,46,41,31,118,0.091190108
Birmingham (Ann and Tusc),35055,22974,684,745,666,2095,0.091190041
Charlotte,28052,35662,1139,1019,1094,3252,0.091189501
Ft. Smith-Fay-Sprngdl-Rgrs,72736,8137,272,246,224,742,0.091188399
Sioux City,51018,340,11,9,11,31,0.091176471
Sherman-Ada,74534,340,11,12,8,31,0.091176471
Terre Haute,47805,12602,418,392,339,1149,0.091176004
Paducah-Cape Girard-Harsbg,38230,3422,108,105,99,312,0.091174752
Denver,80014,42940,896,1345,1674,3915,0.091173731
Seattle-Tacoma,98372,27859,675,779,1086,2540,0.091173409
Birmingham (Ann and Tusc),36758,1393,48,44,35,127,0.091170136
Sacramnto-Stkton-Modesto,95313,1393,52,42,33,127,0.091170136
Greenvll-Spart-Ashevll-And,29307,21445,570,641,744,1955,0.091163441
Memphis,38670,724,19,23,24,66,0.091160221
Baton Rouge,70756,362,10,10,13,33,0.091160221
Chicago,60031,37659,1174,1150,1109,3433,0.091160148
Johnstown-Altoona-St Colge,16820,1097,36,32,32,100,0.091157703
Tampa-St. Pete (Sarasota),33705,28457,691,888,1015,2594,0.091155076
"Columbia, SC",29045,28227,1005,829,739,2573,0.09115386
Dallas-Ft. Worth,75105,373,15,11,8,34,0.091152815
Los Angeles,91390,20132,658,660,517,1835,0.09114842
Atlanta,30655,31027,993,924,911,2828,0.091146421
Tampa-St. Pete (Sarasota),33611,35559,652,1169,1420,3241,0.091144295
Davenport-R.Island-Moline,61265,42595,1220,1302,1360,3882,0.091137457
Chicago,60564,46414,1883,1424,923,4230,0.091136295
Corpus Christi,78380,23482,825,723,592,2140,0.091133634
Lansing,49250,5695,217,177,125,519,0.091132572
Little Rock-Pine Bluff,72110,11577,362,374,319,1055,0.091128963
Dothan,36301,40580,1243,1266,1189,3698,0.091128635
"Portland, OR",97225,27456,602,781,1119,2502,0.091127622
Santabarbra-Sanmar-Sanluob,93436,56712,1803,1726,1639,5168,0.091127098
"Portland, OR",97086,35456,1122,997,1112,3231,0.091127031
Ft. Smith-Fay-Sprngdl-Rgrs,72936,14475,497,454,368,1319,0.091122625
Omaha,51548,428,18,13,8,39,0.091121495
Davenport-R.Island-Moline,61239,900,32,26,24,82,0.091111111
Detroit,48229,9143,298,271,264,833,0.091107951
Beaumont-Port Arthur,77640,17047,512,528,513,1553,0.091101074
Denver,80222,22185,397,597,1027,2021,0.091097588
Wichita-Hutchinson Plus,67031,1954,66,54,58,178,0.091095189
Chico-Redding,96002,34844,1055,1031,1088,3174,0.091091723
"Lafayette, LA",70533,7048,255,217,170,642,0.091089671
"Washington, DC (Hagrstwn)",20769,7070,226,215,203,644,0.091089109
Johnstown-Altoona-St Colge,16882,516,17,15,15,47,0.091085271
Jacksonville,31542,2580,94,84,57,235,0.091085271
Seattle-Tacoma,98168,37526,1044,1125,1249,3418,0.091083515
Toledo,43614,29174,699,780,1178,2657,0.091074244
Cincinnati,45011,75489,2562,2318,1995,6875,0.091072872
Champaign&Sprngfld-Decatur,62510,1713,54,58,44,156,0.091068301
Baton Rouge,70719,4678,167,147,112,426,0.091064558
Dallas-Ft. Worth,75756,4129,148,114,114,376,0.091063211
Paducah-Cape Girard-Harsbg,42028,593,24,16,14,54,0.091062395
Houston,77546,56479,1983,1721,1439,5143,0.091060394
Philadelphia,8030,13870,441,395,427,1263,0.091059841
Oklahoma City,73130,22360,759,661,616,2036,0.091055456
Shreveport,75954,3163,109,94,85,288,0.091052798
Detroit,48239,36453,1123,1068,1128,3319,0.091048748
Birmingham (Ann and Tusc),35127,9325,292,296,261,849,0.091045576
Montgomery-Selma,36110,11369,349,340,346,1035,0.091037031
Norfolk-Portsmth-Newpt Nws,23518,29889,681,825,1215,2721,0.091036836
Philadelphia,8052,20135,471,596,766,1833,0.09103551
"Jackson, MS",39073,20917,748,613,543,1904,0.091026438
Los Angeles,90212,12020,302,329,463,1094,0.091014975
Miami-Ft. Lauderdale,33326,34632,1298,1056,798,3152,0.091014091
Little Rock-Pine Bluff,71639,5230,184,149,143,476,0.091013384
Bluefield-Beckley-Oak Hill,25880,6329,198,193,185,576,0.091009638
Chicago,60585,26372,1182,747,471,2400,0.091005612
San Francisco-Oak-San Jose,94931,9066,222,271,332,825,0.090999338
Des Moines-Ames,50533,4033,149,97,121,367,0.090999256
Cleveland-Akron (Canton),44837,4209,144,119,120,383,0.090995486
Houston,77493,79600,2752,2249,2242,7243,0.090992462
Fairbanks,99705,21826,651,605,730,1986,0.090992394
Los Angeles,90720,23057,776,720,602,2098,0.09099189
South Bend-Elkhart,49031,7803,244,280,186,710,0.090990645
St. Louis,63084,19300,628,574,554,1756,0.090984456
Cedar Rapids-Wtrlo-IWC&Dub,50158,31215,1060,944,836,2840,0.0909819
Lubbock,79316,10464,343,324,285,952,0.090978593
Huntsville-Decatur (Flor),35750,15279,499,429,462,1390,0.09097454
Detroit,48036,22314,573,692,765,2030,0.090974276
New Orleans,70094,30031,918,922,892,2732,0.090972662
Cincinnati,45103,37518,1115,1076,1222,3413,0.090969668
Sacramnto-Stkton-Modesto,95695,38090,1152,1146,1167,3465,0.090968758
Denver,81125,3089,110,97,74,281,0.090967951
Chicago,60112,4672,144,141,140,425,0.090967466
Chicago,60803,21098,620,620,679,1919,0.090956489
Birmingham (Ann and Tusc),35160,25210,927,739,627,2293,0.09095597
Indianapolis,46048,2089,71,64,55,190,0.090952609
Orlando-Daytona Bch-Melbrn,34773,4651,179,144,100,423,0.090948183
El Paso (Las Cruces),79922,7994,297,233,197,727,0.090943207
La Crosse-Eau Claire,54460,2760,96,70,85,251,0.090942029
Biloxi-Gulfport,39553,17242,540,516,512,1568,0.090940726
Sioux City,51108,6246,210,187,171,568,0.0909382
Hartford & New Haven,6354,6664,193,186,227,606,0.090936375
Green Bay-Appleton,54937,21543,582,649,728,1959,0.09093441
Pittsburgh,15205,22940,509,631,946,2086,0.090932868
Flint-Saginaw-Bay City,48505,17046,526,477,547,1550,0.090930424
Cedar Rapids-Wtrlo-IWC&Dub,52405,26054,677,742,950,2369,0.090926537
Tampa-St. Pete (Sarasota),33838,6379,211,198,171,580,0.090923342
Cleveland-Akron (Canton),44081,7061,246,234,162,642,0.090921966
Albany-Schenectady-Troy,1224,99,3,3,3,9,0.090909091
Burlington-Plattsburgh,5441,209,7,5,7,19,0.090909091
New York,7608,77,2,2,3,7,0.090909091
Philadelphia,8041,946,35,26,25,86,0.090909091
Watertown,13680,1056,36,27,33,96,0.090909091
Youngstown,16145,2486,96,77,53,226,0.090909091
Johnstown-Altoona-St Colge,16871,33,1,1,1,3,0.090909091
Harrisburg-Lncstr-Leb-York,17076,66,2,2,2,6,0.090909091
Chattanooga,35979,1155,39,34,32,105,0.090909091
Charleston-Huntington,41655,748,29,15,24,68,0.090909091
Ft. Wayne,46765,6072,243,178,131,552,0.090909091
Indianapolis,47392,33,1,1,1,3,0.090909091
Evansville,47616,330,11,9,10,30,0.090909091
Des Moines-Ames,50057,220,11,6,3,20,0.090909091
Ottumwa-Kirksville,52580,385,14,12,9,35,0.090909091
Madison,53543,1650,65,44,41,150,0.090909091
Green Bay-Appleton,54978,22,1,1,0,2,0.090909091
Minneapolis-St. Paul,55450,44,1,2,1,4,0.090909091
Sioux Falls(Mitchell),57052,429,15,13,11,39,0.090909091
Sioux Falls(Mitchell),57379,88,4,2,2,8,0.090909091
Bismarck-Mnt-Dcknsn(Wlstn),57657,99,4,3,2,9,0.090909091
Great Falls,59542,341,10,11,10,31,0.090909091
Chicago,60146,2321,73,80,58,211,0.090909091
Peoria-Bloomington,61724,561,22,15,14,51,0.090909091
Kansas City,64426,341,13,12,6,31,0.090909091
Topeka,66552,363,15,10,8,33,0.090909091
Lincoln & Hastings-Krny,68974,165,6,3,6,15,0.090909091
Little Rock-Pine Bluff,71662,110,4,3,3,10,0.090909091
Ft. Smith-Fay-Sprngdl-Rgrs,72905,33,1,1,1,3,0.090909091
Dallas-Ft. Worth,75435,1056,36,32,28,96,0.090909091
San Antonio,78870,847,31,27,19,77,0.090909091
Colorado Springs-Pueblo,80939,748,27,20,21,68,0.090909091
Idaho Fals-Pocatllo(Jcksn),83431,902,34,24,24,82,0.090909091
Salt Lake City,84529,22,1,1,0,2,0.090909091
Salt Lake City,84713,4576,192,134,90,416,0.090909091
Portland-Auburn,4103,31605,642,952,1279,2873,0.090903338
Peoria-Bloomington,61614,25919,574,825,957,2356,0.090898569
Detroit,48203,22102,568,737,704,2009,0.090896751
Baltimore,21237,31982,807,948,1152,2907,0.090894878
Grand Rapids-Kalmzoo-B.Crk,49451,5941,197,191,152,540,0.090893789
Savannah,31329,11255,398,313,312,1023,0.090892936
Toledo,45856,5160,161,171,137,469,0.090891473
Seattle-Tacoma,98812,5061,213,127,120,460,0.090891128
Philadelphia,18103,48432,1375,1456,1571,4402,0.09089032
Cleveland-Akron (Canton),44676,4742,156,132,143,431,0.09088992
West Palm Beach-Ft. Pierce,33462,34042,964,1094,1036,3094,0.090887727
Fresno-Visalia,95324,7152,242,222,186,650,0.090883669
Chattanooga,37321,20676,678,604,597,1879,0.090878313
"Portland, OR",97216,16583,380,554,573,1507,0.090876199
Omaha,51503,37558,1370,1103,940,3413,0.090872783
Knoxville,37813,19093,625,572,538,1735,0.090871
Gainesville,32641,13448,450,419,353,1222,0.090868531
Pittsburgh,15045,4468,121,143,142,406,0.090868397
Minneapolis-St. Paul,55423,38255,882,1080,1514,3476,0.090863939
Phoenix (Prescott),85355,16608,612,483,414,1509,0.090859827
Memphis,72472,9102,296,253,278,827,0.090859152
Birmingham (Ann and Tusc),35980,5360,160,159,168,487,0.090858209
Salt Lake City,83110,5305,202,148,132,482,0.090857681
Minneapolis-St. Paul,56093,12283,372,349,395,1116,0.090857282
Dallas-Ft. Worth,76641,1750,58,54,47,159,0.090857143
Memphis,38109,41439,1306,1234,1225,3765,0.09085644
"Portland, OR",97070,27605,708,816,984,2508,0.090853106
Erie,16508,14551,371,456,495,1322,0.090852862
Houston,77573,97642,3455,2861,2555,8871,0.090852297
Nashville,37188,19857,664,583,557,1804,0.090849574
Sacramnto-Stkton-Modesto,95236,4381,145,138,115,398,0.090846839
Houston,77485,4370,165,114,118,397,0.090846682
Beaumont-Port Arthur,75966,4183,151,124,105,380,0.090843892
Raleigh-Durham (Fayetvlle),28376,45838,1469,1294,1401,4164,0.09084166
Waco-Temple-Bryan,76567,9203,298,267,271,836,0.090839943
Las Vegas,89113,40977,904,1189,1629,3722,0.090831442
"Columbus, OH",43777,4503,154,124,131,409,0.090828337
Nashville,37083,16680,523,500,492,1515,0.090827338
Abilene-Sweetwater,79526,1112,47,34,20,101,0.090827338
Denver,81140,2224,79,68,55,202,0.090827338
Birmingham (Ann and Tusc),36206,10780,306,309,364,979,0.090816327
Salt Lake City,82933,1949,84,57,36,177,0.090815803
Fargo,56721,10527,349,321,286,956,0.090814097
"Columbus, OH",43214,27397,440,822,1226,2488,0.090812863
Raleigh-Durham (Fayetvlle),27587,89393,3445,2671,2002,8118,0.09081248
Amarillo,79081,3568,135,117,72,324,0.090807175
"Columbus, OH",43035,34700,1451,928,772,3151,0.090806916
Oklahoma City,73742,4383,159,131,108,398,0.090805384
Wausau-Rhinelander,54495,7775,248,215,243,706,0.090803859
Des Moines-Ames,50501,27929,907,888,741,2536,0.090801676
Shreveport,71411,2478,91,69,65,225,0.090799031
Baton Rouge,39631,3238,120,97,77,294,0.090796788
Pittsburgh,15204,8051,251,247,233,731,0.090796174
Nashville,42240,41192,1220,1217,1303,3740,0.090794329
Miami-Ft. Lauderdale,33055,42077,1217,1303,1300,3820,0.09078594
Sioux City,51022,727,31,21,14,66,0.090784044
Sacramnto-Stkton-Modesto,95988,8625,298,253,232,783,0.090782609
Champaign&Sprngfld-Decatur,62563,5739,240,176,105,521,0.090782366
"Columbus, OH",43116,1410,61,39,28,128,0.090780142
Tucson (Sierra Vista),85747,32596,1230,948,781,2959,0.09077801
"Washington, DC (Hagrstwn)",20748,40022,1048,1161,1424,3633,0.090775074
Boston (Manchester),1524,6654,198,250,156,604,0.090772468
Sherman-Ada,73461,661,20,19,21,60,0.090771558
Columbus-Tupelo-West Point,38838,1311,42,39,38,119,0.090770404
"Portland, OR",97007,50526,1619,1538,1429,4586,0.090765151
Hartford & New Haven,6401,18829,500,633,576,1709,0.090764247
Atlanta,30220,5509,168,170,162,500,0.090760574
Greenvll-Spart-Ashevll-And,29341,20053,626,612,582,1820,0.090759487
Tulsa,74054,584,21,19,13,53,0.090753425
"Albany, GA",31750,17939,596,560,472,1628,0.090751993
Sacramnto-Stkton-Modesto,95835,43901,1492,1228,1264,3984,0.090749641
Houston,77407,96353,3358,2611,2775,8744,0.090749639
"Jackson, MS",39114,9003,302,261,254,817,0.090747529
Louisville,40175,15604,553,480,383,1416,0.090745963
Chicago,60444,1664,50,44,57,151,0.090745192
Tampa-St. Pete (Sarasota),33803,28520,688,841,1059,2588,0.090743338
Miami-Ft. Lauderdale,33172,41956,985,1362,1460,3807,0.090737916
Ft. Wayne,46731,529,21,15,12,48,0.09073724
Birmingham (Ann and Tusc),35148,2568,74,80,79,233,0.090732087
Houston,77444,1025,34,31,28,93,0.090731707
La Crosse-Eau Claire,54425,2028,65,63,56,184,0.090729783
Seattle-Tacoma,98418,10107,253,293,371,917,0.090729198
Raleigh-Durham (Fayetvlle),28344,3516,133,102,84,319,0.0907281
St. Louis,63116,41048,945,1224,1555,3724,0.090723056
Evansville,42321,485,18,14,12,44,0.090721649
Miami-Ft. Lauderdale,33029,46913,1672,1402,1182,4256,0.090721122
La Crosse-Eau Claire,54720,9105,271,262,293,826,0.090719385
Boston (Manchester),3823,1907,73,58,42,173,0.090718406
Mobile-Pensacola (Ft Walt),36578,1896,71,55,46,172,0.0907173
Oklahoma City,73644,14121,473,392,416,1281,0.090715955
Phoenix (Prescott),85354,7783,268,234,204,706,0.090710523
Atlanta,30153,20119,632,586,607,1825,0.090710274
Joplin-Pittsburg,66739,5027,184,153,119,456,0.090710165
Detroit,48186,33635,922,959,1170,3051,0.090709083
Harrisburg-Lncstr-Leb-York,17579,6813,221,207,190,618,0.090708939
Memphis,38012,13560,445,425,360,1230,0.090707965
Augusta-Aiken,30824,17143,555,510,490,1555,0.090707577
Birmingham (Ann and Tusc),36006,1334,43,46,32,121,0.090704648
"Columbus, GA (Opelika, AL)",36027,15093,486,467,416,1369,0.0907043
Odessa-Midland,79745,6604,256,170,173,599,0.090702604
Memphis,38011,9471,322,282,255,859,0.09069792
San Francisco-Oak-San Jose,94110,63388,963,1700,3086,5749,0.0906954
Yakima-Pasco-Rchlnd-Knnwck,99348,1698,60,49,45,154,0.090694935
Detroit,48035,33442,884,959,1190,3033,0.090694336
Johnstown-Altoona-St Colge,16652,17246,577,628,359,1564,0.090687696
Birmingham (Ann and Tusc),35473,18361,492,510,663,1665,0.090681335
La Crosse-Eau Claire,54446,2691,90,81,73,244,0.090672612
Oklahoma City,73170,41777,1308,1289,1191,3788,0.090671901
Eureka,95562,3441,107,103,102,312,0.090671316
Cheyenne-Scottsbluff,69341,11018,353,333,313,999,0.090669813
Flint-Saginaw-Bay City,48506,24672,724,747,766,2237,0.090669585
Greensboro-H.Point-W.Salem,27215,48870,1350,1518,1563,4431,0.090669122
Los Angeles,91710,80977,2320,2522,2500,7342,0.09066772
Chattanooga,37411,17636,484,519,596,1599,0.090666818
Greenwood-Greenville,38952,375,11,10,13,34,0.090666667
New York,8869,8504,216,243,312,771,0.090663217
Grand Rapids-Kalmzoo-B.Crk,49404,9232,326,265,246,837,0.090662912
Detroit,48071,28138,579,791,1181,2551,0.090660317
Bakersfield,93314,41904,1604,1145,1050,3799,0.090659603
Kansas City,64640,3265,111,88,97,296,0.090658499
Los Angeles,92618,66020,1772,1900,2313,5985,0.090654347
New York,7621,28350,891,828,851,2570,0.090652557
Grand Rapids-Kalmzoo-B.Crk,49303,1059,40,27,29,96,0.090651558
Jacksonville,32073,44093,1285,1307,1405,3997,0.090649309
Dallas-Ft. Worth,75063,51010,1403,1413,1808,4624,0.090648892
Sioux City,51334,6972,242,207,183,632,0.090648308
Rockford,61107,30249,854,974,914,2742,0.090647625
"Columbus, OH",45780,3464,69,99,146,314,0.090646651
St. Louis,62226,28021,776,891,873,2540,0.090646301
Myrtle Beach-Florence,28343,1346,49,35,38,122,0.09063893
Los Angeles,91345,18028,509,552,573,1634,0.090636787
Greenville-N.Bern-Washngtn,28525,3321,97,108,96,301,0.090635351
Wichita Falls & Lawton,73546,993,40,28,22,90,0.090634441
Nashville,37075,75150,2442,2206,2163,6811,0.090632069
"Lafayette, LA",70510,23888,761,739,665,2165,0.090631279
Ft. Wayne,45821,1302,48,39,31,118,0.0906298
Peoria-Bloomington,61491,1953,61,59,57,177,0.0906298
Albuquerque-Santa Fe,87113,16287,532,500,444,1476,0.090624424
Baltimore,21229,42075,1158,1251,1404,3813,0.090623886
"Columbia, SC",29001,1909,70,51,52,173,0.090623363
Los Angeles,90814,17700,295,486,823,1604,0.090621469
Oklahoma City,73801,15063,498,446,421,1365,0.090619399
Beaumont-Port Arthur,77651,13419,440,380,396,1216,0.090617781
"Springfield, MO",72740,10594,358,322,280,960,0.090617331
"Columbia, SC",29154,29598,890,852,940,2682,0.090614231
Pittsburgh,15140,3079,99,96,84,279,0.090613836
"Columbus, OH",43160,22404,732,644,654,2030,0.09060882
South Bend-Elkhart,46628,26532,872,783,749,2404,0.090607568
Chicago,60456,4481,111,140,155,406,0.090604776
Orlando-Daytona Bch-Melbrn,32707,38321,946,1198,1328,3472,0.090603064
Huntsville-Decatur (Flor),35660,9790,257,273,357,887,0.090602656
Los Angeles,90620,47064,1276,1435,1553,4264,0.090600034
Oklahoma City,73179,8290,250,247,254,751,0.090591074
Milwaukee,53223,29706,917,821,953,2691,0.09058776
Toledo,43413,1402,50,40,37,127,0.090584879
Ottumwa-Kirksville,52501,30172,999,866,868,2733,0.090580671
Houston,77024,38928,1253,1231,1042,3526,0.090577476
Lexington,41360,541,18,17,14,49,0.090573013
South Bend-Elkhart,46501,3787,134,107,102,343,0.090573013
Cleveland-Akron (Canton),44890,10964,359,320,314,993,0.090569135
Birmingham (Ann and Tusc),36744,6404,172,189,219,580,0.090568395
Oklahoma City,73036,20617,703,614,550,1867,0.090556337
Minneapolis-St. Paul,54028,2805,101,85,68,254,0.090552585
Tulsa,74105,27012,607,833,1006,2446,0.090552347
Tallahassee-Thomasville,39817,11640,366,350,338,1054,0.090549828
"Springfield, MO",65764,1513,55,48,34,137,0.090548579
Flint-Saginaw-Bay City,48617,8990,298,265,251,814,0.09054505
Birmingham (Ann and Tusc),35906,10448,308,326,312,946,0.090543645
Odessa-Midland,79713,497,19,14,12,45,0.09054326
Baltimore,21005,1734,56,52,49,157,0.090542099
Colorado Springs-Pueblo,81039,1977,66,63,50,179,0.090541224
Lincoln & Hastings-Krny,68405,3457,120,110,83,313,0.090540931
Spokane,99208,61002,1836,1834,1853,5523,0.090538015
Miami-Ft. Lauderdale,33024,74146,2265,2229,2219,6713,0.090537588
Macon,31211,16104,490,482,486,1458,0.090536513
Birmingham (Ann and Tusc),35049,4142,137,127,111,375,0.090535973
Sioux City,51247,5346,198,149,137,484,0.090534979
Columbus-Tupelo-West Point,38804,17441,511,540,528,1579,0.0905338
Atlanta,30629,5545,178,162,162,502,0.090532011
South Bend-Elkhart,46580,22401,680,655,693,2028,0.090531673
Dayton,45426,14625,421,467,436,1324,0.090529915
Louisville,40213,16990,443,505,590,1538,0.090523838
Columbia-Jefferson City,65034,707,28,20,16,64,0.090523338
Rochestr-Mason City-Austin,55902,27673,760,755,990,2505,0.090521447
Lubbock,79549,15190,540,431,404,1375,0.090520079
Norfolk-Portsmth-Newpt Nws,23601,25376,621,784,892,2297,0.0905186
Bluefield-Beckley-Oak Hill,25008,232,10,6,5,21,0.090517241
Cincinnati,45671,232,8,7,6,21,0.090517241
Dallas-Ft. Worth,75471,1348,54,35,33,122,0.090504451
Minneapolis-St. Paul,55024,39722,1509,1163,923,3595,0.090504003
Lexington,40701,31745,980,963,930,2873,0.090502441
"Washington, DC (Hagrstwn)",21740,67888,2068,2042,2034,6144,0.090502003
Salt Lake City,84329,221,7,8,5,20,0.090497738
Seattle-Tacoma,98850,1989,72,61,47,180,0.090497738
Richmond-Petersburg,23231,38377,1091,1136,1246,3473,0.090496912
Baltimore,21136,35328,1128,1062,1007,3197,0.090494792
San Francisco-Oak-San Jose,94520,39186,1078,1122,1346,3546,0.090491502
Charlotte,29718,4089,128,126,116,370,0.090486672
Austin,78942,9427,331,257,265,853,0.090484778
Albuquerque-Santa Fe,87110,39820,960,1179,1464,3603,0.09048217
Houston,77385,32870,1127,903,944,2974,0.090477639
Minneapolis-St. Paul,55418,32275,657,968,1295,2920,0.090472502
Memphis,72432,5969,185,171,184,540,0.090467415
Tampa-St. Pete (Sarasota),33598,33483,1134,966,929,3029,0.090463817
Rochestr-Mason City-Austin,55972,5273,184,135,158,477,0.090460838
New York,10983,5859,190,187,153,530,0.090459123
Louisville,47170,15123,416,439,513,1368,0.090458242
New Orleans,70072,56093,1782,1665,1627,5074,0.09045692
Montgomery-Selma,36701,20563,659,630,571,1860,0.090453728
Cincinnati,45213,11962,300,356,426,1082,0.090453101
Los Angeles,91302,24720,849,752,635,2236,0.090453074
Mobile-Pensacola (Ft Walt),32534,16738,420,466,628,1514,0.090452862
"Washington, DC (Hagrstwn)",20716,22277,626,645,744,2015,0.090452036
New York,6840,20675,838,662,370,1870,0.0904474
"Washington, DC (Hagrstwn)",20018,21516,432,634,880,1946,0.090444321
Billings,59106,22335,729,620,671,2020,0.090441012
Bluefield-Beckley-Oak Hill,24733,387,11,12,12,35,0.090439276
San Antonio,78016,10250,326,331,270,927,0.090439024
Dayton,45306,2311,82,64,63,209,0.09043704
Albuquerque-Santa Fe,88030,25666,916,743,662,2321,0.09043092
Lansing,49203,37388,1208,1077,1096,3381,0.090430085
Flint-Saginaw-Bay City,48731,1515,53,45,39,137,0.090429043
Orlando-Daytona Bch-Melbrn,32820,10395,328,297,315,940,0.09042809
Jacksonville,31553,5198,156,158,156,470,0.090419392
Grand Rapids-Kalmzoo-B.Crk,49327,8715,311,256,221,788,0.090418818
Chattanooga,37303,26455,773,826,793,2392,0.09041769
Sacramnto-Stkton-Modesto,95932,8107,290,245,198,733,0.09041569
New York,11560,6858,235,225,160,620,0.090405366
Paducah-Cape Girard-Harsbg,63780,6604,229,171,197,597,0.090399758
Baltimore,21636,1062,30,32,34,96,0.09039548
Minneapolis-St. Paul,55387,15765,600,480,345,1425,0.090390105
Seattle-Tacoma,98055,23111,521,638,930,2089,0.090389858
Columbia-Jefferson City,65018,8032,278,232,216,726,0.090388446
Sioux City,57010,520,15,12,20,47,0.090384615
Atlanta,30529,13144,397,385,406,1188,0.090383445
Grand Rapids-Kalmzoo-B.Crk,49015,27096,851,859,739,2449,0.090382344
Bluefield-Beckley-Oak Hill,25862,343,11,12,8,31,0.090379009
"Washington, DC (Hagrstwn)",22150,27418,752,838,888,2478,0.090378583
New York,11788,16088,444,538,472,1454,0.090377921
Anchorage,99654,43031,1484,1233,1172,3889,0.090376705
Dayton,45440,23613,658,714,762,2134,0.090373947
Cincinnati,41016,5942,173,166,198,537,0.090373612
Kansas City,64076,9826,336,259,293,888,0.090372481
Phoenix (Prescott),86047,16753,589,481,444,1514,0.090371874
"Rochester, NY",14610,14031,238,375,655,1268,0.090371321
Shreveport,71027,2025,75,56,52,183,0.09037037
Greenvll-Spart-Ashevll-And,30520,4548,148,134,129,411,0.090369393
"Albany, GA",31791,11442,357,344,333,1034,0.090368817
Des Moines-Ames,50228,2523,97,79,52,228,0.090368609
Columbus-Tupelo-West Point,38652,16942,554,509,468,1531,0.090367135
"Portland, OR",97396,3497,112,100,104,316,0.090363168
Houston,77515,33941,1143,987,937,3067,0.090362688
Charlotte,28034,20573,666,590,603,1859,0.090361153
San Antonio,78205,2313,23,74,112,209,0.090358841
Clarksburg-Weston,26241,13867,408,483,362,1253,0.090358405
Indianapolis,46051,2800,85,85,83,253,0.090357143
Evansville,42437,6685,236,191,177,604,0.090351533
Chicago,60540,43542,1440,1537,957,3934,0.090349548
Raleigh-Durham (Fayetvlle),27539,29188,1112,895,630,2637,0.090345347
St. Louis,63389,7571,252,207,225,684,0.090344736
"Columbus, GA (Opelika, AL)",31816,4981,156,147,147,450,0.090343305
San Francisco-Oak-San Jose,94040,37734,911,1112,1386,3409,0.090342927
Charleston-Huntington,25035,963,21,39,27,87,0.090342679
Los Angeles,92308,41564,1348,1273,1134,3755,0.090342604
"Washington, DC (Hagrstwn)",20912,23489,704,717,701,2122,0.090340159
Baltimore,21133,30895,927,944,920,2791,0.090338242
Albany-Schenectady-Troy,12084,4616,107,131,179,417,0.090337955
Wilkes Barre-Scranton-Hztn,18706,16704,489,505,515,1509,0.090337644
Shreveport,75974,3022,101,92,80,273,0.090337525
Chicago,60449,9055,301,277,240,818,0.09033683
Atlanta,30183,6974,256,250,124,630,0.090335532
Fairbanks,99709,28373,750,873,940,2563,0.090332358
Green Bay-Appleton,54902,22063,571,658,764,1993,0.09033223
Chattanooga,37332,2834,101,80,75,256,0.090331687
Tulsa,74401,15410,471,465,456,1392,0.090330954
Paducah-Cape Girard-Harsbg,63845,5026,162,150,142,454,0.090330283
Joplin-Pittsburg,66770,941,42,23,20,85,0.090329437
Minneapolis-St. Paul,56068,1096,35,32,32,99,0.090328467
Cleveland-Akron (Canton),44119,11259,331,355,331,1017,0.090327738
Tulsa,74130,2026,67,63,53,183,0.090325765
Kansas City,64130,21445,669,634,634,1937,0.090324085
Cincinnati,45385,40300,1313,1238,1089,3640,0.090322581
Chico-Redding,95965,20903,637,628,623,1888,0.090321963
"Washington, DC (Hagrstwn)",20171,54496,1486,1574,1862,4922,0.090318555
Seattle-Tacoma,98233,16774,484,501,530,1515,0.09031835
Indianapolis,46031,2148,67,79,48,194,0.090316574
El Paso (Las Cruces),79911,9201,329,259,243,831,0.09031627
Tampa-St. Pete (Sarasota),33839,4440,143,123,135,401,0.090315315
"Springfield, MO",65810,22499,653,729,650,2032,0.090315125
"Washington, DC (Hagrstwn)",21742,33760,1008,1023,1018,3049,0.090313981
Portland-Auburn,4106,27582,752,800,939,2491,0.090312523
Philadelphia,8332,35335,1120,1045,1026,3191,0.090307061
Erie,16423,3920,111,120,123,354,0.090306122
Cleveland-Akron (Canton),43824,3909,128,112,113,353,0.090304426
"Jackson, MS",39042,39655,1272,1186,1123,3581,0.090303871
Jacksonville,32068,58894,2044,1733,1541,5318,0.090297823
Spokane,99206,40755,1185,1206,1289,3680,0.090295669
Des Moines-Ames,50047,6368,251,157,167,575,0.090295226
Seattle-Tacoma,98374,52296,1691,1501,1530,4722,0.090293713
New York,7760,9303,359,288,193,840,0.090293454
Bluefield-Beckley-Oak Hill,24925,1163,41,37,27,105,0.090283749
Miami-Ft. Lauderdale,33179,48936,1378,1461,1579,4418,0.090281184
Atlanta,30564,4630,134,144,140,418,0.090280778
Las Vegas,89103,47552,1086,1510,1697,4293,0.090280114
Seattle-Tacoma,98466,29819,821,901,970,2692,0.090278011
Mobile-Pensacola (Ft Walt),39456,1296,44,34,39,117,0.090277778
Odessa-Midland,79755,288,10,9,7,26,0.090277778
Austin,78681,58558,2321,1705,1260,5286,0.090269476
Denver,80137,1562,50,46,45,141,0.090268886
Oklahoma City,74873,11455,414,324,296,1034,0.090266259
Birmingham (Ann and Tusc),35575,1130,39,33,30,102,0.090265487
Harrisburg-Lncstr-Leb-York,17344,3667,112,97,122,331,0.090264521
"Springfield, MO",72616,10547,347,298,307,952,0.090262634
Little Rock-Pine Bluff,71921,3357,133,102,68,303,0.09025916
Huntsville-Decatur (Flor),35671,2781,66,89,96,251,0.090255304
Austin,78610,53637,1878,1467,1496,4841,0.090254861
Myrtle Beach-Florence,29544,7501,248,220,209,677,0.090254633
San Francisco-Oak-San Jose,95138,18659,624,560,500,1684,0.090251353
Seattle-Tacoma,98208,61441,1819,1776,1950,5545,0.090249182
New York,12721,8012,241,218,264,723,0.090239641
Nashville,37218,14806,402,434,500,1336,0.090233689
Minneapolis-St. Paul,55337,48175,1277,1417,1653,4347,0.090233524
St. Louis,62095,10850,305,321,353,979,0.090230415
Philadelphia,8311,1740,56,49,52,157,0.090229885
Waco-Temple-Bryan,76501,17766,545,555,503,1603,0.090228526
Twin Falls,83328,6805,248,195,171,614,0.090227774
Philadelphia,8016,35046,1031,1046,1085,3162,0.090224277
Wichita Falls & Lawton,73456,1718,56,53,46,155,0.090221187
Orlando-Daytona Bch-Melbrn,32190,1186,56,30,21,107,0.090219224
Greenvll-Spart-Ashevll-And,29385,10009,329,278,296,903,0.090218803
South Bend-Elkhart,46532,1973,67,59,52,178,0.090217942
Detroit,48416,4589,157,139,118,414,0.090215733
"Portland, OR",98604,40305,1323,1229,1084,3636,0.090212132
Kansas City,66210,20086,396,582,834,1812,0.090212088
Indianapolis,46219,35950,1013,1031,1199,3243,0.090208623
Raleigh-Durham (Fayetvlle),27577,26860,881,805,737,2423,0.090208488
Seattle-Tacoma,98312,35374,832,1071,1288,3191,0.090207497
Toledo,45872,4146,112,129,133,374,0.090207429
New York,12771,14246,442,422,421,1285,0.090200758
Richmond-Petersburg,23032,255,9,8,6,23,0.090196078
Kansas City,64165,255,9,9,5,23,0.090196078
Jacksonville,32208,33738,1091,1021,931,3043,0.090195032
Lexington,40505,26346,739,804,833,2376,0.090184468
Indianapolis,46060,47559,1538,1354,1397,4289,0.09018272
Shreveport,71109,17421,514,548,509,1571,0.09017852
Biloxi-Gulfport,39567,10424,318,272,350,940,0.090176516
Spokane,98823,12954,456,378,334,1168,0.0901652
Shreveport,75633,13564,434,415,374,1223,0.090165143
Terre Haute,47847,976,33,24,31,88,0.090163934
Champaign&Sprngfld-Decatur,62628,854,27,27,23,77,0.090163934
Omaha,68138,13542,408,367,446,1221,0.090163934
"Washington, DC (Hagrstwn)",20743,41394,1198,1185,1349,3732,0.090157994
New York,11784,25012,704,724,827,2255,0.090156725
Kansas City,64086,23116,745,672,667,2084,0.090154006
"Portland, OR",97060,22018,697,630,658,1985,0.090153511
South Bend-Elkhart,46506,9983,320,311,269,900,0.090153261
Cincinnati,45231,41829,1317,1193,1261,3771,0.090152765
Kansas City,64668,1320,46,35,38,119,0.090151515
Cleveland-Akron (Canton),44021,6356,195,201,177,573,0.090151038
Cincinnati,45142,4437,136,134,130,400,0.090151003
Raleigh-Durham (Fayetvlle),27501,23251,769,679,648,2096,0.09014666
Champaign&Sprngfld-Decatur,62694,2973,98,82,88,268,0.090144635
Dallas-Ft. Worth,76033,28410,908,809,844,2561,0.090144315
Montgomery-Selma,36071,710,28,20,16,64,0.090140845
Raleigh-Durham (Fayetvlle),27893,36899,1163,1086,1077,3326,0.090137944
Chicago,61360,3173,92,102,92,286,0.090135518
Denver,81144,7278,252,223,181,656,0.090134652
Biloxi-Gulfport,39507,18073,488,563,578,1629,0.090134455
Mobile-Pensacola (Ft Walt),36693,18495,527,547,593,1667,0.090132468
Columbia-Jefferson City,65101,28902,958,859,788,2605,0.090132171
Tulsa,74037,25641,959,765,587,2311,0.09012909
Elmira (Corning),14839,699,26,22,15,63,0.090128755
"Washington, DC (Hagrstwn)",22303,16410,277,442,760,1479,0.090127971
Lake Charles,70668,6513,240,175,172,587,0.090127437
South Bend-Elkhart,46553,3828,133,107,105,345,0.090125392
Denver,80018,23534,827,640,654,2121,0.090124926
Ft. Myers-Naples,33907,26652,577,772,1053,2402,0.090124569
"Columbus, OH",43739,2197,78,66,54,198,0.090122895
Kansas City,64136,2197,74,52,72,198,0.090122895
Augusta-Aiken,30809,55946,2051,1652,1339,5042,0.090122618
Seattle-Tacoma,98467,16556,488,479,525,1492,0.090118386
Columbia-Jefferson City,65076,688,27,18,17,62,0.090116279
San Antonio,78239,30472,981,890,875,2746,0.090115516
Albuquerque-Santa Fe,86514,5726,181,185,150,516,0.090115264
Joplin-Pittsburg,64762,1487,57,40,37,134,0.090114324
Bismarck-Mnt-Dcknsn(Wlstn),58647,1254,21,35,57,113,0.090111643
Houston,77578,32671,1145,902,897,2944,0.090110496
St. Louis,63385,51903,2022,1502,1153,4677,0.090110398
Raleigh-Durham (Fayetvlle),28357,2841,97,83,76,256,0.090109117
Miami-Ft. Lauderdale,33142,53036,1611,1584,1584,4779,0.090108605
Raleigh-Durham (Fayetvlle),27524,14583,483,438,393,1314,0.090104917
Oklahoma City,73054,4961,166,143,138,447,0.090102802
Wilkes Barre-Scranton-Hztn,18651,9112,271,272,278,821,0.090100966
Shreveport,71067,3818,133,117,94,344,0.090099529
Kansas City,66012,9767,325,293,262,880,0.090099314
Montgomery-Selma,36769,2131,63,67,62,192,0.090098545
Kansas City,64075,11954,407,317,353,1077,0.090095366
"Charleston, SC",29492,23109,671,578,833,2082,0.090094768
Richmond-Petersburg,23075,10267,323,287,315,925,0.090094477
Wilkes Barre-Scranton-Hztn,17864,2453,80,73,68,221,0.090093763
New York,11231,36340,872,1097,1305,3274,0.090093561
Charlotte,28692,4229,94,157,130,381,0.09009222
Kansas City,63566,111,4,3,3,10,0.09009009
Grand Rapids-Kalmzoo-B.Crk,49013,5184,179,147,141,467,0.090084877
Spokane,99224,26476,654,710,1021,2385,0.090081583
Dallas-Ft. Worth,75215,18950,517,543,647,1707,0.090079156
Chicago,60074,36424,1023,1139,1119,3281,0.090077971
"Columbus, OH",43106,1521,56,47,34,137,0.090072321
Yakima-Pasco-Rchlnd-Knnwck,98903,17387,575,520,471,1566,0.090067292
Birmingham (Ann and Tusc),35570,10759,319,322,328,969,0.090064132
Detroit,48161,27281,792,809,856,2457,0.090062681
Memphis,38601,2143,74,64,55,193,0.090060663
New York,7064,3853,103,105,139,347,0.090059694
El Paso (Las Cruces),79903,15934,436,497,502,1435,0.090058993
Montgomery-Selma,36435,533,16,18,14,48,0.090056285
"Columbus, GA (Opelika, AL)",31805,2343,74,68,69,211,0.090055484
Detroit,48327,21232,464,623,825,1912,0.090052751
Dayton,45449,18989,450,538,722,1710,0.090052135
Shreveport,71251,8151,244,247,243,734,0.090050301
Wausau-Rhinelander,54476,19256,562,545,627,1734,0.090049855
Johnstown-Altoona-St Colge,16659,211,9,5,5,19,0.090047393
Houston,77575,17158,583,463,499,1545,0.09004546
Bismarck-Mnt-Dcknsn(Wlstn),59201,4520,171,123,113,407,0.090044248
Paducah-Cape Girard-Harsbg,62924,2510,71,75,80,226,0.090039841
Nashville,42120,2710,92,76,76,244,0.0900369
Chattanooga,30742,7397,188,223,255,666,0.090036501
Monroe-El Dorado,71232,5609,186,170,149,505,0.090033874
Wichita Falls & Lawton,73541,3843,136,112,98,346,0.090033828
Panama City,32444,19826,642,598,545,1785,0.09003329
San Francisco-Oak-San Jose,95121,37464,1104,1133,1136,3373,0.090033098
Baltimore,21738,3621,137,112,77,326,0.090030378
New Orleans,70065,50761,1534,1427,1609,4570,0.090029747
"Portland, OR",97303,41810,1273,1187,1304,3764,0.090026309
Raleigh-Durham (Fayetvlle),27571,9231,404,258,169,831,0.090022749
New York,11742,12408,330,365,422,1117,0.090022566
New Orleans,70051,1844,55,47,64,166,0.090021692
Syracuse,13402,1433,52,41,36,129,0.090020935
Peoria-Bloomington,61615,24150,711,699,764,2174,0.090020704
Ft. Smith-Fay-Sprngdl-Rgrs,74941,2244,86,62,54,202,0.090017825
Philadelphia,18901,29351,934,1066,642,2642,0.090013969
Lincoln & Hastings-Krny,68526,8499,300,231,234,765,0.090010589
Champaign&Sprngfld-Decatur,62629,15299,567,428,382,1377,0.090005883
Los Angeles,92373,34821,865,1035,1234,3134,0.090003159
Philadelphia,19050,29755,814,873,991,2678,0.09000168
Denver,80228,35433,786,1011,1392,3189,0.090000847
Houston,77571,39533,1281,1140,1137,3558,0.090000759
Baton Rouge,70810,42846,1153,1282,1421,3856,0.089996732
Norfolk-Portsmth-Newpt Nws,23323,44459,1548,1275,1178,4001,0.089993027
Minneapolis-St. Paul,56251,1089,28,33,37,98,0.089990817
Baton Rouge,70729,889,36,21,23,80,0.089988751
Chicago,46347,4712,164,147,113,424,0.089983022
New York,7670,15081,625,484,248,1357,0.089980771
Phoenix (Prescott),85937,8602,348,244,182,774,0.089979075
Dallas-Ft. Worth,76012,27007,775,864,791,2430,0.089976673
Miami-Ft. Lauderdale,33182,14093,353,460,455,1268,0.089973746
Boston (Manchester),3045,13893,464,482,304,1250,0.089973368
"Columbus, OH",43125,15594,390,472,541,1403,0.089970501
Sioux City,50536,4257,136,138,109,383,0.089969462
Columbus-Tupelo-West Point,38851,8481,287,240,236,763,0.089965806
Cleveland-Akron (Canton),44320,18574,583,567,521,1671,0.089964466
Greenwood-Greenville,38901,17830,535,541,528,1604,0.08996074
Chicago,60126,47343,1651,1606,1002,4259,0.089960501
San Francisco-Oak-San Jose,94582,50390,2267,1468,798,4533,0.089958325
Cedar Rapids-Wtrlo-IWC&Dub,50621,1434,48,36,45,129,0.089958159
Madison,53825,478,19,12,12,43,0.089958159
Youngstown,44437,4013,133,126,102,361,0.089957638
San Diego,92019,43134,1231,1290,1359,3880,0.089952242
New York,11373,102802,2533,3098,3616,9247,0.089949612
Twin Falls,83316,10973,344,326,317,987,0.089948054
Harrisburg-Lncstr-Leb-York,17853,3113,111,83,86,280,0.08994539
Tulsa,74965,4525,166,119,122,407,0.089944751
Oklahoma City,73014,1601,58,46,40,144,0.089943785
New Orleans,70085,5515,163,166,167,496,0.089936537
Salt Lake City,84535,2235,88,62,51,201,0.089932886
Memphis,38002,45423,1719,1323,1043,4085,0.089932413
New York,7093,67230,1667,2068,2311,6046,0.089930091
Burlington-Plattsburgh,5068,3336,70,112,118,300,0.089928058
"Washington, DC (Hagrstwn)",20812,278,12,8,5,25,0.089928058
Minneapolis-St. Paul,55444,16769,583,485,440,1508,0.089927843
Philadelphia,18072,7039,195,217,221,633,0.089927547
Sioux Falls(Mitchell),57311,1568,65,40,36,141,0.089923469
Quincy-Hannibal-Keokuk,62376,1290,33,40,43,116,0.089922481
St. Louis,62272,1379,47,37,40,124,0.089920232
Madison,53593,31228,830,844,1134,2808,0.089919303
Des Moines-Ames,50310,31028,866,881,1043,2790,0.089918783
Columbus-Tupelo-West Point,39756,1557,53,47,40,140,0.089916506
Lansing,49251,5917,179,173,180,532,0.089910428
Jacksonville,32046,9844,325,291,269,885,0.089902479
"Columbus, OH",43055,63992,1904,1938,1911,5753,0.089901863
Philadelphia,19426,43082,1614,1429,830,3873,0.089898333
San Francisco-Oak-San Jose,94122,53163,854,1394,2531,4779,0.089893347
Philadelphia,8071,9122,240,286,294,820,0.089892567
New York,10305,44086,1109,1381,1473,3963,0.089892483
Omaha,51520,178,7,5,4,16,0.08988764
Quincy-Hannibal-Keokuk,63458,178,6,5,5,16,0.08988764
"Washington, DC (Hagrstwn)",20837,6753,237,218,152,607,0.089885977
"Lafayette, LA",70591,5418,181,168,138,487,0.089885567
New York,7657,11426,321,342,364,1027,0.089882724
Kansas City,66064,6008,188,172,180,540,0.08988016
Sacramnto-Stkton-Modesto,95993,37550,1134,1154,1087,3375,0.08988016
"Alexandria, LA",71355,2737,94,81,71,246,0.08987943
Lexington,40514,16368,529,478,464,1471,0.089870479
Sioux Falls(Mitchell),57103,37388,1121,1166,1073,3360,0.089868407
Grand Rapids-Kalmzoo-B.Crk,49004,16369,470,480,521,1471,0.089864989
Chicago,60072,957,36,24,26,86,0.089864159
Albuquerque-Santa Fe,87005,868,32,25,21,78,0.089861751
Yakima-Pasco-Rchlnd-Knnwck,97844,4251,141,130,111,382,0.089861209
Sioux City,68784,1992,82,47,50,179,0.089859438
"Columbus, OH",45681,1558,54,46,40,140,0.089858793
Phoenix (Prescott),85193,4585,144,145,123,412,0.089858233
Oklahoma City,73703,29825,919,847,914,2680,0.089857502
Spokane,99205,44894,1120,1269,1645,4034,0.089856105
New York,11778,12431,404,360,353,1117,0.089856005
Tulsa,74447,15536,503,474,419,1396,0.089855819
Phoenix (Prescott),85024,26053,720,719,902,2341,0.089855295
Billings,82411,690,27,20,15,62,0.089855072
Eureka,95555,345,12,11,8,31,0.089855072
Lake Charles,70658,1458,46,46,39,131,0.089849108
Toledo,43515,7958,258,233,224,715,0.089846695
Panama City,32407,18220,446,533,658,1637,0.089846323
Los Angeles,92223,65156,2276,1836,1742,5854,0.089845908
Greenwood-Greenville,38924,512,15,15,16,46,0.08984375
Raleigh-Durham (Fayetvlle),27536,15750,500,455,460,1415,0.08984127
"Lafayette, LA",70543,3740,132,100,104,336,0.089839572
Wichita-Hutchinson Plus,67205,21483,821,611,498,1930,0.089838477
Charlotte,28119,2037,59,65,59,183,0.089837997
Grand Rapids-Kalmzoo-B.Crk,49080,15584,498,509,393,1400,0.089835729
Philadelphia,19355,32071,1081,1029,771,2881,0.089831935
Roanoke-Lynchburg,24549,4130,145,115,111,371,0.089830508
Yakima-Pasco-Rchlnd-Knnwck,98942,18658,628,527,521,1676,0.08982742
New York,6811,31405,796,1241,784,2821,0.089826461
Philadelphia,19560,8895,273,248,278,799,0.089825745
Orlando-Daytona Bch-Melbrn,32901,26876,720,876,818,2414,0.089819914
Honolulu,96797,77455,2192,2317,2448,6957,0.089819895
Raleigh-Durham (Fayetvlle),28328,25340,798,765,713,2276,0.089818469
New Orleans,70053,15955,425,480,528,1433,0.089815105
Huntsville-Decatur (Flor),35981,1993,65,52,62,179,0.08981435
Watertown,13635,913,20,25,37,82,0.089813801
Orlando-Daytona Bch-Melbrn,34787,109870,3671,2918,3278,9867,0.089806135
Harrisburg-Lncstr-Leb-York,17372,3786,130,98,112,340,0.089804543
Cleveland-Akron (Canton),44314,17939,453,548,610,1611,0.089804337
Harrisburg-Lncstr-Leb-York,17313,12160,369,362,361,1092,0.089802632
Mobile-Pensacola (Ft Walt),36607,6971,179,216,231,626,0.089800602
Albuquerque-Santa Fe,87035,7606,258,234,191,683,0.089797528
Shreveport,75501,36583,1125,1081,1079,3285,0.089795807
Harrisburg-Lncstr-Leb-York,17059,7484,257,199,216,672,0.089791555
Erie,16125,17152,583,558,399,1540,0.089785448
"Springfield, MO",65616,28491,785,869,904,2558,0.089782738
Chicago,46382,2016,77,52,52,181,0.089781746
Los Angeles,91505,31611,718,861,1259,2838,0.089778874
Charleston-Huntington,25165,401,13,12,11,36,0.089775561
Philadelphia,8085,22211,828,614,552,1994,0.089775337
Little Rock-Pine Bluff,71647,1682,62,53,36,151,0.089774078
Jonesboro,72416,6405,206,177,192,575,0.089773614
Dallas-Ft. Worth,76052,37294,1523,991,834,3348,0.089773154
Orlando-Daytona Bch-Melbrn,32922,16475,493,504,482,1479,0.089772382
Mankato,56003,15484,506,452,432,1390,0.089770085
Philadelphia,8107,13624,336,415,472,1223,0.089768056
Philadelphia,19510,7720,263,231,199,693,0.089766839
Lexington,40337,5726,185,177,152,514,0.08976598
Champaign&Sprngfld-Decatur,62613,3710,146,107,80,333,0.089757412
Shreveport,74728,11264,358,332,321,1011,0.089754972
Orlando-Daytona Bch-Melbrn,32805,23787,707,727,701,2135,0.089754908
Harrisburg-Lncstr-Leb-York,17048,4646,160,144,113,417,0.089754628
Los Angeles,93555,32868,1060,947,943,2950,0.089752951
"Washington, DC (Hagrstwn)",22309,33772,1030,1025,976,3031,0.089748904
New York,11557,8067,265,251,208,724,0.089748358
Philadelphia,19374,936,36,28,20,84,0.08974359
Mobile-Pensacola (Ft Walt),39452,29718,991,821,855,2667,0.08974359
Columbia-Jefferson City,63361,4212,140,125,113,378,0.08974359
Raleigh-Durham (Fayetvlle),27518,22186,587,665,739,1991,0.089741278
Charlotte,28083,26933,828,767,822,2417,0.08974121
Wilkes Barre-Scranton-Hztn,17747,3187,116,89,81,286,0.089739567
Sacramnto-Stkton-Modesto,95361,35805,1173,1066,974,3213,0.08973607
Birmingham (Ann and Tusc),35031,8358,270,250,230,750,0.089734386
Boise,83644,17385,658,508,394,1560,0.089732528
"Portland, OR",97140,28875,1068,843,680,2591,0.089731602
Little Rock-Pine Bluff,72112,11412,267,318,439,1024,0.089730109
Houston,77586,23504,710,736,663,2109,0.089729408
Abilene-Sweetwater,76435,691,25,23,14,62,0.089725036
Wichita-Hutchinson Plus,67140,613,25,11,19,55,0.089722675
Chicago,60443,20530,620,610,612,1842,0.089722358
"Washington, DC (Hagrstwn)",22602,32244,1014,967,912,2893,0.089722119
Seattle-Tacoma,98568,2909,104,88,69,261,0.089721554
Denver,80644,2976,78,103,86,267,0.089717742
El Paso (Las Cruces),88044,3333,121,102,76,299,0.089708971
Raleigh-Durham (Fayetvlle),27517,31882,789,854,1217,2860,0.08970579
Juneau,99801,29553,866,904,881,2651,0.089703245
Cedar Rapids-Wtrlo-IWC&Dub,52316,1806,66,53,43,162,0.089700997
Champaign&Sprngfld-Decatur,61833,2174,44,84,67,195,0.089696412
New York,7047,64375,1644,2003,2127,5774,0.089693204
Eugene,97370,9544,267,297,292,856,0.089689858
Lexington,40350,223,9,6,5,20,0.089686099
Sioux Falls(Mitchell),51230,446,18,11,11,40,0.089686099
Phoenix (Prescott),85032,65815,1707,1963,2232,5902,0.089675606
New Orleans,70071,3011,94,78,98,270,0.089671206
Los Angeles,92603,19873,683,624,475,1782,0.089669401
Houston,77414,24703,794,719,702,2215,0.089665223
"Jackson, TN",38388,1528,53,44,40,137,0.089659686
"Jackson, MS",39629,6882,229,201,187,617,0.08965417
New York,10573,41928,1258,1283,1218,3759,0.089653692
Lincoln & Hastings-Krny,68507,16140,431,429,587,1447,0.089653036
Detroit,48374,18215,749,517,367,1633,0.089651386
New York,12570,6793,222,206,181,609,0.089651111
Oklahoma City,73078,13285,553,373,265,1191,0.089649981
New York,7751,22265,767,659,570,1996,0.089647429
Ft. Wayne,45873,2376,83,69,61,213,0.089646465
Peoria-Bloomington,61742,1149,42,30,31,103,0.089643168
New Orleans,70030,4306,148,120,118,386,0.089642359
Pittsburgh,15148,2510,76,65,84,225,0.089641434
San Francisco-Oak-San Jose,94804,45549,1247,1371,1465,4083,0.089639729
Seattle-Tacoma,98144,36670,676,955,1656,3287,0.089637306
New York,7302,64472,628,1270,3881,5779,0.089635811
Birmingham (Ann and Tusc),35217,12529,394,381,348,1123,0.089632054
Detroit,48360,12172,382,361,348,1091,0.089631942
Orlando-Daytona Bch-Melbrn,32708,47182,1368,1404,1457,4229,0.089631639
Dallas-Ft. Worth,75482,26330,842,772,746,2360,0.089631599
Memphis,38683,4552,159,135,114,408,0.089630931
Springfield-Holyoke,1106,15899,625,538,262,1425,0.089628279
Syracuse,13068,4820,132,144,156,432,0.089626556
"Portland, OR",98662,39230,1104,1146,1266,3516,0.089625287
Seattle-Tacoma,98108,26144,665,798,880,2343,0.089619033
Sherman-Ada,73443,3593,131,95,96,322,0.089618703
Toledo,43623,19762,543,552,676,1771,0.089616436
Atlanta,30009,19896,535,613,635,1783,0.089616003
Nashville,37055,29751,868,921,877,2666,0.089610433
Greenville-N.Bern-Washngtn,28530,6640,214,196,185,595,0.089608434
Houston,77583,59671,2073,1650,1624,5347,0.089608017
Albuquerque-Santa Fe,88250,279,9,9,7,25,0.089605735
Cincinnati,45255,22220,673,684,634,1991,0.08960396
Oklahoma City,73080,11484,404,329,296,1029,0.089602926
Yakima-Pasco-Rchlnd-Knnwck,99338,20502,744,589,504,1837,0.089601015
Peoria-Bloomington,61568,4230,166,120,93,379,0.089598109
Denver,80109,29355,1163,870,597,2630,0.089592914
Minneapolis-St. Paul,55421,30550,845,881,1011,2737,0.089590835
Nashville,37072,33609,898,1024,1089,3011,0.089589098
Tulsa,74462,6675,232,199,167,598,0.089588015
Green Bay-Appleton,54113,3572,124,105,91,320,0.089585666
"Washington, DC (Hagrstwn)",20158,4800,187,155,88,430,0.089583333
Ft. Wayne,46791,960,30,28,28,86,0.089583333
Cleveland-Akron (Canton),44105,32776,981,940,1015,2936,0.08957774
Tyler-Longview(Lfkn&Ncgd),75684,7781,265,231,201,697,0.089577175
Champaign&Sprngfld-Decatur,62635,681,24,18,19,61,0.089574156
Johnstown-Altoona-St Colge,15902,10673,279,323,354,956,0.089571817
Milwaukee,53594,5426,160,164,162,486,0.089568743
Youngstown,16146,12750,359,394,389,1142,0.089568627
Salt Lake City,84117,25367,646,746,880,2272,0.089565183
Birmingham (Ann and Tusc),35954,11969,352,363,357,1072,0.089564709
"Columbus, GA (Opelika, AL)",36274,10272,306,300,314,920,0.089563863
Wichita-Hutchinson Plus,67152,9111,309,277,230,816,0.089562068
Los Angeles,90745,59713,1606,1800,1942,5348,0.089561737
"Tri-Cities, TN-VA",37616,5259,184,152,135,471,0.089560753
Bluefield-Beckley-Oak Hill,25085,804,27,25,20,72,0.089552239
Bluefield-Beckley-Oak Hill,25922,335,11,11,8,30,0.089552239
"Columbus, GA (Opelika, AL)",31832,268,8,9,7,24,0.089552239
Mobile-Pensacola (Ft Walt),36727,67,2,2,2,6,0.089552239
Cedar Rapids-Wtrlo-IWC&Dub,50268,938,29,34,21,84,0.089552239
Fargo,56651,670,24,20,16,60,0.089552239
Wichita Falls & Lawton,76377,603,22,16,16,54,0.089552239
Dallas-Ft. Worth,76676,469,18,12,12,42,0.089552239
Fresno-Visalia,93652,335,13,11,6,30,0.089552239
Raleigh-Durham (Fayetvlle),27801,18906,558,584,551,1693,0.089548292
Salt Lake City,84124,21843,667,647,642,1956,0.089548139
Denver,80016,71861,2712,2052,1671,6435,0.089547877
Cleveland-Akron (Canton),44111,39723,1089,1209,1259,3557,0.0895451
Hattiesburg-Laurel,39323,1329,46,34,39,119,0.089541008
Dallas-Ft. Worth,76622,1195,42,35,30,107,0.089539749
Richmond-Petersburg,23834,27083,831,776,818,2425,0.089539564
"Jackson, MS",39063,2714,84,90,69,243,0.089535741
"Washington, DC (Hagrstwn)",25428,12822,419,354,375,1148,0.089533614
Los Angeles,90601,31544,874,942,1008,2824,0.089525742
Charlotte,29715,47074,1811,1337,1066,4214,0.08951863
Charleston-Huntington,25143,8367,224,259,266,749,0.089518346
Chicago,60302,32642,905,1005,1012,2922,0.089516574
"Jackson, TN",38345,2279,77,64,63,204,0.089512944
Cleveland-Akron (Canton),44683,7943,228,234,249,711,0.089512779
Charlotte,28604,7284,237,234,181,652,0.089511258
Wichita-Hutchinson Plus,67114,21126,726,593,572,1891,0.089510556
Cleveland-Akron (Canton),44035,62440,1664,1833,2092,5589,0.08950993
"Washington, DC (Hagrstwn)",22060,9865,241,262,380,883,0.089508363
Cleveland-Akron (Canton),44857,23552,758,672,678,2108,0.089504076
Wichita-Hutchinson Plus,67952,581,21,20,11,52,0.089500861
Wichita-Hutchinson Plus,67103,257,9,8,6,23,0.089494163
Minneapolis-St. Paul,55362,21052,744,576,564,1884,0.089492685
Amarillo,73951,961,27,34,25,86,0.089490114
Detroit,48134,23947,774,709,660,2143,0.089489289
Champaign&Sprngfld-Decatur,61880,4224,148,121,109,378,0.089488636
Wilkes Barre-Scranton-Hztn,18505,20986,601,631,646,1878,0.08948823
Lubbock,79235,3263,119,100,73,292,0.089488201
Birmingham (Ann and Tusc),35077,14695,502,409,404,1315,0.08948622
Albany-Schenectady-Troy,12028,1084,41,28,28,97,0.089483395
"Charleston, SC",29483,59978,1986,1690,1691,5367,0.08948281
Los Angeles,92708,56830,1529,1844,1712,5085,0.089477389
Columbia-Jefferson City,65255,4627,173,142,99,414,0.089474822
Tampa-St. Pete (Sarasota),33625,28198,768,867,888,2523,0.089474431
Savannah,31312,26712,967,772,651,2390,0.089472896
"Washington, DC (Hagrstwn)",25413,10942,341,324,314,979,0.08947176
Tulsa,74066,31835,991,956,901,2848,0.089461285
Salt Lake City,84724,1129,46,30,25,101,0.089459699
Denver,80138,35681,1258,1071,863,3192,0.089459376
Meridian,39335,2683,76,85,79,240,0.089452106
Tucson (Sierra Vista),85710,57585,1431,1789,1931,5151,0.089450378
"Jackson, MS",39601,22907,714,664,671,2049,0.08944864
Evansville,42333,995,31,32,26,89,0.089447236
"Washington, DC (Hagrstwn)",25438,6932,216,215,189,620,0.089440277
Knoxville,37756,2661,102,80,56,238,0.08944006
New York,8804,2225,68,64,67,199,0.089438202
Knoxville,37846,4573,161,133,115,409,0.089438006
"Washington, DC (Hagrstwn)",22741,246,8,7,7,22,0.089430894
Huntsville-Decatur (Flor),35739,5658,176,167,163,506,0.089430894
"Columbus, OH",43340,1722,64,47,43,154,0.089430894
Shreveport,71065,984,31,29,28,88,0.089430894
Indianapolis,46184,14660,475,403,433,1311,0.089427012
Boston (Manchester),1536,7727,233,222,236,691,0.089426686
"Charleston, SC",29407,35854,698,1028,1480,3206,0.089418196
Myrtle Beach-Florence,29532,19571,592,569,589,1750,0.089418016
Macon,31032,14449,478,440,374,1292,0.089417953
Birmingham (Ann and Tusc),36201,17312,428,532,588,1548,0.089417745
St. Louis,63038,6744,231,232,140,603,0.089412811
Odessa-Midland,79749,425,17,12,9,38,0.089411765
Chicago,60805,19003,589,551,559,1699,0.089406936
New York,7036,46596,1253,1406,1507,4166,0.089406816
Raleigh-Durham (Fayetvlle),27540,53443,2203,1511,1064,4778,0.089403664
Peoria-Bloomington,61559,2953,111,83,70,264,0.08940061
Greenville-N.Bern-Washngtn,28398,6197,195,181,178,554,0.089398096
Little Rock-Pine Bluff,72125,839,28,25,22,75,0.089392133
Baton Rouge,70774,10650,361,321,270,952,0.089389671
Tucson (Sierra Vista),85635,35295,1029,1064,1062,3155,0.089389432
"Rochester, NY",14614,1734,16,60,79,155,0.089388697
Elmira (Corning),14830,19007,563,565,571,1699,0.08938812
Fargo,58351,358,11,10,11,32,0.089385475
Great Falls,59529,179,5,6,5,16,0.089385475
Grand Rapids-Kalmzoo-B.Crk,49426,42312,1522,1184,1076,3782,0.089383626
Grand Rapids-Kalmzoo-B.Crk,49464,30634,1034,873,831,2738,0.089377815
"Charleston, SC",29414,46992,910,1196,2094,4200,0.089376915
"Alexandria, LA",71351,10439,329,317,287,933,0.089376377
Harrisburg-Lncstr-Leb-York,17347,7228,254,206,186,646,0.089374654
Cedar Rapids-Wtrlo-IWC&Dub,52227,3312,130,96,70,296,0.089371981
New York,7840,32572,1023,1065,823,2911,0.089371239
New Orleans,70117,27974,655,746,1099,2500,0.0893687
St. Louis,63012,11548,385,346,301,1032,0.089366124
New York,11776,22638,640,706,677,2023,0.089363018
Elmira (Corning),14877,470,15,15,12,42,0.089361702
Bowling Green,42765,6345,208,187,172,567,0.089361702
Sherman-Ada,74729,2809,95,82,74,251,0.089355643
New York,7407,21476,559,623,737,1919,0.08935556
Los Angeles,92782,28818,845,818,912,2575,0.089353876
Detroit,48341,17470,469,498,594,1561,0.089353177
Davenport-R.Island-Moline,52761,30050,936,919,830,2685,0.089351082
"Lafayette, LA",70520,20593,693,591,556,1840,0.08935075
Peoria-Bloomington,61736,1858,77,57,32,166,0.08934338
Idaho Fals-Pocatllo(Jcksn),83427,929,40,27,16,83,0.08934338
Chicago,60162,8070,206,254,261,721,0.089343247
Denver,80129,30480,999,940,784,2723,0.08933727
Little Rock-Pine Bluff,72579,1444,47,42,40,129,0.08933518
Boston (Manchester),1581,22063,675,665,631,1971,0.089335086
Toledo,43608,12873,457,373,320,1150,0.089334266
"Columbus, OH",43332,2015,63,58,59,180,0.089330025
Greenvll-Spart-Ashevll-And,28043,20139,610,603,586,1799,0.089329162
Mobile-Pensacola (Ft Walt),36562,1780,51,53,55,159,0.089325843
Birmingham (Ann and Tusc),35020,23689,734,662,720,2116,0.089324159
Charleston-Huntington,25285,627,22,21,13,56,0.089314195
Charleston-Huntington,41257,627,19,19,18,56,0.089314195
Kansas City,64012,30253,954,893,855,2702,0.089313457
"Springfield, MO",65771,1422,60,38,29,127,0.08931083
Dallas-Ft. Worth,75409,31185,1068,866,851,2785,0.089305756
Orlando-Daytona Bch-Melbrn,32738,49127,1473,1459,1455,4387,0.089299163
New York,11552,24827,719,762,736,2217,0.089297942
Denver,80019,9026,289,234,283,806,0.089297585
Spokane,83837,3438,102,102,103,307,0.089296102
Wilkes Barre-Scranton-Hztn,18372,2475,93,69,59,221,0.089292929
Miami-Ft. Lauderdale,33076,44584,1865,1278,838,3981,0.089292123
Tyler-Longview(Lfkn&Ncgd),75654,12252,429,340,325,1094,0.089291544
Atlanta,30217,9273,301,255,272,828,0.089291491
"Rochester, NY",14486,280,10,6,9,25,0.089285714
Clarksburg-Weston,26327,56,2,2,1,5,0.089285714
Mobile-Pensacola (Ft Walt),36567,16184,527,468,450,1445,0.089285714
Fargo,56523,504,22,14,9,45,0.089285714
St. Louis,62084,1512,49,44,42,135,0.089285714
Ottumwa-Kirksville,63451,280,12,8,5,25,0.089285714
"Springfield, MO",65728,56,2,2,1,5,0.089285714
Wichita Falls & Lawton,73560,560,21,18,11,50,0.089285714
Denver,80463,56,2,2,1,5,0.089285714
Reno,89414,336,13,9,8,30,0.089285714
Augusta-Aiken,29851,9789,304,280,290,874,0.08928389
Cleveland-Akron (Canton),44714,8602,249,243,276,768,0.089281562
Birmingham (Ann and Tusc),35546,3965,123,119,112,354,0.089281211
Beaumont-Port Arthur,77627,22704,668,630,729,2027,0.089279422
Seattle-Tacoma,98331,5634,185,170,148,503,0.089279375
Louisville,40011,2677,85,86,68,239,0.089279044
St. Louis,63005,19244,685,606,427,1718,0.089274579
Jacksonville,32258,41255,1018,1127,1538,3683,0.089274027
Oklahoma City,73052,6128,206,171,170,547,0.089262402
Lincoln & Hastings-Krny,68803,26977,830,859,719,2408,0.089261223
San Diego,92008,28221,675,799,1045,2519,0.089259771
"Jackson, MS",39094,3966,133,112,109,354,0.089258699
Philadelphia,8330,30395,879,863,971,2713,0.089258102
Louisville,40033,12873,390,398,361,1149,0.089256584
Seattle-Tacoma,98815,8571,289,258,218,765,0.089254463
Topeka,66407,549,23,16,10,49,0.089253188
Sioux City,68723,549,20,13,16,49,0.089253188
Buffalo,14806,2084,72,57,57,186,0.08925144
Charleston-Huntington,41256,1860,69,51,46,166,0.089247312
Cincinnati,45040,60362,2358,1806,1223,5387,0.089244889
Memphis,72342,3709,120,100,111,331,0.089242383
"Washington, DC (Hagrstwn)",20175,35768,1221,1042,929,3192,0.08924178
Evansville,47542,10399,341,289,298,928,0.08923935
Binghamton,13485,1524,52,39,45,136,0.089238845
Pittsburgh,15064,381,14,11,9,34,0.089238845
Huntsville-Decatur (Flor),35661,19812,565,591,612,1768,0.089238845
Detroit,48048,11049,350,317,319,986,0.089238845
Idaho Fals-Pocatllo(Jcksn),83434,1905,78,46,46,170,0.089238845
"Washington, DC (Hagrstwn)",26726,12943,444,378,333,1155,0.089237426
Monroe-El Dorado,71465,2880,93,82,82,257,0.089236111
Chicago,60441,34729,1139,1013,947,3099,0.089233782
Knoxville,37830,33082,1006,1026,920,2952,0.089232815
Lexington,40923,975,34,28,25,87,0.089230769
Baltimore,21046,16127,417,501,521,1439,0.089229243
"Portland, OR",97123,51128,1612,1487,1463,4562,0.089227038
New Orleans,70002,19266,437,602,680,1719,0.089224541
Champaign&Sprngfld-Decatur,62692,1995,59,61,58,178,0.089223058
Harrisburg-Lncstr-Leb-York,17046,32559,1010,938,957,2905,0.089222642
Cincinnati,41073,5649,116,124,264,504,0.089219331
Atlanta,30554,8328,247,233,263,743,0.089217099
Paducah-Cape Girard-Harsbg,63873,4024,129,122,108,359,0.089214712
Atlanta,30215,39288,1383,1196,926,3505,0.089212991
Hartford & New Haven,6052,8250,221,272,243,736,0.089212121
New York,11701,28550,734,852,961,2547,0.089211909
Green Bay-Appleton,54915,44187,1439,1270,1233,3942,0.089211759
Ft. Smith-Fay-Sprngdl-Rgrs,72846,4226,151,117,109,377,0.089209655
Lima,45801,22520,655,708,646,2009,0.089209591
Birmingham (Ann and Tusc),35045,15492,512,444,426,1382,0.089207333
Ft. Smith-Fay-Sprngdl-Rgrs,72722,3464,110,104,95,309,0.089203233
Watertown,13665,852,28,24,24,76,0.089201878
Sioux Falls(Mitchell),69212,426,16,11,11,38,0.089201878
Zanesville,43802,1435,46,41,41,128,0.089198606
Minneapolis-St. Paul,56307,5684,192,179,136,507,0.089197748
Harrisburg-Lncstr-Leb-York,17557,15124,492,416,441,1349,0.08919598
Little Rock-Pine Bluff,72058,19878,695,588,490,1773,0.089194084
Dallas-Ft. Worth,75048,32133,1172,944,750,2866,0.089191797
Hattiesburg-Laurel,39336,1110,34,34,31,99,0.089189189
Detroit,48195,29669,663,891,1092,2646,0.089183997
Orlando-Daytona Bch-Melbrn,34472,34278,1134,992,931,3057,0.089182566
Waco-Temple-Bryan,76534,2736,89,92,63,244,0.089181287
Tampa-St. Pete (Sarasota),33527,18637,663,565,434,1662,0.089177443
New York,12456,471,13,12,17,42,0.089171975
Davenport-R.Island-Moline,52623,1884,59,58,51,168,0.089171975
Kansas City,66226,15386,622,439,311,1372,0.089171975
Sioux Falls(Mitchell),57380,3084,104,80,91,275,0.089169909
New York,7065,30539,787,899,1037,2723,0.089164675
Birmingham (Ann and Tusc),35125,11204,348,335,316,999,0.089164584
Myrtle Beach-Florence,28358,33524,977,997,1015,2989,0.089160005
Amarillo,79014,3219,133,93,61,287,0.089158124
Toledo,43560,34222,1183,1020,848,3051,0.089153176
Amarillo,79086,1862,66,61,39,166,0.08915145
"Washington, DC (Hagrstwn)",20640,10084,302,305,292,899,0.089151131
Kansas City,64128,11733,384,354,308,1046,0.08915026
Wichita-Hutchinson Plus,67026,4958,187,155,100,442,0.08914885
Medford-Klamath Falls,97503,13113,430,386,353,1169,0.089148174
Lansing,48876,3971,107,127,120,354,0.089146311
"Charleston, SC",29485,59885,2007,1675,1656,5338,0.089137514
Des Moines-Ames,50830,1638,58,56,32,146,0.089133089
Baton Rouge,70744,6496,205,195,179,579,0.089131773
Mobile-Pensacola (Ft Walt),36604,8527,197,236,327,760,0.08912865
"Jackson, MS",39149,1728,57,50,47,154,0.08912037
Chicago,60181,29343,808,900,907,2615,0.089118359
Champaign&Sprngfld-Decatur,61931,1066,37,27,31,95,0.089118199
New York,11738,16697,493,488,507,1488,0.089117806
Houston,77377,43035,1631,1190,1014,3835,0.089113512
Jacksonville,32040,8080,258,245,217,720,0.089108911
Mobile-Pensacola (Ft Walt),36522,7777,262,228,203,693,0.089108911
Lincoln & Hastings-Krny,68943,202,7,4,7,18,0.089108911
Chattanooga,37357,6756,222,193,187,602,0.08910598
Cincinnati,41074,6251,188,181,188,557,0.089105743
Birmingham (Ann and Tusc),35475,20370,719,584,512,1815,0.08910162
Lake Charles,70669,9944,307,283,296,886,0.089098954
Chicago,60178,22032,704,640,619,1963,0.089097676
St. Louis,62839,6218,172,193,189,554,0.089096172
Houston,77069,18901,488,532,664,1684,0.089095815
New Orleans,70049,1953,64,51,59,174,0.089093702
Tallahassee-Thomasville,31757,11213,398,331,270,999,0.089093017
San Francisco-Oak-San Jose,95482,33090,1039,991,918,2948,0.08909036
Charleston-Huntington,41566,449,15,15,10,40,0.08908686
Kansas City,64461,797,28,22,21,71,0.089084065
Greenvll-Spart-Ashevll-And,28778,10597,354,327,263,944,0.089081816
New Orleans,70070,13606,493,390,329,1212,0.089078348
Salisbury,19947,22644,728,661,628,2017,0.089074368
South Bend-Elkhart,46561,13180,454,393,327,1174,0.089074355
"Rochester, NY",14606,28224,798,827,889,2514,0.089073129
Charlotte,28159,3065,105,76,92,273,0.089070147
Salt Lake City,89815,16605,634,419,426,1479,0.089069557
New York,7660,13192,358,386,431,1175,0.089069133
New York,11765,741,23,26,17,66,0.089068826
Albuquerque-Santa Fe,87747,1482,34,37,61,132,0.089068826
"Portland, OR",97230,41878,1107,1179,1444,3730,0.089068246
Atlanta,30735,5973,191,175,166,532,0.08906747
Pittsburgh,21521,1134,37,39,25,101,0.089065256
Boston (Manchester),2169,63203,1097,1630,2902,5629,0.089062228
Houston,77538,1033,37,30,25,92,0.089060987
Zanesville,43701,55570,1571,1668,1710,4949,0.089058845
Burlington-Plattsburgh,3770,393,17,11,7,35,0.089058524
Denver,69152,786,26,22,22,70,0.089058524
San Diego,92026,54314,1511,1604,1722,4837,0.089056229
Dallas-Ft. Worth,76660,539,21,14,13,48,0.089053803
Minneapolis-St. Paul,55433,35002,984,1005,1128,3117,0.089052054
Birmingham (Ann and Tusc),35904,13363,400,389,401,1190,0.08905186
"Rochester, NY",14616,27009,790,787,828,2405,0.089044393
Orlando-Daytona Bch-Melbrn,32720,35444,1079,1141,936,3156,0.089041869
Birmingham (Ann and Tusc),35184,5694,190,164,153,507,0.089041096
Columbia-Jefferson City,63384,1696,65,45,41,151,0.089033019
Atlanta,30646,8188,258,228,243,729,0.089032731
Oklahoma City,74849,2954,94,94,75,263,0.089031821
"Jackson, TN",38358,12378,370,385,347,1102,0.089028922
Miami-Ft. Lauderdale,33018,56949,1616,1772,1682,5070,0.089027024
Wilkes Barre-Scranton-Hztn,18622,337,10,11,9,30,0.089020772
Joplin-Pittsburg,64759,7751,265,213,212,690,0.089020772
Las Vegas,89045,1584,53,47,41,141,0.089015152
Dallas-Ft. Worth,75230,27580,668,763,1024,2455,0.089013778
Raleigh-Durham (Fayetvlle),27330,41410,1321,1211,1154,3686,0.089012316
New York,11214,93472,2469,2766,3085,8320,0.089010613
Twin Falls,83333,12257,442,382,267,1091,0.089010361
Champaign&Sprngfld-Decatur,60927,2202,66,71,59,196,0.089009991
Grand Junction-Montrose,81425,5359,177,154,146,477,0.089009143
Roanoke-Lynchburg,24073,31380,773,902,1118,2793,0.089005736
New York,10980,12988,391,360,405,1156,0.089005236
Indianapolis,47247,191,6,5,6,17,0.089005236
Evansville,62886,382,13,9,12,34,0.089005236
Quincy-Hannibal-Keokuk,63446,573,20,15,16,51,0.089005236
Sherman-Ada,73438,2865,101,85,69,255,0.089005236
Raleigh-Durham (Fayetvlle),27880,3191,111,95,78,284,0.089000313
St. Louis,62016,3000,97,86,84,267,0.089
Cincinnati,45157,9753,323,288,257,868,0.088998257
Cincinnati,47017,618,18,23,14,55,0.088996764
Paducah-Cape Girard-Harsbg,42020,2281,60,83,60,203,0.088996054
Baltimore,21234,64625,1697,1813,2241,5751,0.088990329
Dallas-Ft. Worth,75402,20744,601,621,624,1846,0.088989587
San Francisco-Oak-San Jose,94901,42736,1290,1262,1251,3803,0.088988207
Nashville,37186,10552,348,288,303,939,0.08898787
Tallahassee-Thomasville,39819,12474,384,364,362,1110,0.088985089
Paducah-Cape Girard-Harsbg,62941,708,27,20,16,63,0.088983051
Wichita Falls & Lawton,76261,236,8,8,5,21,0.088983051
Rockford,61108,29107,847,862,881,2590,0.088982032
Little Rock-Pine Bluff,71602,16352,476,498,481,1455,0.088979941
Dallas-Ft. Worth,75068,78064,2781,2206,1959,6946,0.088978274
Cleveland-Akron (Canton),44147,19488,535,565,634,1734,0.088977833
Sacramnto-Stkton-Modesto,95316,7249,234,227,184,645,0.08897779
Macon,31055,4743,152,148,122,422,0.088973224
Los Angeles,92371,17309,605,495,440,1540,0.088971056
"Portland, OR",97211,34226,690,999,1356,3045,0.088967452
Los Angeles,92604,27617,801,806,850,2457,0.088966941
Seattle-Tacoma,98531,28202,823,863,823,2509,0.088965322
Albuquerque-Santa Fe,87531,3923,124,117,108,349,0.088962529
Wichita-Hutchinson Plus,67144,2799,109,78,62,249,0.088960343
Houston,77062,26001,757,772,784,2313,0.088958117
St. Louis,62533,978,31,25,31,87,0.088957055
Champaign&Sprngfld-Decatur,62661,1304,47,34,35,116,0.088957055
Cleveland-Akron (Canton),44411,2327,82,60,65,207,0.088955737
New Orleans,70763,4182,160,119,93,372,0.088952654
Knoxville,37932,25362,733,773,750,2256,0.088951975
Minneapolis-St. Paul,55075,20485,585,636,601,1822,0.088943129
San Francisco-Oak-San Jose,95136,43399,1097,1256,1507,3860,0.088942142
Mobile-Pensacola (Ft Walt),36784,6735,208,190,201,599,0.088938382
Ft. Smith-Fay-Sprngdl-Rgrs,74901,1799,62,54,44,160,0.088938299
Indianapolis,46123,43772,1436,1252,1205,3893,0.088938134
Miami-Ft. Lauderdale,33324,49811,1230,1400,1800,4430,0.088936179
Cincinnati,41014,6994,193,182,247,622,0.088933371
Wichita-Hutchinson Plus,67865,1012,38,30,22,90,0.088932806
South Bend-Elkhart,46582,14472,443,407,437,1287,0.088930348
Kansas City,64701,15023,490,415,431,1336,0.088930307
Baton Rouge,70372,2159,67,58,67,192,0.08893006
Memphis,63851,3306,89,100,105,294,0.08892922
Madison,53562,29947,859,896,908,2663,0.088923765
Knoxville,37814,34153,1079,999,959,3037,0.088923374
Des Moines-Ames,50126,6399,208,227,134,569,0.088920144
Memphis,38053,26316,766,755,819,2340,0.088919289
"Lafayette, LA",70611,22920,797,636,605,2038,0.088917976
Salt Lake City,84109,24832,714,733,761,2208,0.088917526
New Orleans,70395,4881,170,140,124,434,0.088916206
Charleston-Huntington,45634,1912,62,58,50,170,0.088912134
Charlottesville,22901,37161,895,1128,1281,3304,0.088910417
Detroit,48030,14723,302,415,592,1309,0.08890851
Baltimore,21912,1271,44,39,30,113,0.088906373
Las Vegas,89131,50503,1752,1513,1225,4490,0.08890561
St. Louis,62560,1361,49,43,29,121,0.088905217
Philadelphia,19709,56746,1970,1663,1412,5045,0.088904945
Providence-New Bedford,2720,31067,741,959,1062,2762,0.088904625
Sacramnto-Stkton-Modesto,95320,12700,397,380,352,1129,0.088897638
Columbus-Tupelo-West Point,39740,6176,223,179,147,549,0.088892487
"Washington, DC (Hagrstwn)",20164,43031,1263,1260,1302,3825,0.088889405
Charlottesville,23055,720,28,17,19,64,0.088888889
Charleston-Huntington,25559,1755,64,50,42,156,0.088888889
Rockford,61243,225,10,6,4,20,0.088888889
Wichita-Hutchinson Plus,67838,855,32,23,21,76,0.088888889
Wichita-Hutchinson Plus,67850,315,11,10,7,28,0.088888889
Tulsa,74457,765,31,19,18,68,0.088888889
Houston,77560,180,5,4,7,16,0.088888889
"Portland, OR",97212,26663,668,681,1021,2370,0.088887222
Salt Lake City,84737,26315,902,765,672,2339,0.088884667
Houston,77386,70570,2773,1893,1606,6272,0.088876293
Madison,53520,6605,220,193,174,587,0.088872067
Greenvll-Spart-Ashevll-And,29697,13368,446,372,370,1188,0.088868941
Kansas City,64643,934,34,29,20,83,0.088865096
Lexington,40513,11163,386,354,252,992,0.088865
Mobile-Pensacola (Ft Walt),32504,21753,538,688,707,1933,0.088861306
Evansville,47710,18040,457,540,606,1603,0.088858093
Charlotte,28115,47515,1619,1415,1188,4222,0.088856151
Little Rock-Pine Bluff,72223,27145,796,799,817,2412,0.088856143
Cincinnati,45697,4682,160,132,124,416,0.088850918
Abilene-Sweetwater,79536,5166,171,148,140,459,0.088850174
Wilkes Barre-Scranton-Hztn,18330,8475,261,255,237,753,0.088849558
Atlanta,30104,5031,151,151,145,447,0.088849135
"Washington, DC (Hagrstwn)",20147,72059,2351,2129,1922,6402,0.088843864
Jacksonville,31501,14059,428,435,386,1249,0.088839889
Buffalo,14724,2589,90,74,66,230,0.088837389
St. Louis,62258,10255,373,285,253,911,0.088834715
Chicago,60643,44859,1374,1342,1269,3985,0.088833902
Chicago,60563,38893,1037,1087,1331,3455,0.088833466
New York,11940,5516,162,174,154,490,0.088832487
Cincinnati,45013,53878,1699,1534,1553,4786,0.08883032
Palm Springs,92282,1396,45,46,33,124,0.088825215
Tyler-Longview(Lfkn&Ncgd),75766,25973,825,762,720,2307,0.088823009
"Columbus, OH",45896,1959,61,60,53,174,0.088820827
Minneapolis-St. Paul,55309,21763,763,623,547,1933,0.088820475
Peoria-Bloomington,60921,1610,50,54,39,143,0.088819876
Greenvll-Spart-Ashevll-And,29372,4740,150,130,141,421,0.088818565
Atlanta,30286,24387,708,729,729,2166,0.088817813
Louisville,47162,912,33,25,23,81,0.088815789
"Portland, OR",97306,34555,1070,1002,997,3069,0.088814933
Davenport-R.Island-Moline,52659,1475,44,40,47,131,0.088813559
Jacksonville,31516,16090,523,475,431,1429,0.088812927
Philadelphia,8083,10100,268,299,330,897,0.088811881
Milwaukee,53184,4110,137,127,101,365,0.088807786
Oklahoma City,73040,1599,58,47,37,142,0.088805503
Amarillo,79121,7083,183,223,223,629,0.088804179
Knoxville,40856,518,16,16,14,46,0.088803089
Tulsa,74019,21497,687,646,576,1909,0.088803089
Columbus-Tupelo-West Point,38866,12703,407,366,355,1128,0.088797922
Mobile-Pensacola (Ft Walt),32569,13086,340,316,506,1162,0.088797188
Charleston-Huntington,45663,6059,183,185,170,538,0.08879353
Philadelphia,8062,17907,651,552,387,1590,0.088792092
Sacramnto-Stkton-Modesto,95670,58523,1569,1660,1967,5196,0.088785606
Des Moines-Ames,50133,428,18,11,9,38,0.088785047
Denver,80755,214,10,5,4,19,0.088785047
Norfolk-Portsmth-Newpt Nws,23454,58321,1686,1763,1729,5178,0.088784486
Birmingham (Ann and Tusc),36207,19542,568,588,579,1735,0.088783134
Peoria-Bloomington,62633,597,19,17,17,53,0.088777219
New York,12594,3965,115,121,116,352,0.088776797
Cedar Rapids-Wtrlo-IWC&Dub,50665,2895,106,67,84,257,0.088773748
Salt Lake City,84309,766,32,23,13,68,0.088772846
Dayton,45356,25143,765,735,732,2232,0.088772223
New York,10601,13315,286,384,512,1182,0.088772062
San Francisco-Oak-San Jose,94060,1318,33,53,31,117,0.088770865
Toledo,43556,1870,66,56,44,166,0.088770053
Beaumont-Port Arthur,77632,23195,716,655,688,2059,0.088769131
Shreveport,75672,17450,540,554,455,1549,0.088767908
Salt Lake City,84765,8573,322,253,186,761,0.088767059
Philadelphia,19934,15107,473,467,401,1341,0.088766797
Montgomery-Selma,36047,1273,38,39,36,113,0.088766693
Boise,83634,38269,1248,1089,1060,3397,0.088766364
Charleston-Huntington,41603,1397,48,39,37,124,0.088761632
Charleston-Huntington,25514,3808,125,108,105,338,0.088760504
New York,6850,21519,482,608,820,1910,0.088758771
Philadelphia,19609,10354,293,310,316,919,0.088757968
Lexington,41385,507,19,13,13,45,0.088757396
Dayton,45388,845,32,22,21,75,0.088757396
San Francisco-Oak-San Jose,94596,21498,467,599,842,1908,0.088752442
Memphis,38024,26287,797,771,765,2333,0.088751094
Memphis,38015,2693,90,69,80,239,0.088748608
Dothan,36305,16778,522,514,453,1489,0.088747169
Charlotte,28075,24035,912,701,520,2133,0.088745579
Dallas-Ft. Worth,75032,39788,1489,1186,856,3531,0.08874535
Atlanta,30621,6795,270,194,139,603,0.088741722
"Alexandria, LA",71405,5578,160,163,172,495,0.088741484
Wichita-Hutchinson Plus,67841,293,10,8,8,26,0.088737201
Fresno-Visalia,93704,28614,816,833,890,2539,0.088732788
New York,7057,11946,291,317,452,1060,0.08873263
Rochestr-Mason City-Austin,50456,1668,46,53,49,148,0.088729017
Green Bay-Appleton,54155,8047,235,179,300,714,0.088728719
Houston,77474,15195,529,412,407,1348,0.088713393
"Columbus, OH",43773,2897,94,75,88,257,0.088712461
Boise,83709,63634,2082,1763,1800,5645,0.088710438
"Springfield, MO",65714,37290,1301,1069,938,3308,0.08871011
Charleston-Huntington,41631,744,23,17,26,66,0.088709677
Minneapolis-St. Paul,54762,1364,53,31,37,121,0.088709677
Bismarck-Mnt-Dcknsn(Wlstn),58756,248,8,7,7,22,0.088709677
Topeka,66614,30809,791,930,1012,2733,0.088707845
"Portland, OR",97302,42230,1201,1142,1403,3746,0.088704712
Wilmington,28433,4284,128,131,121,380,0.088702148
Atlanta,30269,40834,1500,1255,867,3622,0.088700593
"Lafayette, LA",70592,31691,1131,825,855,2811,0.088700262
Sioux Falls(Mitchell),57384,823,33,22,18,73,0.088699878
Amarillo,79031,1150,47,30,25,102,0.088695652
San Diego,91942,40803,866,1026,1727,3619,0.088694459
Meridian,39364,2582,90,75,64,229,0.088690937
Salt Lake City,84050,13237,559,371,244,1174,0.088690791
West Palm Beach-Ft. Pierce,34956,10362,343,302,274,919,0.088689442
Oklahoma City,73075,8953,288,274,232,794,0.088685357
Philadelphia,19610,16903,476,645,378,1499,0.088682482
Nashville,37134,2898,78,85,94,257,0.08868185
"Columbus, GA (Opelika, AL)",31808,9168,301,282,230,813,0.08867801
"Washington, DC (Hagrstwn)",20860,2075,69,70,45,184,0.088674699
Sacramnto-Stkton-Modesto,95818,24652,503,672,1011,2186,0.088674347
"Columbus, OH",43723,4466,134,122,140,396,0.088669951
Ft. Wayne,45851,609,25,17,12,54,0.088669951
Des Moines-Ames,50008,812,30,19,23,72,0.088669951
Tyler-Longview(Lfkn&Ncgd),75789,8278,276,241,217,734,0.088668761
Philadelphia,19312,11684,442,357,237,1036,0.088668264
Houston,77488,14357,475,401,397,1273,0.088667549
Minneapolis-St. Paul,55125,44358,1282,1371,1280,3933,0.088664953
"Washington, DC (Hagrstwn)",22734,3598,111,110,98,319,0.088660367
Savannah,29944,4320,148,130,105,383,0.088657407
Erie,16327,2583,78,91,60,229,0.088656601
Atlanta,30170,3429,116,96,92,304,0.088655585
Rockford,61115,21781,652,618,661,1931,0.08865525
Baltimore,21009,31347,935,896,948,2779,0.088652822
Knoxville,40831,4828,136,147,145,428,0.088649544
Atlanta,30521,5471,157,156,172,485,0.088649241
Indianapolis,46037,51781,2068,1461,1061,4590,0.088642552
"Portland, OR",98683,35694,967,1041,1156,3164,0.088642349
Milwaukee,53213,26590,590,791,976,2357,0.088642347
Atlanta,30224,26963,822,758,810,2390,0.088639988
Wichita-Hutchinson Plus,67074,1602,64,46,32,142,0.088639201
Houston,77568,19100,571,561,561,1693,0.088638743
Tulsa,74135,20860,471,627,751,1849,0.088638543
Huntsville-Decatur (Flor),35647,1241,41,35,34,110,0.088638195
Anchorage,99515,22135,683,631,648,1962,0.088637904
Houston,77434,4321,121,144,118,383,0.08863689
Harrisburg-Lncstr-Leb-York,17978,440,17,12,10,39,0.088636364
Atlanta,30076,44407,1239,1386,1311,3936,0.088634675
Greenvll-Spart-Ashevll-And,28726,3633,107,106,109,322,0.088631985
Detroit,48038,44217,938,1277,1704,3919,0.088631069
"Washington, DC (Hagrstwn)",20650,16621,599,460,414,1473,0.088622827
"Columbus, OH",43822,4728,164,140,115,419,0.088620981
St. Louis,62269,35556,1172,967,1012,3151,0.088620767
Atlanta,30567,8023,264,229,218,711,0.088620217
"Portland, OR",97031,20210,672,617,502,1791,0.088619495
St. Louis,62034,14478,454,369,460,1283,0.088617212
Oklahoma City,73566,1467,50,40,40,130,0.088616224
Mobile-Pensacola (Ft Walt),39476,7493,244,203,217,664,0.088616042
Los Angeles,92506,45152,1370,1309,1322,4001,0.0886118
Baltimore,21236,42895,1296,1216,1289,3801,0.088611726
Oklahoma City,73068,12967,449,351,349,1149,0.088609547
Myrtle Beach-Florence,29501,47636,1439,1306,1476,4221,0.088609455
Detroit,48430,39838,1217,1186,1127,3530,0.088608866
Harrisonburg,22821,6478,214,187,173,574,0.088607595
Charleston-Huntington,45619,7189,222,203,212,637,0.088607595
Cedar Rapids-Wtrlo-IWC&Dub,50607,395,17,10,8,35,0.088607595
Dallas-Ft. Worth,75437,1264,40,41,31,112,0.088607595
Detroit,48206,15755,417,454,525,1396,0.088606791
Indianapolis,46176,28859,832,825,900,2557,0.088603209
Birmingham (Ann and Tusc),35501,10440,299,307,319,925,0.088601533
Yakima-Pasco-Rchlnd-Knnwck,99337,34980,1222,1001,876,3099,0.088593482
Chicago,60954,6005,190,162,180,532,0.088592839
"Columbus, OH",43045,2156,85,62,44,191,0.088589981
Philadelphia,8109,23197,685,691,679,2055,0.088589042
"Albany, GA",31552,1253,42,38,31,111,0.08858739
Columbia-Jefferson City,65329,587,20,13,19,52,0.088586031
Austin,78750,28560,818,840,872,2530,0.088585434
Cleveland-Akron (Canton),44010,1716,56,63,33,152,0.088578089
"Portland, OR",98660,13717,270,390,555,1215,0.088576219
"Columbia, SC",29078,16754,574,472,438,1484,0.088575862
New Orleans,70116,10703,197,331,420,948,0.088573297
Atlanta,30230,9202,276,256,283,815,0.088567703
New York,7924,7994,251,279,178,708,0.088566425
Chicago,60176,11167,308,320,361,989,0.08856452
Tulsa,74365,4110,156,108,100,364,0.088564477
"Jackson, MS",39111,9304,298,268,258,824,0.088564058
Albuquerque-Santa Fe,87825,2868,107,75,72,254,0.088563459
Oklahoma City,73772,3602,126,100,93,319,0.08856191
Seattle-Tacoma,98118,49299,1167,1469,1730,4366,0.088561634
Salisbury,21864,542,17,15,16,48,0.088560886
Charleston-Huntington,41615,813,29,21,22,72,0.088560886
Indianapolis,46175,542,13,14,21,48,0.088560886
Atlanta,30187,9406,303,265,265,833,0.088560493
Buffalo,14225,35174,790,1013,1312,3115,0.088559732
Chicago,60707,41555,1112,1239,1329,3680,0.088557334
Wilmington,28320,7611,244,219,211,674,0.088556037
Evansville,42420,37005,1143,1133,1001,3277,0.088555601
Oklahoma City,73737,3591,133,99,86,318,0.08855472
Tallahassee-Thomasville,32351,16600,511,523,436,1470,0.088554217
Charleston-Huntington,45686,3241,111,96,80,287,0.088552916
Denver,80642,4359,139,131,116,386,0.08855242
Philadelphia,8046,31824,952,891,975,2818,0.088549522
Glendive,59330,8120,270,229,220,719,0.088546798
Ft. Smith-Fay-Sprngdl-Rgrs,72933,5037,194,135,117,446,0.088544769
Monroe-El Dorado,71334,7646,226,240,211,677,0.088543029
Ft. Smith-Fay-Sprngdl-Rgrs,74955,14050,454,432,358,1244,0.088540925
Boston (Manchester),2048,24012,711,702,713,2126,0.088539064
South Bend-Elkhart,49102,1265,45,35,32,112,0.088537549
Cleveland-Akron (Canton),44651,881,29,29,20,78,0.088535755
Flint-Saginaw-Bay City,48840,11905,317,357,380,1054,0.088534229
Richmond-Petersburg,23114,23720,838,712,550,2100,0.088532884
Cincinnati,45245,21823,502,701,729,1932,0.08853045
Grand Rapids-Kalmzoo-B.Crk,48851,2293,73,61,69,203,0.08853031
Atlanta,30577,22332,715,666,596,1977,0.088527673
New Orleans,70084,6405,199,182,186,567,0.08852459
Fresno-Visalia,93737,8145,289,208,224,721,0.088520565
Monroe-El Dorado,71441,723,23,24,17,64,0.088520055
Boston (Manchester),1752,42195,1045,1224,1466,3735,0.088517597
Los Angeles,90623,15162,442,437,463,1342,0.088510751
Cleveland-Akron (Canton),43006,644,23,20,14,57,0.088509317
St. Joseph,64506,22021,654,714,581,1949,0.088506426
Los Angeles,92883,38404,1345,1072,982,3399,0.088506406
"Lafayette, LA",71325,983,29,29,29,87,0.088504578
St. Louis,65565,5028,170,142,133,445,0.088504375
Erie,16509,27479,662,843,927,2432,0.088503948
Salisbury,21875,7446,217,228,214,659,0.088503895
Rockford,61012,2192,69,72,53,194,0.08850365
Atlanta,30161,36033,1092,1047,1050,3189,0.088502206
Detroit,48047,40124,1149,1227,1175,3551,0.088500648
Cincinnati,45102,25537,826,701,733,2260,0.088499041
Los Angeles,91789,39730,1112,1235,1169,3516,0.088497357
Tallahassee-Thomasville,31634,5616,185,170,142,497,0.088497151
Bismarck-Mnt-Dcknsn(Wlstn),58722,1808,59,55,46,160,0.088495575
New Orleans,70436,452,15,12,13,40,0.088495575
"Columbia, SC",29170,22928,673,654,702,2029,0.088494417
Tyler-Longview(Lfkn&Ncgd),75681,2520,82,71,70,223,0.088492063
Biloxi-Gulfport,39564,43394,1435,1277,1128,3840,0.088491497
Birmingham (Ann and Tusc),35406,20183,703,582,501,1786,0.088490314
Atlanta,30258,3006,99,86,81,266,0.088489687
New York,6883,10069,435,289,167,891,0.088489423
Twin Falls,83341,9538,387,276,181,844,0.088488153
Chicago,61301,10702,301,307,339,947,0.088488133
Grand Rapids-Kalmzoo-B.Crk,49002,19404,551,530,636,1717,0.08848691
Nashville,38481,938,30,28,25,83,0.088486141
"Portland, OR",97223,50867,1282,1439,1780,4501,0.088485659
Indianapolis,46168,40777,1278,1173,1157,3608,0.088481252
Shreveport,71851,1797,51,54,54,159,0.088480801
Ft. Wayne,46845,30120,1091,876,698,2665,0.088479416
Louisville,47223,1458,50,45,34,129,0.088477366
Albany-Schenectady-Troy,12144,20661,546,583,699,1828,0.088475872
Monroe-El Dorado,71225,7867,257,218,221,696,0.088470828
Lubbock,79339,6703,235,171,187,593,0.08846785
"Albany, GA",31765,2532,81,82,61,224,0.088467615
Seattle-Tacoma,98802,34500,1126,1015,911,3052,0.088463768
"Columbus, GA (Opelika, AL)",36801,26576,740,744,867,2351,0.088463275
Cedar Rapids-Wtrlo-IWC&Dub,52359,260,9,8,6,23,0.088461538
Chico-Redding,95920,260,9,9,5,23,0.088461538
Baton Rouge,70711,5709,200,155,150,505,0.088456823
New York,7836,12300,373,350,365,1088,0.088455285
"Washington, DC (Hagrstwn)",20197,2555,97,81,48,226,0.088454012
Jonesboro,72411,2770,85,79,81,245,0.088447653
Chicago,60188,42206,1130,1222,1381,3733,0.08844714
Joplin-Pittsburg,66713,5201,172,163,125,460,0.08844453
Macon,31022,1549,48,49,40,137,0.088444158
Columbia-Jefferson City,65035,1549,61,41,35,137,0.088444158
Sherman-Ada,73401,36453,1132,1050,1042,3224,0.088442652
Johnstown-Altoona-St Colge,15711,441,16,11,12,39,0.088435374
Salt Lake City,84061,441,17,12,10,39,0.088435374
Boise,83646,78513,3002,2167,1774,6943,0.088431215
Dallas-Ft. Worth,75035,96966,4060,2647,1867,8574,0.088422746
Los Angeles,90755,11185,286,321,382,989,0.088421994
Tulsa,74137,28364,893,860,755,2508,0.088421943
San Francisco-Oak-San Jose,94580,29066,751,862,957,2570,0.088419459
"Columbus, OH",43748,2556,92,60,74,226,0.088419405
Greenvll-Spart-Ashevll-And,29680,38397,1178,1091,1126,3395,0.088418366
Sioux Falls(Mitchell),57350,16592,523,453,491,1467,0.088416104
"Washington, DC (Hagrstwn)",20615,328,11,10,8,29,0.088414634
Great Falls,59225,656,26,16,16,58,0.088414634
Dallas-Ft. Worth,76250,837,32,23,19,74,0.088410992
Louisville,40065,34103,1057,989,969,3015,0.088408644
Salt Lake City,84053,509,22,13,10,45,0.088408644
Seattle-Tacoma,98039,2907,114,104,39,257,0.088407293
Charlotte,29732,62213,1802,1801,1897,5500,0.08840596
Cincinnati,45120,3337,105,93,97,295,0.088402757
New York,6855,8914,217,280,291,788,0.088400269
Macon,31082,10159,345,307,246,898,0.088394527
Raleigh-Durham (Fayetvlle),28356,5634,194,165,139,498,0.088391906
Shreveport,75605,34066,925,989,1097,3011,0.088387248
Raleigh-Durham (Fayetvlle),27807,7603,245,218,209,672,0.088386163
"Springfield, MO",65706,16315,533,469,440,1442,0.088384922
"Jackson, TN",38351,17741,571,514,483,1568,0.088382842
Charlotte,28117,53360,1703,1578,1435,4716,0.08838081
Minneapolis-St. Paul,55315,6755,262,200,135,597,0.088378979
Los Angeles,93516,2048,74,61,46,181,0.088378906
Birmingham (Ann and Tusc),36203,18930,554,566,553,1673,0.088378236
"Washington, DC (Hagrstwn)",20165,34545,1073,1008,972,3053,0.088377479
Minneapolis-St. Paul,55054,2693,111,70,57,238,0.088377274
"Washington, DC (Hagrstwn)",17228,1041,40,29,23,92,0.088376561
"Lafayette, LA",70548,9471,346,254,237,837,0.08837504
Knoxville,40958,430,14,17,7,38,0.088372093
Madison,53545,23504,683,657,737,2077,0.088367937
Idaho Fals-Pocatllo(Jcksn),83001,18299,441,483,693,1617,0.088365484
"Portland, OR",97127,4753,166,116,138,420,0.088365243
Tallahassee-Thomasville,31648,928,32,26,24,82,0.088362069
Baton Rouge,70346,10457,325,304,295,924,0.088361863
Raleigh-Durham (Fayetvlle),27332,37279,1217,1026,1051,3294,0.088360739
Chicago,60401,8002,255,232,220,707,0.088352912
Seattle-Tacoma,98052,83261,1864,2250,3242,7356,0.088348687
Lincoln & Hastings-Krny,68870,566,22,18,10,50,0.088339223
Macon,31065,883,27,28,23,78,0.088335221
Lexington,42603,600,22,17,14,53,0.088333333
Cincinnati,47224,600,24,14,15,53,0.088333333
Sherman-Ada,74726,2400,72,72,68,212,0.088333333
Colorado Springs-Pueblo,80930,917,28,26,27,81,0.088331516
Pittsburgh,15136,24261,637,718,788,2143,0.088331066
Greenvll-Spart-Ashevll-And,28779,17593,434,493,627,1554,0.088330586
Memphis,38135,28894,924,842,786,2552,0.088322835
Wilkes Barre-Scranton-Hztn,18202,14515,379,439,464,1282,0.088322425
Philadelphia,19962,13632,453,383,368,1204,0.088321596
Erie,16111,1370,51,34,36,121,0.088321168
Duluth-Superior,55720,17448,593,497,451,1541,0.088319578
Mobile-Pensacola (Ft Walt),36539,702,19,21,22,62,0.088319088
Memphis,72396,12591,421,354,337,1112,0.088317052
Greenwood-Greenville,38954,1087,32,35,29,96,0.088316467
New York,10992,9081,278,275,249,802,0.088316265
Paducah-Cape Girard-Harsbg,63876,1993,60,55,61,176,0.088309082
Charleston-Huntington,45653,4020,136,119,100,355,0.088308458
Youngstown,44405,8108,221,256,239,716,0.088307844
Salt Lake City,84014,16771,596,471,414,1481,0.088307197
"Columbus, OH",43345,838,33,21,20,74,0.088305489
Tampa-St. Pete (Sarasota),33604,38107,1050,1070,1245,3365,0.088303986
"Charleston, SC",29488,21868,704,617,610,1931,0.088302543
New York,7734,12763,342,376,409,1127,0.088302123
Milwaukee,53128,9083,294,257,251,802,0.088296818
Harrisburg-Lncstr-Leb-York,17547,9117,240,284,281,805,0.088296589
Sioux Falls(Mitchell),57046,487,18,15,10,43,0.088295688
Austin,78736,9922,215,267,394,876,0.088288651
Sioux Falls(Mitchell),57072,589,22,19,11,52,0.088285229
Mobile-Pensacola (Ft Walt),36572,6819,222,206,174,602,0.088282739
Bluefield-Beckley-Oak Hill,24739,13174,402,400,361,1163,0.088279945
Detroit,48135,26813,657,793,917,2367,0.088278074
Fargo,56575,691,30,14,17,61,0.088277858
Myrtle Beach-Florence,29579,58532,1677,1743,1747,5167,0.088276498
Columbus-Tupelo-West Point,38857,3761,119,114,99,332,0.088274395
New York,12518,5279,157,168,141,466,0.088274294
Los Angeles,91010,25977,672,784,837,2293,0.088270393
Detroit,48093,24755,627,704,854,2185,0.088264997
New York,8805,14151,402,405,442,1249,0.088262314
Cleveland-Akron (Canton),44135,25583,730,736,792,2258,0.088261736
Phoenix (Prescott),85048,35044,1100,1036,957,3093,0.088260473
Albuquerque-Santa Fe,87013,3705,117,115,95,327,0.088259109
Sacramnto-Stkton-Modesto,95612,1235,34,39,36,109,0.088259109
New York,11693,11387,309,364,332,1005,0.08825854
"Jackson, MS",39071,5926,187,163,173,523,0.088255147
Jacksonville,32225,55691,1479,1541,1895,4915,0.088254835
Lexington,40972,1507,53,42,38,133,0.088254811
Indianapolis,46901,38345,1130,1134,1120,3384,0.088251402
"Washington, DC (Hagrstwn)",20132,18890,688,604,375,1667,0.08824775
Chicago,60465,17791,550,495,525,1570,0.088246866
Las Vegas,89015,42778,1260,1268,1247,3775,0.088246295
Tampa-St. Pete (Sarasota),33558,31730,1183,918,699,2800,0.088244564
Binghamton,13795,3479,85,117,105,307,0.088243748
Norfolk-Portsmth-Newpt Nws,23320,61924,1489,1786,2189,5464,0.088237194
Burlington-Plattsburgh,5073,34,1,1,1,3,0.088235294
Harrisburg-Lncstr-Leb-York,17576,136,3,4,5,12,0.088235294
Norfolk-Portsmth-Newpt Nws,23409,102,3,3,3,9,0.088235294
Hattiesburg-Laurel,39348,544,20,14,14,48,0.088235294
Ft. Wayne,46940,2550,106,74,45,225,0.088235294
Des Moines-Ames,50137,34,1,1,1,3,0.088235294
Cedar Rapids-Wtrlo-IWC&Dub,52346,1088,39,29,28,96,0.088235294
Sioux Falls(Mitchell),56146,34,1,1,1,3,0.088235294
Bismarck-Mnt-Dcknsn(Wlstn),58713,34,1,1,1,3,0.088235294
Ottumwa-Kirksville,63544,782,29,24,16,69,0.088235294
Kansas City,65332,1530,56,40,39,135,0.088235294
Monroe-El Dorado,71425,238,8,8,5,21,0.088235294
Ft. Smith-Fay-Sprngdl-Rgrs,74931,1768,61,51,44,156,0.088235294
Dallas-Ft. Worth,75481,408,14,13,9,36,0.088235294
Amarillo,79042,1122,45,29,25,99,0.088235294
Orlando-Daytona Bch-Melbrn,32746,43261,1229,1251,1337,3817,0.088231895
Macon,31021,29661,883,872,862,2617,0.088230336
Pittsburgh,15367,9498,375,291,172,838,0.088229101
Boston (Manchester),2129,18430,281,445,900,1626,0.088225719
Paducah-Cape Girard-Harsbg,62884,2947,90,87,83,260,0.088225314
"Columbus, OH",43731,5044,157,144,144,445,0.088223632
Greenvll-Spart-Ashevll-And,29627,19315,624,514,566,1704,0.088221589
Terre Haute,47804,9635,252,289,309,850,0.088220031
Philadelphia,19608,25075,783,786,643,2212,0.088215354
Lexington,40356,46659,1567,1299,1250,4116,0.088214492
Bangor,4969,1383,37,38,47,122,0.088214027
Norfolk-Portsmth-Newpt Nws,23693,23942,836,712,564,2112,0.088213182
West Palm Beach-Ft. Pierce,33426,25960,526,722,1042,2290,0.088212635
Chicago,60106,19794,593,588,565,1746,0.088208548
Chicago,46392,8276,288,246,196,730,0.088206863
Denver,80836,1009,39,29,21,89,0.088206145
Tampa-St. Pete (Sarasota),33545,34159,1216,945,852,3013,0.088205158
Miami-Ft. Lauderdale,33064,62162,1725,1830,1928,5483,0.088205013
St. Louis,63630,4127,139,121,104,364,0.088199661
Cincinnati,41097,7563,251,220,196,667,0.088192516
Syracuse,13135,5783,165,183,162,510,0.088189521
Dallas-Ft. Worth,75135,11385,405,314,285,1004,0.08818621
Los Angeles,93065,72496,2165,2171,2057,6393,0.088184176
Philadelphia,19365,8539,267,252,234,753,0.088183628
New Orleans,70444,9673,328,284,241,853,0.088183604
Detroit,48092,27250,705,790,908,2403,0.088183486
Rockford,61111,22466,599,644,738,1981,0.088177691
Savannah,31510,9946,334,298,245,877,0.088176151
Detroit,48307,45218,1295,1361,1331,3987,0.088172852
Kansas City,64479,896,29,26,24,79,0.088169643
Topeka,66531,1327,47,43,27,117,0.088168802
Richmond-Petersburg,23228,36521,829,1000,1391,3220,0.088168451
Macon,31031,5671,189,168,143,500,0.088167872
Kansas City,64119,32064,876,907,1044,2827,0.088167415
Johnstown-Altoona-St Colge,16673,5263,166,150,148,464,0.088162645
Nashville,37066,68034,1983,1881,2134,5998,0.088161801
Philadelphia,19126,15982,489,440,480,1409,0.088161682
"Columbus, GA (Opelika, AL)",31811,6386,224,185,154,563,0.088161604
Salt Lake City,84017,4662,173,123,115,411,0.088159588
St. Louis,63070,7748,243,225,215,683,0.088151781
Twin Falls,83325,987,40,28,19,87,0.088145897
Detroit,48230,17369,481,577,473,1531,0.088145547
San Antonio,78255,19775,711,570,462,1743,0.088141593
Charlotte,28112,27468,852,796,773,2421,0.088138925
Pittsburgh,15145,6887,172,209,226,607,0.08813707
Detroit,48314,21739,529,623,764,1916,0.088136529
Portland-Auburn,4210,24689,718,759,699,2176,0.088136417
Lexington,40353,22636,707,612,676,1995,0.088133946
Norfolk-Portsmth-Newpt Nws,23415,2031,58,62,59,179,0.088133924
New York,11239,18699,525,565,558,1648,0.088133055
Green Bay-Appleton,54952,27300,784,790,832,2406,0.088131868
Memphis,38063,15795,473,492,427,1392,0.088129155
Evansville,42410,1339,46,37,35,118,0.088125467
Montgomery-Selma,36108,16545,497,476,485,1458,0.0881233
Albuquerque-Santa Fe,88267,1044,33,35,24,92,0.088122605
Casper-Riverton,82520,12994,495,383,267,1145,0.088117593
Birmingham (Ann and Tusc),35061,1237,36,36,37,109,0.088116411
Paducah-Cape Girard-Harsbg,42066,22709,763,638,600,2001,0.088114844
Boise,83703,17966,448,550,585,1583,0.088110876
New Orleans,70067,2690,84,81,72,237,0.088104089
Elmira (Corning),14903,7389,229,208,214,651,0.088103938
Los Angeles,93010,45685,1240,1331,1454,4025,0.088103316
Birmingham (Ann and Tusc),36091,3689,116,109,100,325,0.088099756
"Lafayette, LA",70544,10579,334,318,280,932,0.088099064
New York,7934,1941,75,60,36,171,0.088098918
Rockford,61088,5982,213,172,142,527,0.088097626
St. Louis,62002,29456,829,862,904,2595,0.088097501
St. Louis,63660,3712,125,104,98,327,0.088092672
Meridian,39092,2838,100,83,67,250,0.088090204
Billings,82431,3928,145,113,88,346,0.08808554
"Portland, OR",97304,35738,1069,1060,1019,3148,0.088085511
Austin,78652,7050,164,183,274,621,0.088085106
Sioux Falls(Mitchell),57039,4087,146,129,85,360,0.088084169
Louisville,40117,2702,91,78,69,238,0.088082902
San Francisco-Oak-San Jose,94014,50522,1228,1436,1786,4450,0.08808044
"Columbus, GA (Opelika, AL)",36804,22139,715,612,623,1950,0.088079859
Lexington,40472,1510,48,44,41,133,0.08807947
Dayton,45415,12591,341,389,379,1109,0.088078786
Los Angeles,93004,31791,938,965,897,2800,0.088075241
Minneapolis-St. Paul,55313,25331,875,781,575,2231,0.088073902
Johnstown-Altoona-St Colge,16664,2146,84,56,49,189,0.088070829
North Platte,69167,352,8,13,10,31,0.088068182
Sherman-Ada,74743,8187,238,247,236,721,0.088066447
Houston,77534,3100,115,91,67,273,0.088064516
Des Moines-Ames,50544,511,20,13,12,45,0.088062622
"Lafayette, LA",70577,4406,152,117,119,388,0.088061734
Greenvll-Spart-Ashevll-And,30557,5678,167,166,167,500,0.088059176
Nashville,37027,64927,2398,1885,1434,5717,0.088052736
Waco-Temple-Bryan,76630,1431,52,37,37,126,0.088050314
Idaho Fals-Pocatllo(Jcksn),83212,159,7,5,2,14,0.088050314
Champaign&Sprngfld-Decatur,62615,5338,176,168,126,470,0.088047958
Bluefield-Beckley-Oak Hill,24605,8348,258,275,202,735,0.088045041
New Orleans,70427,17071,533,500,470,1503,0.088044051
"Charleston, SC",29426,1522,48,48,38,134,0.08804205
Philadelphia,19021,9950,296,271,309,876,0.088040201
Detroit,48073,32531,562,927,1375,2864,0.088039101
Augusta-Aiken,29841,33508,971,929,1050,2950,0.088038677
San Antonio,78827,886,35,25,18,78,0.088036117
Syracuse,13211,6293,159,182,213,554,0.088034324
Kansas City,66217,4964,126,120,191,437,0.088033844
Salisbury,21851,7498,238,229,193,660,0.088023473
New York,11542,31288,815,972,967,2754,0.088020967
Tulsa,74421,4874,172,140,117,429,0.088018055
Cleveland-Akron (Canton),44077,58843,1750,1767,1662,5179,0.088013867
Savannah,31513,16225,571,458,399,1428,0.088012327
"Albany, GA",31714,6613,216,184,182,582,0.088008468
Sioux City,51039,2568,94,68,64,226,0.088006231
Philadelphia,19061,20135,562,561,649,1772,0.08800596
Wheeling-Steubenville,43935,7761,211,239,233,683,0.088004123
New York,18324,9795,293,307,262,862,0.088004084
New York,10463,69406,1756,2106,2246,6108,0.088003919
Miami-Ft. Lauderdale,33157,67895,2017,2049,1909,5975,0.088003535
Watertown,13656,2909,103,79,74,256,0.08800275
Los Angeles,91006,31863,920,1010,874,2804,0.088001758
San Francisco-Oak-San Jose,94089,23295,400,580,1070,2050,0.088001717
Corpus Christi,78075,125,5,3,3,11,0.088
Twin Falls,83321,250,8,7,7,22,0.088
Chicago,60071,3841,104,112,122,338,0.087997917
Wichita-Hutchinson Plus,67146,1716,72,45,34,151,0.087995338
Abilene-Sweetwater,79545,1716,75,43,33,151,0.087995338
Shreveport,75558,1466,50,47,32,129,0.087994543
Savannah,31309,966,30,26,29,85,0.087991718
Wheeling-Steubenville,26377,466,15,12,14,41,0.087982833
Waco-Temple-Bryan,76527,5342,175,152,143,470,0.087982029
Springfield-Holyoke,1349,807,24,20,27,71,0.087980173
Tulsa,74015,8877,287,272,222,781,0.087980173
"Washington, DC (Hagrstwn)",20774,52584,1428,1527,1671,4626,0.087973528
Shreveport,71073,2012,57,64,56,177,0.087972167
Wilkes Barre-Scranton-Hztn,18840,10458,316,303,301,920,0.087970931
Charleston-Huntington,45692,8310,268,245,218,731,0.087966306
Raleigh-Durham (Fayetvlle),27597,32388,1066,902,881,2849,0.087964678
New York,10954,23464,685,686,693,2064,0.087964541
Little Rock-Pine Bluff,72227,11357,275,336,388,999,0.087963371
Huntsville-Decatur (Flor),35614,8640,252,254,254,760,0.087962963
Dallas-Ft. Worth,75028,48591,1688,1465,1121,4274,0.087958675
Memphis,38651,8584,288,242,225,755,0.087954334
Norfolk-Portsmth-Newpt Nws,27974,1046,29,31,32,92,0.087954111
Wilkes Barre-Scranton-Hztn,18237,3968,112,114,123,349,0.087953629
Waco-Temple-Bryan,76643,15008,495,407,418,1320,0.087953092
Minneapolis-St. Paul,55353,3195,106,88,87,281,0.087949922
Corpus Christi,78368,8630,288,246,225,759,0.087949015
Flint-Saginaw-Bay City,48732,10961,308,318,338,964,0.08794818
Atlanta,30087,37956,1114,1093,1131,3338,0.087943935
Detroit,48213,19001,561,554,556,1671,0.08794274
Tampa-St. Pete (Sarasota),34638,39129,1419,1103,919,3441,0.087939891
Kansas City,64674,398,14,10,11,35,0.087939698
Savannah,30439,10314,351,280,276,907,0.087938724
"Lafayette, LA",70750,1285,29,39,45,113,0.087937743
Mobile-Pensacola (Ft Walt),36545,8472,249,260,236,745,0.087936733
Greenwood-Greenville,38769,1865,53,59,52,164,0.087935657
Indianapolis,46052,23597,677,703,695,2075,0.087934907
New York,10024,59557,1158,1473,2606,5237,0.087932569
Knoxville,37755,3446,121,99,83,303,0.087928033
Des Moines-Ames,50124,4970,185,134,118,437,0.087927565
Dallas-Ft. Worth,75158,4993,175,134,130,439,0.087923092
Bowling Green,42713,2127,67,66,54,187,0.087917254
St. Louis,63040,8690,328,259,177,764,0.087917146
Louisville,40004,30825,928,864,918,2710,0.087915653
Philadelphia,19701,44270,1292,1275,1325,3892,0.087915067
Peoria-Bloomington,61479,91,3,2,3,8,0.087912088
Joplin-Pittsburg,66714,182,8,4,4,16,0.087912088
Los Angeles,90008,31261,781,906,1061,2748,0.087905057
San Antonio,78232,34231,876,970,1163,3009,0.087902778
Columbus-Tupelo-West Point,39361,1149,33,35,33,101,0.087902524
Toledo,43517,3686,127,106,91,324,0.087900163
"Springfield, MO",65775,25348,780,727,721,2228,0.087896481
Shreveport,71037,21537,753,579,561,1893,0.08789525
Ft. Myers-Naples,33909,38433,1234,1076,1068,3378,0.087893217
"Lafayette, LA",70525,12811,428,359,339,1126,0.087893217
Monroe-El Dorado,71259,1718,57,47,47,151,0.087892899
San Francisco-Oak-San Jose,94121,40595,694,1158,1716,3568,0.087892598
Greensboro-H.Point-W.Salem,27317,17522,548,505,487,1540,0.08788951
Raleigh-Durham (Fayetvlle),28339,7134,216,196,215,627,0.087888982
Denver,80807,4119,133,117,112,362,0.087885409
Roanoke-Lynchburg,24012,30405,841,839,992,2672,0.087880283
Clarksburg-Weston,26257,899,27,20,32,79,0.087875417
Birmingham (Ann and Tusc),36765,899,29,25,25,79,0.087875417
Tampa-St. Pete (Sarasota),33596,29747,1068,882,664,2614,0.087874408
Indianapolis,47393,1525,56,40,38,134,0.087868852
"Springfield, MO",65548,5679,184,161,154,499,0.087867582
New York,7601,49281,1096,1466,1768,4330,0.087863477
New York,11746,69882,2104,2090,1946,6140,0.087862397
St. Louis,63373,626,20,15,20,55,0.087859425
Jacksonville,32217,19964,533,595,626,1754,0.087858145
Los Angeles,92821,42216,1169,1202,1338,3709,0.087857684
Syracuse,13334,1161,45,30,27,102,0.087855297
Bluefield-Beckley-Oak Hill,24827,387,13,10,11,34,0.087855297
"Jackson, MS",39095,6124,188,184,166,538,0.087851078
Seattle-Tacoma,98271,33170,970,907,1037,2914,0.087850467
Paducah-Cape Girard-Harsbg,38261,16517,511,504,436,1451,0.087848883
Chicago,60014,47946,1528,1381,1303,4212,0.08784883
"Columbia, SC",29073,52147,1751,1426,1404,4581,0.087847815
Greenvll-Spart-Ashevll-And,28708,683,19,17,24,60,0.087847731
Indianapolis,46947,28197,932,808,737,2477,0.087846225
Elmira (Corning),14801,5134,185,136,130,451,0.087845734
Toledo,45841,979,37,21,28,86,0.08784474
San Antonio,78260,41335,1680,1133,818,3631,0.087843232
New York,7109,38570,931,1119,1338,3388,0.08784029
New York,8812,14777,445,439,414,1298,0.08783921
Utica,13454,592,21,16,15,52,0.087837838
Paducah-Cape Girard-Harsbg,62956,740,25,24,16,65,0.087837838
Lake Charles,70662,444,15,12,12,39,0.087837838
Dallas-Ft. Worth,75452,5385,176,163,134,473,0.087836583
Ft. Wayne,46788,3609,123,108,86,317,0.087835966
Birmingham (Ann and Tusc),35044,7241,218,211,207,636,0.087833172
Ft. Smith-Fay-Sprngdl-Rgrs,74932,2186,72,65,55,192,0.087831656
Johnstown-Altoona-St Colge,16617,2596,77,69,82,228,0.087827427
Ft. Wayne,43512,27907,844,854,753,2451,0.087827427
Columbus-Tupelo-West Point,35592,4452,148,118,125,391,0.087825696
Detroit,48101,27774,754,808,877,2439,0.087815943
Cincinnati,47022,3291,110,91,88,289,0.087815254
Los Angeles,93505,14451,506,374,389,1269,0.087813992
Augusta-Aiken,29812,11001,364,329,273,966,0.087810199
Birmingham (Ann and Tusc),35172,3109,95,92,86,273,0.087809585
El Paso (Las Cruces),88007,26752,857,768,724,2349,0.087806519
Albany-Schenectady-Troy,12182,14020,354,425,452,1231,0.087803138
Grand Rapids-Kalmzoo-B.Crk,49030,2722,92,75,72,239,0.087803086
Flint-Saginaw-Bay City,48708,25536,699,744,799,2242,0.087797619
Philadelphia,19946,5342,157,153,159,469,0.087794833
Birmingham (Ann and Tusc),35221,3964,132,111,105,348,0.087790111
Indianapolis,46035,991,37,24,26,87,0.087790111
Youngstown,44485,15503,451,463,447,1361,0.08778946
Raleigh-Durham (Fayetvlle),27569,9204,306,264,238,808,0.087787918
Greenvll-Spart-Ashevll-And,29654,10047,319,276,287,882,0.087787399
Charlotte,28277,76529,2585,2211,1922,6718,0.087783716
Knoxville,42649,2210,73,68,53,194,0.087782805
Rochestr-Mason City-Austin,55944,8020,287,224,193,704,0.087780549
Buffalo,14723,1162,44,31,27,102,0.08777969
South Bend-Elkhart,46563,23149,745,685,602,2032,0.08777917
Flint-Saginaw-Bay City,48532,18388,505,517,592,1614,0.087774636
San Francisco-Oak-San Jose,94572,9513,286,291,258,835,0.087774624
Memphis,38949,319,9,11,8,28,0.087774295
Louisville,41008,7565,244,200,220,664,0.087772637
Denver,81601,17386,539,516,471,1526,0.08777177
Dallas-Ft. Worth,75462,12852,393,381,354,1128,0.087768441
Minneapolis-St. Paul,56157,752,27,20,19,66,0.087765957
Wichita-Hutchinson Plus,67581,376,15,11,7,33,0.087765957
Salt Lake City,84631,3122,128,74,72,274,0.087764254
"Charleston, SC",29556,11064,350,329,292,971,0.087762111
Dallas-Ft. Worth,75496,3373,120,103,73,296,0.087755707
"Springfield, MO",65740,3658,109,113,99,321,0.08775287
Providence-New Bedford,2745,25629,727,724,798,2249,0.087752156
Memphis,38040,4809,164,129,129,422,0.087752131
Yakima-Pasco-Rchlnd-Knnwck,97882,8638,263,256,239,758,0.087751794
Bluefield-Beckley-Oak Hill,24736,547,15,16,17,48,0.087751371
Dallas-Ft. Worth,76248,41390,1576,1274,782,3632,0.087750664
Sioux Falls(Mitchell),57071,3453,113,94,96,303,0.087749783
Dallas-Ft. Worth,75071,85710,3084,2388,2049,7521,0.087749387
Seattle-Tacoma,98498,30007,729,863,1041,2633,0.087746193
Davenport-R.Island-Moline,61362,5539,192,165,129,486,0.08774147
Indianapolis,47339,832,33,24,16,73,0.087740385
Philadelphia,19551,4901,168,132,130,430,0.087737196
Myrtle Beach-Florence,29592,1060,34,32,27,93,0.087735849
Wilmington,28455,1573,49,44,45,138,0.087730451
Orlando-Daytona Bch-Melbrn,32827,23187,810,603,621,2034,0.087721568
Binghamton,13903,17396,431,507,588,1526,0.087721315
Charlotte,28629,57,2,1,2,5,0.087719298
Indianapolis,46961,57,2,2,1,5,0.087719298
Chicago,60437,171,5,5,5,15,0.087719298
Topeka,66526,741,22,21,22,65,0.087719298
Abilene-Sweetwater,79539,171,7,5,3,15,0.087719298
Twin Falls,83349,1083,43,33,19,95,0.087719298
Dallas-Ft. Worth,76118,16405,509,470,460,1439,0.087717159
Las Vegas,89074,53526,1287,1571,1837,4695,0.087714382
Atlanta,30549,32036,1178,914,718,2810,0.087713822
Lexington,40744,20111,638,568,558,1764,0.087713192
Flint-Saginaw-Bay City,48866,4720,150,132,132,414,0.087711864
Sioux Falls(Mitchell),57501,17193,503,479,526,1508,0.087710115
"Columbus, GA (Opelika, AL)",31820,14115,474,404,360,1238,0.087708112
Harrisburg-Lncstr-Leb-York,17244,2782,91,76,77,244,0.087706686
New York,7458,12280,471,369,237,1077,0.087703583
New York,10917,1870,53,54,57,164,0.087700535
Albany-Schenectady-Troy,12801,14846,361,431,510,1302,0.087700391
Jonesboro,72437,3512,111,81,116,308,0.087699317
Nashville,37205,24003,550,766,789,2105,0.087697371
Champaign&Sprngfld-Decatur,62702,33365,904,988,1034,2926,0.087696688
Sioux Falls(Mitchell),57368,1243,59,27,23,109,0.08769107
Paducah-Cape Girard-Harsbg,62883,593,16,20,16,52,0.087689713
Indianapolis,46044,2794,99,79,67,245,0.087687903
Greensboro-H.Point-W.Salem,27263,21702,665,592,646,1903,0.087687771
Quincy-Hannibal-Keokuk,62340,1551,48,50,38,136,0.087685364
Norfolk-Portsmth-Newpt Nws,23464,73742,2103,2088,2275,6466,0.087684088
"Jackson, MS",39044,3718,129,109,88,326,0.087681549
Shreveport,71275,2224,67,65,63,195,0.087679856
Orlando-Daytona Bch-Melbrn,34480,24921,816,714,655,2185,0.08767706
Memphis,38659,2475,89,66,62,217,0.087676768
Fargo,56701,12683,376,371,365,1112,0.087676417
Des Moines-Ames,50313,17314,492,505,521,1518,0.087674714
Montgomery-Selma,36109,23496,705,659,696,2060,0.087674498
"Jackson, TN",38220,1882,54,61,50,165,0.087672689
Meridian,39352,730,19,26,19,64,0.087671233
Salisbury,21869,1038,33,25,33,91,0.087668593
Wichita-Hutchinson Plus,67416,1038,40,27,24,91,0.087668593
St. Louis,62208,16745,434,470,564,1468,0.087667961
Cleveland-Akron (Canton),44833,16643,510,498,451,1459,0.087664484
Nashville,38401,68891,2009,1996,2034,6039,0.087660217
Charleston-Huntington,25181,1175,37,34,32,103,0.087659574
Myrtle Beach-Florence,29591,4700,154,132,126,412,0.087659574
Milwaukee,53585,2179,79,65,47,191,0.087654888
"Jackson, MS",39066,3799,108,115,110,333,0.087654646
Boston (Manchester),1510,15733,390,442,547,1379,0.087650162
Miami-Ft. Lauderdale,33020,46744,1107,1361,1629,4097,0.087647613
Greensboro-H.Point-W.Salem,27017,8808,264,251,257,772,0.087647593
Syracuse,13074,4153,140,118,106,364,0.087647484
Huntsville-Decatur (Flor),35611,29232,828,839,895,2562,0.087643678
Harrisburg-Lncstr-Leb-York,17025,18541,549,546,530,1625,0.087643601
New York,11229,81592,2234,2383,2534,7151,0.087643396
Birmingham (Ann and Tusc),35903,17172,499,512,494,1505,0.087642674
Minneapolis-St. Paul,56048,4256,146,131,96,373,0.087640977
Burlington-Plattsburgh,5346,5146,166,187,98,451,0.087640886
Baltimore,20711,7371,257,216,173,646,0.087640754
Greensboro-H.Point-W.Salem,27356,3115,101,90,82,273,0.087640449
Dallas-Ft. Worth,76690,1529,48,40,46,134,0.08763898
Hattiesburg-Laurel,39480,2305,81,68,53,202,0.087635575
New York,12520,3275,107,99,81,287,0.087633588
Raleigh-Durham (Fayetvlle),27573,10624,300,319,312,931,0.087631777
"Tri-Cities, TN-VA",24273,5603,164,182,145,491,0.087631626
Cleveland-Akron (Canton),44092,16752,415,462,591,1468,0.087631328
San Antonio,78059,6128,197,164,176,537,0.087630548
New York,12738,194,7,4,6,17,0.087628866
Nashville,38483,6402,202,192,167,561,0.087628866
Wilkes Barre-Scranton-Hztn,17954,4599,142,126,135,403,0.087627745
Lexington,40380,7087,228,209,184,621,0.087625229
Chicago,60408,5592,154,163,173,490,0.087625179
"Columbus, OH",45647,2408,73,71,67,211,0.087624585
Yakima-Pasco-Rchlnd-Knnwck,98952,2214,75,66,53,194,0.08762421
New York,11510,34593,937,1035,1059,3031,0.087618882
Reno,89445,17291,577,454,484,1515,0.087617836
San Diego,92118,17622,537,629,378,1544,0.087617751
Los Angeles,92887,19711,602,624,501,1727,0.087616052
Chicago,60457,14050,392,418,421,1231,0.087615658
Shreveport,71049,3173,95,103,80,278,0.087614245
Nashville,42134,19746,588,563,579,1730,0.087612681
Cincinnati,45233,16208,542,488,390,1420,0.087611056
Grand Rapids-Kalmzoo-B.Crk,49333,13834,457,399,356,1212,0.087610236
New York,7901,23001,823,673,519,2015,0.087604887
Seattle-Tacoma,98188,26871,628,802,924,2354,0.087603736
Salt Lake City,84021,3299,139,96,54,289,0.087602304
Mobile-Pensacola (Ft Walt),36613,12123,348,385,329,1062,0.087602079
La Crosse-Eau Claire,54659,1347,51,30,37,118,0.087602079
Kansas City,66109,25845,846,693,725,2264,0.087599149
South Bend-Elkhart,49107,9886,296,282,288,866,0.087598624
Corpus Christi,78418,32810,1026,1018,830,2874,0.087595245
Louisville,40010,548,19,19,10,48,0.087591241
Detroit,48214,19067,379,520,771,1670,0.087585881
New York,10309,33476,954,1005,973,2932,0.087585136
"Rochester, NY",13143,2706,85,77,75,237,0.087583149
Baton Rouge,70752,902,27,29,23,79,0.087583149
Traverse City-Cadillac,49715,3140,85,94,96,275,0.087579618
Joplin-Pittsburg,64844,4339,137,112,131,380,0.087577783
Syracuse,13088,22781,512,616,867,1995,0.087572977
Nashville,38563,2478,83,71,63,217,0.087570621
Rockford,61011,2992,92,96,74,262,0.087566845
Montgomery-Selma,36732,7937,252,216,227,695,0.087564571
Houston,77362,8017,289,221,192,702,0.087563927
Parkersburg,26101,28243,820,787,866,2473,0.08756152
Minneapolis-St. Paul,55025,26166,846,745,700,2291,0.087556371
New York,11581,23128,666,700,659,2025,0.087556209
Des Moines-Ames,50236,1599,61,46,33,140,0.087554722
Rockford,61084,3061,110,88,70,268,0.087553087
Dallas-Ft. Worth,75065,13866,438,413,363,1214,0.087552286
Philadelphia,8075,31250,954,897,885,2736,0.087552
Detroit,48240,17167,514,470,519,1503,0.087551698
Cincinnati,47003,1028,29,27,34,90,0.087548638
Dallas-Ft. Worth,76041,514,16,16,13,45,0.087548638
Cedar Rapids-Wtrlo-IWC&Dub,50624,1839,69,54,38,161,0.08754758
Greenville-N.Bern-Washngtn,28572,6408,219,181,161,561,0.087546816
Sioux Falls(Mitchell),51246,3861,132,113,93,338,0.087542088
Terre Haute,61933,891,25,29,24,78,0.087542088
Wichita-Hutchinson Plus,67834,891,32,19,27,78,0.087542088
Dallas-Ft. Worth,76035,3050,119,81,67,267,0.087540984
Knoxville,42653,4615,146,123,135,404,0.087540628
Chicago,60152,12143,364,363,336,1063,0.087540147
Santabarbra-Sanmar-Sanluob,93455,45146,1469,1248,1235,3952,0.087538209
Roanoke-Lynchburg,24541,27211,803,780,799,2382,0.087538128
Youngstown,44446,20164,499,605,661,1765,0.087532236
Evansville,47633,2422,72,75,65,212,0.087530966
Paducah-Cape Girard-Harsbg,63829,914,27,23,30,80,0.087527352
Austin,78648,8546,288,263,197,748,0.087526328
Charlotte,29743,1611,53,49,39,141,0.087523277
Cedar Rapids-Wtrlo-IWC&Dub,52747,2228,82,61,52,195,0.087522442
Austin,78717,41807,1324,1094,1241,3659,0.087521229
Birmingham (Ann and Tusc),35466,5336,179,153,135,467,0.087518741
New Orleans,70422,13723,430,395,376,1201,0.087517307
Salt Lake City,84340,4285,167,114,94,375,0.087514586
Shreveport,71268,2594,88,74,65,227,0.087509638
Wichita-Hutchinson Plus,67135,3234,131,88,64,283,0.08750773
Grand Junction-Montrose,81504,32993,1008,911,968,2887,0.08750341
Philadelphia,19938,11211,388,317,276,981,0.087503345
Elmira (Corning),14905,8377,240,259,234,733,0.087501492
Louisville,40062,320,11,9,8,28,0.0875
Lexington,41760,240,8,7,6,21,0.0875
Columbia-Jefferson City,65263,1920,69,48,51,168,0.0875
Ft. Smith-Fay-Sprngdl-Rgrs,72839,240,10,6,5,21,0.0875
Dayton,45308,4663,146,134,128,408,0.087497319
Mobile-Pensacola (Ft Walt),36441,3623,115,97,105,317,0.08749655
Tallahassee-Thomasville,32352,5646,189,168,137,494,0.087495572
"Washington, DC (Hagrstwn)",20601,29375,881,823,866,2570,0.087489362
Dallas-Ft. Worth,75087,50932,1835,1450,1171,4456,0.087489201
Raleigh-Durham (Fayetvlle),27519,71508,2940,1922,1394,6256,0.087486715
Mobile-Pensacola (Ft Walt),36420,10756,353,311,277,941,0.087486054
Victoria,77995,9876,319,280,265,864,0.087484812
Joplin-Pittsburg,67335,3555,134,101,76,311,0.087482419
Albuquerque-Santa Fe,87107,30258,794,886,967,2647,0.087480997
Greenvll-Spart-Ashevll-And,30516,1909,59,52,56,167,0.087480356
Hattiesburg-Laurel,39347,1166,37,36,29,102,0.087478559
Quincy-Hannibal-Keokuk,61422,2915,85,89,81,255,0.087478559
Columbus-Tupelo-West Point,39341,6333,171,191,192,554,0.087478288
Idaho Fals-Pocatllo(Jcksn),83443,1086,34,29,32,95,0.08747698
Oklahoma City,73064,28339,993,784,702,2479,0.087476622
Wilkes Barre-Scranton-Hztn,18512,12289,326,376,373,1075,0.087476605
Salisbury,21841,1006,15,34,39,88,0.087475149
Grand Rapids-Kalmzoo-B.Crk,49348,15136,480,422,422,1324,0.087473573
Memphis,38041,3704,50,90,184,324,0.087473002
Davenport-R.Island-Moline,52646,423,13,15,9,37,0.087470449
Shreveport,71450,846,31,25,18,74,0.087470449
"Columbia, SC",29153,14725,471,406,411,1288,0.087470289
Baltimore,21911,10838,340,309,299,948,0.087470013
"Columbus, OH",43004,33166,1023,878,1000,2901,0.087469095
Wilmington,28448,766,20,25,22,67,0.087467363
Ft. Smith-Fay-Sprngdl-Rgrs,72845,1109,39,32,26,97,0.087466186
"Columbus, OH",43103,13503,483,358,340,1181,0.087462045
Albany-Schenectady-Troy,12166,1635,53,47,43,143,0.087461774
Salt Lake City,82935,12280,438,357,279,1074,0.087459283
Spokane,99110,1818,68,55,36,159,0.087458746
Miami-Ft. Lauderdale,33317,37127,1025,1092,1130,3247,0.087456568
Sacramnto-Stkton-Modesto,95691,40707,1275,1097,1188,3560,0.087454246
Philadelphia,19148,52622,1209,1363,2030,4602,0.087453917
"Charleston, SC",29461,48460,1566,1277,1395,4238,0.08745357
"Washington, DC (Hagrstwn)",22180,27123,808,739,825,2372,0.087453453
Baltimore,21029,12601,480,383,239,1102,0.087453377
Baltimore,21639,4288,133,126,116,375,0.087453358
Cincinnati,41051,32692,1115,921,823,2859,0.087452588
"Jackson, TN",38352,526,19,15,12,46,0.087452471
New York,7033,8256,235,257,230,722,0.08745155
Detroit,48371,25214,864,768,573,2205,0.087451416
Dayton,45344,16615,526,471,456,1453,0.087451098
Boston (Manchester),2382,14774,446,405,441,1292,0.087450927
Shreveport,71019,7044,242,196,178,616,0.087450312
Chicago,60423,33002,1207,943,736,2886,0.087449246
Bismarck-Mnt-Dcknsn(Wlstn),58369,972,38,27,20,85,0.08744856
Madison,53714,16833,427,520,525,1472,0.087447276
Atlanta,30084,43581,1219,1234,1358,3811,0.087446364
Charlotte,28012,29653,938,900,755,2593,0.087444778
"Tri-Cities, TN-VA",41754,446,14,13,12,39,0.087443946
Lexington,41763,446,14,13,12,39,0.087443946
Paducah-Cape Girard-Harsbg,62948,11516,353,325,329,1007,0.087443557
Ft. Smith-Fay-Sprngdl-Rgrs,72751,10201,351,288,253,892,0.087442408
Atlanta,30619,1544,49,44,42,135,0.087435233
Abilene-Sweetwater,79556,12272,402,360,311,1073,0.087434811
Shreveport,71469,3008,94,93,76,263,0.087433511
Omaha,68135,30458,1115,840,708,2663,0.087431873
San Francisco-Oak-San Jose,94085,25815,460,596,1201,2257,0.087429789
"Albany, GA",31639,10031,307,299,271,877,0.08742897
Baton Rouge,70788,3500,112,99,95,306,0.087428571
Mankato,56081,6108,193,161,180,534,0.087426326
Salt Lake City,83114,1018,48,30,11,89,0.087426326
Wichita-Hutchinson Plus,67030,2871,97,84,70,251,0.087425984
"Columbus, OH",43344,5708,185,167,147,499,0.087421163
Minneapolis-St. Paul,55109,35907,977,1029,1133,3139,0.08742028
Miami-Ft. Lauderdale,33323,22741,547,672,769,1988,0.087419199
Nashville,37087,59598,1816,1729,1665,5210,0.087419041
Birmingham (Ann and Tusc),35206,15672,461,415,494,1370,0.08741705
Abilene-Sweetwater,79520,2082,69,59,54,182,0.087415946
Waco-Temple-Bryan,76579,6235,231,168,146,545,0.087409783
Tulsa,74337,4153,147,109,107,363,0.087406694
Cincinnati,41092,3970,152,120,75,347,0.087405542
"Jackson, MS",39117,9542,304,244,286,834,0.08740306
Burlington-Plattsburgh,5857,1373,44,37,39,120,0.087399854
Philadelphia,19153,11785,355,326,349,1030,0.087399236
Minneapolis-St. Paul,56291,492,14,16,13,43,0.087398374
New York,7021,2174,84,62,44,190,0.087396504
Chicago,60476,2277,60,73,66,199,0.087395696
Paducah-Cape Girard-Harsbg,62979,1190,28,47,29,104,0.087394958
San Francisco-Oak-San Jose,95403,45884,1347,1332,1331,4010,0.087394299
Chicago,60050,32096,932,949,924,2805,0.087394068
New York,12540,7655,262,211,196,669,0.08739386
Sacramnto-Stkton-Modesto,95673,15928,494,461,437,1392,0.08739327
San Francisco-Oak-San Jose,94102,40782,463,1195,1906,3564,0.087391496
West Palm Beach-Ft. Pierce,33428,45842,1517,1361,1128,4006,0.087387112
Champaign&Sprngfld-Decatur,61721,515,14,14,17,45,0.087378641
Boston (Manchester),1904,20005,563,603,582,1748,0.087378155
Philadelphia,19002,35307,1146,1064,875,3085,0.087376441
Seattle-Tacoma,98011,29001,725,823,986,2534,0.087376297
Knoxville,37709,3937,120,114,110,344,0.087376175
Paducah-Cape Girard-Harsbg,63801,23313,701,673,663,2037,0.087376142
Tyler-Longview(Lfkn&Ncgd),75647,13757,481,391,330,1202,0.087373701
Grand Rapids-Kalmzoo-B.Crk,49419,8790,328,245,195,768,0.087372014
Terre Haute,47443,1156,37,32,32,101,0.087370242
Tallahassee-Thomasville,32064,7646,237,235,196,668,0.087365943
New York,10965,15155,472,442,410,1324,0.087363906
Detroit,48015,8253,212,242,267,721,0.087362171
Grand Rapids-Kalmzoo-B.Crk,49455,5048,177,142,122,441,0.087361331
Joplin-Pittsburg,64856,4201,138,123,106,367,0.087360152
New Orleans,70394,13576,407,373,406,1186,0.087360047
Cincinnati,40359,7578,253,223,186,662,0.087358142
Minneapolis-St. Paul,55020,4350,185,113,82,380,0.087356322
Salt Lake City,83112,870,31,20,25,76,0.087356322
Sacramnto-Stkton-Modesto,95655,4785,149,119,150,418,0.087356322
Denver,80126,43432,1726,1255,813,3794,0.087354946
Ft. Wayne,45898,1202,46,31,28,105,0.087354409
Wichita-Hutchinson Plus,67870,1534,59,39,36,134,0.087353325
Tucson (Sierra Vista),85756,42975,1338,1267,1149,3754,0.087353112
Augusta-Aiken,30814,10635,351,325,253,929,0.087353079
New York,11767,13280,389,400,371,1160,0.087349398
Memphis,38661,1786,56,47,53,156,0.087346025
Rochestr-Mason City-Austin,55964,4694,168,126,116,410,0.087345548
Philadelphia,8328,1454,44,38,45,127,0.087345254
Philadelphia,8069,13544,421,391,371,1183,0.08734495
Joplin-Pittsburg,64778,561,19,17,13,49,0.087344029
"Springfield, MO",72611,1683,56,49,42,147,0.087344029
New York,7931,3618,125,110,81,316,0.087341072
Sioux City,51031,13018,417,381,339,1137,0.087340605
Seattle-Tacoma,98133,51958,962,1433,2143,4538,0.087339774
Dayton,45377,14358,402,404,448,1254,0.087338069
Little Rock-Pine Bluff,72047,1145,40,34,26,100,0.087336245
Laredo,78564,229,10,6,4,20,0.087336245
Lubbock,79371,1374,51,35,34,120,0.087336245
Bluefield-Beckley-Oak Hill,25136,1729,47,50,54,151,0.087333719
Greenville-N.Bern-Washngtn,27837,6023,196,175,155,526,0.087331894
Biloxi-Gulfport,39565,20394,683,574,524,1781,0.087329607
New York,10007,8634,155,224,375,754,0.087329164
San Antonio,78881,1752,49,63,41,153,0.087328767
Montgomery-Selma,36703,10867,359,297,293,949,0.08732861
St. Louis,62048,1294,36,42,35,113,0.087326121
Los Angeles,91607,31583,596,760,1402,2758,0.08732546
St. Louis,62040,39955,1111,1120,1258,3489,0.087323239
Abilene-Sweetwater,79602,26843,848,739,757,2344,0.087322579
La Crosse-Eau Claire,54498,2634,86,79,65,230,0.087319666
New York,8520,29249,904,867,783,2554,0.087319225
Honolulu,96791,7742,226,220,230,676,0.087315939
Cedar Rapids-Wtrlo-IWC&Dub,50707,7479,230,195,228,653,0.087311138
Seattle-Tacoma,98501,48437,1316,1417,1496,4229,0.087309288
St. Louis,63645,11992,391,356,300,1047,0.087308205
New York,11789,7491,222,209,223,654,0.087304766
Burlington-Plattsburgh,5041,126,4,5,2,11,0.087301587
Lexington,40946,126,5,3,3,11,0.087301587
Omaha,51521,2142,68,63,56,187,0.087301587
La Crosse-Eau Claire,54722,4536,156,120,120,396,0.087301587
Boston (Manchester),2375,10012,301,288,285,874,0.087295246
Boston (Manchester),1529,3093,89,95,86,270,0.087293889
New York,11020,6026,211,178,137,526,0.087288417
Toledo,43406,1753,55,50,48,153,0.08727895
Meridian,39305,18825,550,559,534,1643,0.087277556
Dallas-Ft. Worth,75182,8983,331,246,207,784,0.087275966
Paducah-Cape Girard-Harsbg,63736,3403,105,101,91,297,0.087275933
Denver,81625,12283,383,353,336,1072,0.087275096
"Portland, OR",98607,38419,1529,1137,687,3353,0.087274526
Denver,81632,12009,383,367,298,1048,0.087267882
Chattanooga,30710,6956,226,199,182,607,0.087262795
"Charleston, SC",29405,28008,701,797,946,2444,0.087260783
Johnstown-Altoona-St Colge,15865,1146,27,32,41,100,0.087260035
Charlotte,28031,30668,954,933,789,2676,0.087257076
"Jackson, MS",38721,871,20,33,23,76,0.087256028
Joplin-Pittsburg,64873,871,28,28,20,76,0.087256028
Chicago,60453,56651,1613,1627,1703,4943,0.087253535
Louisville,47130,50899,1359,1358,1724,4441,0.087251223
Knoxville,37847,2510,84,71,64,219,0.087250996
Dayton,45305,12069,376,361,316,1053,0.087248322
Detroit,48026,14603,395,418,461,1274,0.087242347
Atlanta,30032,45976,1037,1233,1741,4011,0.087241169
New York,11727,29803,765,832,1003,2600,0.08723954
San Diego,92126,74405,1639,2013,2839,6491,0.087238761
Philadelphia,19605,21493,644,646,585,1875,0.087237705
Champaign&Sprngfld-Decatur,61839,619,23,16,15,54,0.08723748
"Rochester, NY",14433,4654,143,140,123,406,0.087236786
Louisville,42740,2029,75,56,46,177,0.087235091
Birmingham (Ann and Tusc),35228,9446,297,264,263,824,0.087232691
Kansas City,64080,13871,510,384,316,1210,0.087232355
Twin Falls,83335,1903,73,51,42,166,0.087230688
Charleston-Huntington,41562,2247,70,75,51,196,0.087227414
Dothan,36375,7865,238,236,212,686,0.087221869
Lexington,40729,5916,195,177,144,516,0.087221095
Ft. Myers-Naples,33993,35865,1153,1010,965,3128,0.087215949
Columbia-Jefferson City,65109,40142,1218,1191,1092,3501,0.087215385
Medford-Klamath Falls,97603,32105,993,905,902,2800,0.08721383
West Palm Beach-Ft. Pierce,33458,55740,1885,1636,1340,4861,0.087208468
New York,8829,3486,102,100,102,304,0.087205967
Cincinnati,46173,10573,338,301,283,922,0.087203254
Detroit,48173,12523,415,360,317,1092,0.087199553
Wichita Falls & Lawton,76379,539,17,17,13,47,0.087198516
Philadelphia,18032,9817,293,271,292,856,0.087195681
New York,10547,7638,218,227,221,666,0.087195601
Oklahoma City,74840,1273,52,35,24,111,0.087195601
Toledo,43540,1468,44,45,39,128,0.08719346
Columbia-Jefferson City,65084,7432,258,204,186,648,0.087190527
"Washington, DC (Hagrstwn)",20720,24728,909,680,567,2156,0.087188612
Huntsville-Decatur (Flor),35648,3808,121,111,100,332,0.087184874
Tulsa,74441,5219,187,147,121,455,0.087181452
Bismarck-Mnt-Dcknsn(Wlstn),58852,2902,95,74,84,253,0.087181254
"Washington, DC (Hagrstwn)",20624,1170,40,32,30,102,0.087179487
Paducah-Cape Girard-Harsbg,62910,2145,75,62,50,187,0.087179487
Minneapolis-St. Paul,55128,29881,860,841,904,2605,0.087179144
"Columbus, GA (Opelika, AL)",39840,4382,140,124,118,382,0.087174806
Topeka,66451,1629,58,42,42,142,0.087170043
Buffalo,14779,7044,216,197,201,614,0.087166383
Greensboro-H.Point-W.Salem,27360,47726,1450,1341,1369,4160,0.087164229
Bismarck-Mnt-Dcknsn(Wlstn),58554,29955,826,887,898,2611,0.087164079
Mobile-Pensacola (Ft Walt),32580,4417,117,152,116,385,0.087163233
"Washington, DC (Hagrstwn)",21704,23875,963,645,473,2081,0.087162304
Seattle-Tacoma,98270,54876,1643,1534,1606,4783,0.087160143
Jacksonville,32257,42474,1103,1204,1395,3702,0.087159203
"Columbus, GA (Opelika, AL)",39846,1721,57,53,40,150,0.087158629
Davenport-R.Island-Moline,52748,10005,372,284,216,872,0.087156422
Evansville,47612,872,20,25,31,76,0.087155963
Tulsa,74422,654,24,16,17,57,0.087155963
Tampa-St. Pete (Sarasota),33543,44438,1539,1232,1102,3873,0.087155137
Cleveland-Akron (Canton),44053,20539,574,632,584,1790,0.087151273
"Albany, GA",31637,2903,89,84,80,253,0.087151223
Evansville,42351,4326,137,132,108,377,0.08714748
Greensboro-H.Point-W.Salem,27299,5026,153,147,138,438,0.087146836
Bowling Green,42127,6472,192,182,190,564,0.087144623
Birmingham (Ann and Tusc),36792,700,23,18,20,61,0.087142857
New York,12789,1905,42,61,63,166,0.087139108
Phoenix (Prescott),85249,50517,2193,1428,781,4402,0.087138983
Pittsburgh,15650,27657,805,947,658,2410,0.08713888
San Francisco-Oak-San Jose,95404,38537,1068,1097,1193,3358,0.087137037
Savannah,31532,723,27,19,17,63,0.087136929
Jonesboro,72422,4361,129,123,128,380,0.087135978
"Jackson, MS",39183,13657,437,372,381,1190,0.087134803
Los Angeles,93063,55099,1494,1700,1607,4801,0.087134068
Dallas-Ft. Worth,75478,987,37,27,22,86,0.087132725
Orlando-Daytona Bch-Melbrn,32712,52220,1755,1479,1316,4550,0.087131367
Cleveland-Akron (Canton),44427,1492,53,41,36,130,0.087131367
Charleston-Huntington,45652,2743,89,86,64,239,0.087130879
Philadelphia,8094,43016,1339,1170,1239,3748,0.08713037
Toledo,49256,3868,131,104,102,337,0.087125129
Tyler-Longview(Lfkn&Ncgd),75457,6221,200,173,169,542,0.087124257
West Palm Beach-Ft. Pierce,33405,19765,569,577,576,1722,0.087123704
Salt Lake City,84073,264,9,8,6,23,0.087121212
Chicago,60135,7289,227,218,190,635,0.087117574
Charleston-Huntington,41605,815,27,27,17,71,0.087116564
"Charleston, SC",29409,2181,63,97,30,190,0.087116002
Raleigh-Durham (Fayetvlle),27896,20938,652,601,571,1824,0.087114338
Dayton,45390,3329,99,99,92,290,0.087113247
Augusta-Aiken,30441,1986,61,60,52,173,0.087109768
Providence-New Bedford,2780,52899,1497,1552,1559,4608,0.087109397
Albuquerque-Santa Fe,88230,5476,182,156,139,477,0.087107378
Oklahoma City,73098,3777,136,107,86,329,0.087106169
"Columbia, SC",29212,31835,854,902,1017,2773,0.087105387
Nashville,42232,884,31,24,22,77,0.087104072
Lexington,40312,5993,198,169,155,522,0.087101619
Charlotte,28105,47198,1480,1328,1303,4111,0.087101148
Dallas-Ft. Worth,76426,12078,390,350,312,1052,0.087100513
Charleston-Huntington,25245,907,27,23,29,79,0.087100331
Albuquerque-Santa Fe,87124,60783,1999,1719,1576,5294,0.087096721
Roanoke-Lynchburg,24078,5936,168,184,165,517,0.087095687
Rochestr-Mason City-Austin,50401,28762,784,885,836,2505,0.087094082
West Palm Beach-Ft. Pierce,33403,13652,395,371,423,1189,0.087093466
San Antonio,78117,643,21,18,17,56,0.087091757
Columbia-Jefferson City,65054,976,38,26,21,85,0.087090164
Minneapolis-St. Paul,55008,17373,566,522,425,1513,0.087089161
"Washington, DC (Hagrstwn)",20721,30785,884,935,862,2681,0.087087867
Minneapolis-St. Paul,55427,23666,574,625,862,2061,0.08708696
Los Angeles,93001,36368,890,1093,1184,3167,0.08708205
Milwaukee,53073,15009,557,420,330,1307,0.087081085
Dallas-Ft. Worth,75169,17880,585,514,458,1557,0.087080537
Savannah,30415,8831,279,276,214,769,0.087079606
Boston (Manchester),1450,11369,397,364,229,990,0.087078899
"Portland, OR",97741,15446,486,434,425,1345,0.087077561
Cincinnati,47001,10060,317,284,275,876,0.087077535
New York,7442,11094,317,325,324,966,0.087074094
Harrisburg-Lncstr-Leb-York,17110,28849,753,787,972,2512,0.087074075
Evansville,42404,2251,70,67,59,196,0.087072412
Dayton,45414,20650,556,642,600,1798,0.087070218
Abilene-Sweetwater,76802,5754,199,163,139,501,0.087069864
Birmingham (Ann and Tusc),35453,13093,381,349,410,1140,0.087069426
Denver,81652,5823,196,167,144,507,0.087068521
Wilkes Barre-Scranton-Hztn,18704,31091,800,905,1002,2707,0.087066997
Philadelphia,8093,9889,255,265,341,861,0.087066437
Pittsburgh,15221,28358,543,762,1164,2469,0.087065378
"Washington, DC (Hagrstwn)",22655,23672,739,668,654,2061,0.087064887
Cincinnati,45005,32964,980,917,973,2870,0.087064677
"Jackson, MS",39145,5651,190,159,143,492,0.087064236
Lake Charles,70656,4089,131,124,101,356,0.087062852
Chicago,60542,18849,562,527,552,1641,0.087060322
Knoxville,37918,47255,1319,1351,1444,4114,0.08705957
Dallas-Ft. Worth,76078,11027,381,306,273,960,0.087059037
Los Angeles,91765,45281,1177,1350,1415,3942,0.087056381
Wilkes Barre-Scranton-Hztn,17872,8753,270,250,242,762,0.087055867
Springfield-Holyoke,1089,28707,720,865,914,2499,0.087051939
Los Angeles,92620,63607,2032,1780,1725,5537,0.087050167
Atlanta,30113,6502,186,182,198,566,0.087050138
Raleigh-Durham (Fayetvlle),28385,2803,92,81,71,244,0.08704959
Nashville,37142,1884,64,59,41,164,0.087048832
Ft. Smith-Fay-Sprngdl-Rgrs,72955,471,15,13,13,41,0.087048832
Memphis,38375,9087,261,275,255,791,0.08704743
Myrtle Beach-Florence,29567,494,16,14,13,43,0.087044534
St. Louis,62572,494,19,15,9,43,0.087044534
New York,7643,11029,274,331,355,960,0.08704325
Sioux Falls(Mitchell),57104,28595,589,851,1049,2489,0.087043189
Salt Lake City,84629,2516,105,64,50,219,0.087042925
Norfolk-Portsmth-Newpt Nws,23337,517,14,16,15,45,0.087040619
New Orleans,70442,517,18,13,14,45,0.087040619
Philadelphia,8049,5193,138,150,164,452,0.087040246
Wilmington,28421,1574,42,50,45,137,0.08703939
Buffalo,14715,2654,95,72,64,231,0.087038433
Billings,59030,1103,15,41,40,96,0.087035358
Hartford & New Haven,6770,31379,837,846,1048,2731,0.087032729
Detroit,48346,22716,579,721,677,1977,0.087031167
Marquette,49916,2976,108,84,67,259,0.08702957
Bluefield-Beckley-Oak Hill,24822,1195,36,34,34,104,0.087029289
Cedar Rapids-Wtrlo-IWC&Dub,50651,3631,132,89,95,316,0.087028367
Rochestr-Mason City-Austin,50471,609,17,17,19,53,0.087027915
"Washington, DC (Hagrstwn)",20011,65980,1454,1675,2613,5742,0.087026372
Spokane,83854,56973,1740,1604,1614,4958,0.087023678
St. Joseph,64485,8607,286,248,215,749,0.087022191
Chicago,60634,72500,1958,2096,2255,6309,0.08702069
St. Louis,63366,58597,1884,1664,1551,5099,0.087018107
Sioux Falls(Mitchell),57325,3597,106,102,105,313,0.087016959
Los Angeles,90245,16951,442,476,557,1475,0.087015515
Ft. Wayne,46710,4574,137,130,131,398,0.087013555
Lexington,40737,1540,54,40,40,134,0.087012987
Flint-Saginaw-Bay City,48611,6436,192,184,184,560,0.087010566
Orlando-Daytona Bch-Melbrn,34470,21825,602,612,685,1899,0.087010309
Madison,53965,12148,348,371,338,1057,0.087010207
Atlanta,30667,839,29,23,21,73,0.087008343
Boston (Manchester),3064,15332,406,462,466,1334,0.087007566
Huntsville-Decatur (Flor),35640,26550,822,735,753,2310,0.08700565
Denver,80624,908,26,29,24,79,0.087004405
New York,11365,43998,1176,1312,1340,3828,0.087003955
"Springfield, MO",65685,931,33,28,20,81,0.087003222
St. Louis,62264,3023,109,81,73,263,0.086999669
Minneapolis-St. Paul,55336,8115,255,241,210,706,0.086999384
Miami-Ft. Lauderdale,33016,44989,1174,1420,1320,3914,0.086999044
Chicago,60655,27311,931,758,687,2376,0.086997913
Orlando-Daytona Bch-Melbrn,34473,25863,792,733,725,2250,0.086996868
Odessa-Midland,79511,1161,42,28,31,101,0.086993971
Chicago,60532,28048,623,871,946,2440,0.086993725
Charlotte,28613,24634,776,694,673,2143,0.086993586
Indianapolis,46920,1184,44,31,28,103,0.086993243
Mobile-Pensacola (Ft Walt),36612,3851,126,99,110,335,0.086990392
Indianapolis,47920,2690,97,66,71,234,0.086988848
Knoxville,37803,36384,1182,1141,842,3165,0.086988786
Louisville,40220,33488,712,884,1317,2913,0.086986383
Indianapolis,47970,1943,58,58,53,169,0.086978899
Wichita-Hutchinson Plus,67124,7795,288,209,181,678,0.086978833
Johnstown-Altoona-St Colge,16627,2081,71,57,53,181,0.086977415
Toledo,43551,44553,1304,1246,1325,3875,0.086975063
Charlotte,28660,2403,75,69,65,209,0.086974615
Louisville,42701,54914,1593,1519,1664,4776,0.086972357
Shreveport,71801,14453,429,429,399,1257,0.086971563
Burlington-Plattsburgh,5827,598,18,21,13,52,0.086956522
"Washington, DC (Hagrstwn)",22960,11431,357,311,326,994,0.086956522
Greenville-N.Bern-Washngtn,28508,1840,63,53,44,160,0.086956522
Lexington,41735,253,8,7,7,22,0.086956522
Dayton,43333,828,23,25,24,72,0.086956522
Cedar Rapids-Wtrlo-IWC&Dub,50609,391,13,9,12,34,0.086956522
Quincy-Hannibal-Keokuk,62351,1633,47,50,45,142,0.086956522
Columbia-Jefferson City,65240,8648,288,249,215,752,0.086956522
Lincoln & Hastings-Krny,68778,598,20,21,11,52,0.086956522
Lincoln & Hastings-Krny,68837,115,5,3,2,10,0.086956522
Monroe-El Dorado,71243,138,4,4,4,12,0.086956522
"Alexandria, LA",71341,2967,93,84,81,258,0.086956522
Little Rock-Pine Bluff,72061,69,2,2,2,6,0.086956522
Memphis,72350,943,34,28,20,82,0.086956522
Oklahoma City,73718,529,20,14,12,46,0.086956522
Oklahoma City,74085,2208,62,63,67,192,0.086956522
San Antonio,78012,368,11,10,11,32,0.086956522
Dayton,45895,18263,587,527,474,1588,0.08695176
"Washington, DC (Hagrstwn)",22302,16734,323,473,659,1455,0.086948727
Denver,80751,17137,484,502,504,1490,0.086946373
"Portland, OR",98632,51124,1457,1474,1514,4445,0.086945466
Toledo,43528,16781,458,488,513,1459,0.086943567
Louisville,47111,18541,606,513,493,1612,0.086942452
Waco-Temple-Bryan,76557,5797,199,154,151,504,0.086941521
Rochestr-Mason City-Austin,55940,2749,86,67,86,239,0.086940706
Pittsburgh,15216,23294,455,614,956,2025,0.086932257
Hartford & New Haven,6010,60668,1688,1698,1888,5274,0.086932155
San Antonio,78247,49856,1437,1433,1464,4334,0.086930359
Chicago,60163,4866,117,140,166,423,0.086929716
"Jackson, MS",39116,3083,98,87,83,268,0.086928317
Yakima-Pasco-Rchlnd-Knnwck,97801,22870,623,704,661,1988,0.086926104
"Alexandria, LA",71438,1369,46,37,36,119,0.086924763
"Springfield, MO",72601,31155,957,949,802,2708,0.086920238
Philadelphia,19007,22147,632,584,709,1925,0.086919222
Harrisburg-Lncstr-Leb-York,17004,5511,178,164,137,479,0.086917075
Los Angeles,90065,42075,1007,1194,1456,3657,0.086916221
"Jackson, MS",39160,2140,65,58,63,186,0.086915888
Oklahoma City,73651,3728,129,92,103,324,0.086909871
Philadelphia,19464,49975,1455,1411,1477,4343,0.086903452
Birmingham (Ann and Tusc),35120,17606,581,483,466,1530,0.086902192
Abilene-Sweetwater,76448,5581,170,156,159,485,0.086901989
Dayton,45380,5512,205,153,121,479,0.086901306
Little Rock-Pine Bluff,71603,27319,743,837,794,2374,0.086899228
Grand Rapids-Kalmzoo-B.Crk,49446,2221,73,60,60,193,0.086897794
Oklahoma City,74631,6617,190,203,182,575,0.086897386
Hattiesburg-Laurel,39479,5662,179,157,156,492,0.08689509
San Antonio,78114,23639,794,644,616,2054,0.086890308
Buffalo,14092,10968,353,335,265,953,0.086889132
Albuquerque-Santa Fe,87112,41835,1076,1224,1335,3635,0.086888969
Buffalo,14760,17908,502,543,511,1556,0.086888541
Little Rock-Pine Bluff,72002,21200,727,545,570,1842,0.086886792
Oklahoma City,73029,1243,46,37,25,108,0.086886565
"Washington, DC (Hagrstwn)",20732,11797,432,312,281,1025,0.086886497
Cleveland-Akron (Canton),44629,2348,77,72,55,204,0.086882453
Joplin-Pittsburg,64779,2256,79,64,53,196,0.086879433
Indianapolis,47246,4397,129,132,121,382,0.086877416
Monroe-El Dorado,71635,10394,323,294,286,903,0.086877044
Tallahassee-Thomasville,31606,3810,135,97,99,331,0.08687664
Miami-Ft. Lauderdale,33060,36926,997,1057,1154,3208,0.086876456
Milwaukee,53115,15712,443,483,439,1365,0.086876273
Kansas City,64637,541,19,15,13,47,0.086876155
Cincinnati,47020,1059,41,28,23,92,0.08687441
New York,11104,31080,554,826,1320,2700,0.086872587
Madison,54638,1554,60,39,36,135,0.086872587
Evansville,62823,1554,48,44,43,135,0.086872587
Sioux Falls(Mitchell),57248,1531,55,44,34,133,0.086871326
Champaign&Sprngfld-Decatur,61938,19857,560,570,595,1725,0.086871129
Raleigh-Durham (Fayetvlle),27522,14021,448,401,369,1218,0.086869695
Montgomery-Selma,36041,1462,55,41,31,127,0.086867305
Cedar Rapids-Wtrlo-IWC&Dub,52342,3281,102,99,84,285,0.086863761
St. Louis,63383,16336,501,488,430,1419,0.086863369
Flint-Saginaw-Bay City,48642,33882,1004,994,945,2943,0.08686028
Nashville,37178,2245,81,62,52,195,0.086859688
Billings,82421,449,19,12,8,39,0.086859688
Salt Lake City,83232,449,22,7,10,39,0.086859688
Orlando-Daytona Bch-Melbrn,32117,30694,762,881,1023,2666,0.086857366
Sioux Falls(Mitchell),57035,1255,50,32,27,109,0.08685259
Richmond-Petersburg,23059,41772,1611,1171,846,3628,0.086852437
Mobile-Pensacola (Ft Walt),36560,3316,101,84,103,288,0.086851628
Nashville,37172,33160,1045,938,897,2880,0.086851628
New Orleans,70123,27024,619,757,971,2347,0.086848727
Bluefield-Beckley-Oak Hill,25913,403,11,15,9,35,0.086848635
Sioux City,51234,1209,39,27,39,105,0.086848635
Jonesboro,72430,403,14,11,10,35,0.086848635
Dallas-Ft. Worth,75469,403,11,12,12,35,0.086848635
Kansas City,64079,15280,534,449,344,1327,0.08684555
Traverse City-Cadillac,49769,1566,45,43,48,136,0.086845466
Atlanta,30563,5815,197,171,137,505,0.086844368
Ft. Wayne,45886,380,14,11,8,33,0.086842105
Milwaukee,53227,22017,484,619,809,1912,0.086841986
Chicago,60171,10387,275,305,322,902,0.086839318
Chattanooga,37310,4549,147,128,120,395,0.086832271
"Jackson, TN",38362,1382,42,36,42,120,0.08683068
New York,11590,46783,1304,1367,1391,4062,0.086826411
Salisbury,21830,4008,136,111,101,348,0.086826347
Indianapolis,46216,2672,46,82,104,232,0.086826347
New York,11730,14604,402,418,448,1268,0.086825527
New York,11729,29001,816,878,824,2518,0.086824592
Charleston-Huntington,25315,2937,68,98,89,255,0.086823289
Miami-Ft. Lauderdale,33149,14593,573,430,264,1267,0.086822449
Tampa-St. Pete (Sarasota),33569,31121,1015,877,810,2702,0.086822403
Mobile-Pensacola (Ft Walt),36553,3179,86,94,96,276,0.086819755
Chicago,60521,17658,702,540,291,1533,0.086816174
Los Angeles,91350,39705,1253,1168,1026,3447,0.086815263
Philadelphia,19804,18327,496,544,551,1591,0.086811808
Nashville,37388,27186,872,738,750,2360,0.086809387
Des Moines-Ames,50530,1152,42,33,25,100,0.086805556
Spokane,99005,10633,408,309,206,923,0.086805229
Atlanta,30062,66693,2306,1936,1547,5789,0.086800714
Des Moines-Ames,50056,1394,49,41,31,121,0.086800574
Hartford & New Haven,6374,8076,231,244,226,701,0.086800396
Hattiesburg-Laurel,39428,8583,267,246,232,745,0.086799487
"Springfield, MO",65647,2454,75,72,66,213,0.086797066
Greenvll-Spart-Ashevll-And,29692,4620,132,130,139,401,0.086796537
Paducah-Cape Girard-Harsbg,63961,1348,42,35,40,117,0.086795252
Austin,78615,1348,46,40,31,117,0.086795252
Erie,16110,265,9,7,7,23,0.086792453
Charleston-Huntington,25107,530,14,17,15,46,0.086792453
Seattle-Tacoma,98037,31950,699,917,1157,2773,0.086791862
Lexington,42553,5542,182,163,136,481,0.086791772
New York,7446,14483,466,430,361,1257,0.086791411
Oklahoma City,74872,3618,128,102,84,314,0.086788281
San Diego,92040,43808,1288,1235,1279,3802,0.086787801
Philadelphia,19154,34095,941,945,1073,2959,0.086786919
Buffalo,14125,3549,100,109,99,308,0.08678501
Baton Rouge,70736,507,16,16,12,44,0.08678501
Wichita Falls & Lawton,76354,11373,354,308,325,987,0.08678449
Savannah,31321,8043,263,219,216,698,0.086783538
Cincinnati,47240,22055,690,614,610,1914,0.086783042
Minneapolis-St. Paul,55122,32415,780,966,1067,2813,0.086780811
Macon,30428,2708,79,79,77,235,0.086779911
Columbus-Tupelo-West Point,38858,7041,217,184,210,611,0.086777446
St. Louis,63640,29570,916,868,782,2566,0.086777139
"Washington, DC (Hagrstwn)",20862,484,18,14,10,42,0.08677686
Lexington,41366,242,8,6,7,21,0.08677686
Toledo,43431,4264,136,122,112,370,0.086772983
San Diego,92071,59733,1664,1746,1773,5183,0.086769457
Little Rock-Pine Bluff,72007,9393,315,248,252,815,0.086766741
New York,18302,19593,599,552,549,1700,0.086765682
Mobile-Pensacola (Ft Walt),36541,14764,460,413,408,1281,0.086765104
Nashville,37010,6120,225,179,127,531,0.086764706
Cheyenne-Scottsbluff,82082,1798,56,50,50,156,0.08676307
Wilkes Barre-Scranton-Hztn,18403,7388,209,209,223,641,0.086762317
Cincinnati,47042,4668,136,127,142,405,0.086760925
Detroit,48076,26107,684,748,833,2265,0.086758341
Baltimore,20701,1533,22,43,68,133,0.086757991
Bluefield-Beckley-Oak Hill,25180,219,8,6,5,19,0.086757991
Little Rock-Pine Bluff,72567,219,7,6,6,19,0.086757991
Atlanta,30028,37301,1288,1031,917,3236,0.086753706
Denver,80808,7043,240,183,188,611,0.086752804
Waco-Temple-Bryan,76632,1487,56,42,31,129,0.086751849
Birmingham (Ann and Tusc),35079,9049,295,253,237,785,0.086749917
Orlando-Daytona Bch-Melbrn,34479,13522,407,379,387,1173,0.086747523
New York,10958,3735,117,120,87,324,0.086746988
Ft. Smith-Fay-Sprngdl-Rgrs,72832,830,27,24,21,72,0.086746988
Greenville-N.Bern-Washngtn,27871,3931,118,127,96,341,0.086746375
Charleston-Huntington,41602,807,23,24,23,70,0.086741016
St. Louis,62916,807,26,21,23,70,0.086741016
Denver,80015,73808,2490,2088,1824,6402,0.086738565
Philadelphia,18914,22574,780,652,526,1958,0.086736954
Santabarbra-Sanmar-Sanluob,93445,6906,189,207,203,599,0.086736171
New York,8722,10999,319,325,310,954,0.086735158
Cincinnati,45218,3897,108,116,114,338,0.086733385
West Palm Beach-Ft. Pierce,34983,46811,1445,1334,1281,4060,0.086731751
Chicago,60046,33460,1053,1003,846,2902,0.086730424
Houston,77514,5961,186,165,166,517,0.086730414
Louisville,42746,1914,65,56,45,166,0.086729363
Shreveport,71016,1891,66,56,42,164,0.0867266
Tulsa,74127,17192,470,515,506,1491,0.086726384
Kansas City,64475,369,13,10,9,32,0.086720867
Meridian,39365,7680,242,218,206,666,0.08671875
Las Vegas,89123,56921,1252,1729,1955,4936,0.086716678
Beaumont-Port Arthur,77657,22868,718,649,616,1983,0.08671506
Los Angeles,92845,15799,484,454,432,1370,0.086714349
Mobile-Pensacola (Ft Walt),36527,20089,698,540,504,1742,0.086714122
New York,8824,12778,414,381,313,1108,0.086711535
Philadelphia,19341,21543,598,609,661,1868,0.0867103
Presque Isle,4743,4567,134,141,121,396,0.086708999
Hattiesburg-Laurel,39459,3679,123,104,92,319,0.086708345
Chicago,60452,26745,730,731,858,2319,0.086707796
Fargo,58381,346,14,8,8,30,0.086705202
"Portland, OR",97020,1038,33,30,27,90,0.086705202
Honolulu,96713,1880,56,53,54,163,0.086702128
Greenvll-Spart-Ashevll-And,29650,41187,1329,1138,1104,3571,0.086702115
"Washington, DC (Hagrstwn)",22041,29354,712,836,997,2545,0.086700279
Rockford,61006,1488,45,43,41,129,0.086693548
Memphis,38633,2307,76,67,57,200,0.086692674
Baton Rouge,70441,5087,149,145,147,441,0.086691567
Cedar Rapids-Wtrlo-IWC&Dub,50626,1615,57,49,34,140,0.086687307
Amarillo,79022,10982,352,314,286,952,0.086687307
Minneapolis-St. Paul,55068,34966,1350,942,739,3031,0.086684208
Cedar Rapids-Wtrlo-IWC&Dub,52002,17628,586,515,427,1528,0.086680281
Grand Rapids-Kalmzoo-B.Crk,49017,20963,601,618,598,1817,0.086676525
Amarillo,79108,12264,406,352,305,1063,0.086676451
Oklahoma City,73834,1396,53,46,22,121,0.086676218
Biloxi-Gulfport,39530,8503,235,249,253,737,0.086675291
Wilmington,28431,6334,204,163,182,549,0.086675087
Sioux City,51101,1523,25,48,59,132,0.086671044
Miami-Ft. Lauderdale,33312,50294,1338,1438,1583,4359,0.086670378
Bluefield-Beckley-Oak Hill,24714,150,5,5,3,13,0.086666667
Dallas-Ft. Worth,75454,26804,1010,699,614,2323,0.086666169
Tucson (Sierra Vista),85730,38622,1092,1095,1160,3347,0.086660453
Minneapolis-St. Paul,55017,877,39,20,17,76,0.086659065
Charlotte,28114,7743,218,217,236,671,0.086658918
Atlanta,30683,7593,203,218,237,658,0.086658765
Cincinnati,45693,8747,262,257,239,758,0.086658283
"Portland, OR",97352,6116,202,164,164,530,0.086657946
New York,10314,92769,2647,2674,2718,8039,0.086656103
"Columbus, OH",43115,1281,46,34,31,111,0.086651054
Joplin-Pittsburg,64750,427,16,12,9,37,0.086651054
Boise,83626,1281,43,40,28,111,0.086651054
"Columbia, SC",29061,14530,446,402,411,1259,0.086648314
Peoria-Bloomington,61314,704,23,19,19,61,0.086647727
Orlando-Daytona Bch-Melbrn,34771,44653,1530,1209,1130,3869,0.086645914
La Crosse-Eau Claire,54421,3474,119,102,80,301,0.086643638
Greensboro-H.Point-W.Salem,27253,34776,992,989,1032,3013,0.086640212
Indianapolis,46065,3555,118,88,102,308,0.086638537
Salisbury,21643,5875,195,156,158,509,0.086638298
"Jackson, MS",39069,5044,154,143,140,437,0.086637589
Memphis,38650,4421,145,117,121,383,0.086631984
St. Louis,62851,531,19,15,12,46,0.086629002
Greenwood-Greenville,38756,5645,165,167,157,489,0.086625332
Milwaukee,53207,33524,684,897,1323,2904,0.086624508
Little Rock-Pine Bluff,72837,7931,261,236,190,687,0.086622116
Cedar Rapids-Wtrlo-IWC&Dub,52302,43860,1482,1230,1087,3799,0.086616507
New York,8882,16002,443,456,487,1386,0.086614173
Champaign&Sprngfld-Decatur,61845,381,12,12,9,33,0.086614173
Paducah-Cape Girard-Harsbg,63743,127,4,4,3,11,0.086614173
Shreveport,71842,2032,71,54,51,176,0.086614173
Juneau,99901,13820,402,416,379,1197,0.086613603
Watertown,13606,2644,84,72,73,229,0.086611195
"Charleston, SC",29111,1224,35,41,30,106,0.086601307
San Diego,92056,53499,1256,1642,1735,4633,0.08659975
Ft. Wayne,47390,4954,169,145,115,429,0.08659669
San Francisco-Oak-San Jose,95123,65500,1779,1896,1997,5672,0.08659542
Birmingham (Ann and Tusc),35133,4088,128,116,110,354,0.086594912
Baton Rouge,70754,12264,390,342,330,1062,0.086594912
Grand Rapids-Kalmzoo-B.Crk,49328,3938,134,100,107,341,0.086592179
Huntsville-Decatur (Flor),35761,13708,470,366,351,1187,0.086591771
Burlington-Plattsburgh,5452,22843,627,653,698,1978,0.086591078
"Columbus, OH",43830,5786,191,157,153,501,0.086588317
Cincinnati,45230,27256,726,780,854,2360,0.08658644
Salt Lake City,84526,4331,144,131,100,375,0.086585084
Tampa-St. Pete (Sarasota),33523,19253,627,531,509,1667,0.086583909
Savannah,31543,4897,151,146,127,424,0.086583623
Davenport-R.Island-Moline,61443,13282,420,378,352,1150,0.086583346
Buffalo,14136,5001,149,168,116,433,0.086582683
New York,10603,18006,442,528,589,1559,0.08658225
"Lafayette, LA",71362,1848,63,48,49,160,0.086580087
Greensboro-H.Point-W.Salem,27284,60199,1773,1790,1649,5212,0.086579511
Atlanta,30185,4262,133,124,112,369,0.086579071
Wheeling-Steubenville,43938,4828,142,138,138,418,0.086578293
Tallahassee-Thomasville,32332,1490,50,41,38,129,0.086577181
Paducah-Cape Girard-Harsbg,63846,1259,48,29,32,109,0.086576648
St. Joseph,64505,12925,393,390,336,1119,0.086576402
"Washington, DC (Hagrstwn)",22312,30414,748,846,1039,2633,0.086571973
New York,7722,9900,358,298,201,857,0.086565657
St. Louis,63043,22792,554,642,777,1973,0.086565462
Oklahoma City,73738,1109,49,26,21,96,0.086564472
Nashville,38474,8468,275,244,214,733,0.086561171
Memphis,38052,3986,138,111,96,345,0.086552935
"Washington, DC (Hagrstwn)",20905,19018,591,567,488,1646,0.086549585
New York,10566,25477,628,790,787,2205,0.086548652
Denver,81611,9440,221,288,308,817,0.08654661
Philadelphia,19136,39690,1125,1114,1196,3435,0.086545729
Dayton,45365,28945,871,836,798,2505,0.086543444
Atlanta,30338,38051,1016,1062,1215,3293,0.086541747
"Washington, DC (Hagrstwn)",22043,26427,733,739,815,2287,0.086540281
"Rochester, NY",14425,13728,446,372,370,1188,0.086538462
Mobile-Pensacola (Ft Walt),36471,832,23,25,24,72,0.086538462
Sioux Falls(Mitchell),57024,416,16,10,10,36,0.086538462
Chicago,60416,9522,296,273,255,824,0.086536442
Milwaukee,53220,25227,648,684,851,2183,0.086534269
Knoxville,37779,3802,126,105,98,329,0.086533403
Raleigh-Durham (Fayetvlle),27502,51541,1997,1449,1014,4460,0.086533051
Joplin-Pittsburg,64855,3074,114,83,69,266,0.086532206
Greenville-N.Bern-Washngtn,27863,12354,381,365,323,1069,0.086530678
Detroit,48124,33399,936,909,1045,2890,0.086529537
Chicago,60102,31839,998,936,821,2755,0.0865291
New York,7640,4981,189,147,95,431,0.086528809
Billings,59301,11661,334,363,312,1009,0.086527742
"Lafayette, LA",70516,1618,54,41,45,140,0.086526576
Dallas-Ft. Worth,75102,1514,48,45,38,131,0.08652576
Birmingham (Ann and Tusc),35124,27206,842,775,737,2354,0.086525031
Paducah-Cape Girard-Harsbg,63822,2716,90,76,69,235,0.0865243
Philadelphia,19044,16065,443,475,472,1390,0.086523498
Houston,77455,1780,64,46,44,154,0.086516854
Tyler-Longview(Lfkn&Ncgd),75941,8692,280,254,218,752,0.086516337
Davenport-R.Island-Moline,61344,393,10,13,11,34,0.086513995
Cleveland-Akron (Canton),44906,16853,464,563,431,1458,0.086512787
"Washington, DC (Hagrstwn)",20152,38977,1726,1021,625,3372,0.086512559
Yakima-Pasco-Rchlnd-Knnwck,97813,1364,43,39,36,118,0.086510264
Louisville,40026,6323,254,184,109,547,0.086509568
Birmingham (Ann and Tusc),35444,4624,137,123,140,400,0.08650519
Spokane,99140,289,12,8,5,25,0.08650519
Baltimore,21737,1919,80,52,34,166,0.086503387
Binghamton,14883,3919,128,98,113,339,0.086501659
South Bend-Elkhart,46539,2185,70,58,61,189,0.086498856
Amarillo,79065,19457,647,541,495,1683,0.086498432
Harrisburg-Lncstr-Leb-York,17252,3769,127,98,101,326,0.086495092
Chicago,60304,16764,526,485,439,1450,0.08649487
"Washington, DC (Hagrstwn)",22032,30096,893,877,833,2603,0.086489899
Birmingham (Ann and Tusc),35035,1584,50,45,42,137,0.086489899
Birmingham (Ann and Tusc),35091,3989,149,105,91,345,0.086487842
Mobile-Pensacola (Ft Walt),36619,14638,412,433,421,1266,0.086487225
Wichita-Hutchinson Plus,67530,17494,565,488,460,1513,0.086486795
Evansville,42461,1480,43,39,46,128,0.086486486
Indianapolis,47980,1110,33,34,29,96,0.086486486
Charlotte,28379,24559,746,698,680,2124,0.086485606
Columbus-Tupelo-West Point,38826,5585,159,169,155,483,0.086481647
Cedar Rapids-Wtrlo-IWC&Dub,50648,3920,143,98,98,339,0.086479592
Greenvll-Spart-Ashevll-And,29640,33407,982,891,1016,2889,0.086478882
"Washington, DC (Hagrstwn)",22664,9644,297,286,251,834,0.08647864
Indianapolis,46112,47006,1678,1281,1106,4065,0.086478322
New Orleans,70454,34321,1061,899,1008,2968,0.086477667
Baltimore,21214,18456,490,549,557,1596,0.086475943
Binghamton,13803,3608,119,94,99,312,0.086474501
Wausau-Rhinelander,54401,31767,905,862,980,2747,0.086473384
Detroit,48359,10616,296,302,320,918,0.086473248
Indianapolis,46150,717,27,17,18,62,0.086471409
Charleston-Huntington,41572,3296,109,101,75,285,0.086468447
Johnstown-Altoona-St Colge,16625,3458,106,98,95,299,0.086466165
Kansas City,66203,19881,470,550,699,1719,0.086464464
"Lafayette, LA",70531,1411,48,43,31,122,0.086463501
Sioux City,50535,879,29,28,19,76,0.086461889
Little Rock-Pine Bluff,72550,879,33,23,20,76,0.086461889
Peoria-Bloomington,61571,23976,831,673,569,2073,0.086461461
Norfolk-Portsmth-Newpt Nws,23308,2371,77,68,60,205,0.086461409
Oklahoma City,73433,2718,89,80,66,235,0.086460633
Indianapolis,46915,613,23,17,13,53,0.086460033
New Orleans,39466,27470,871,753,751,2375,0.086457954
Denver,80603,17107,577,469,433,1479,0.086455837
Greenville-N.Bern-Washngtn,28551,13395,419,375,364,1158,0.086450168
Boise,97918,4465,155,128,103,386,0.086450168
Dayton,45340,856,29,24,21,74,0.086448598
Denver,69121,428,18,8,11,37,0.086448598
Las Vegas,89001,856,35,22,17,74,0.086448598
Albuquerque-Santa Fe,88310,38254,1116,1090,1101,3307,0.086448476
Honolulu,96720,48607,1341,1476,1385,4202,0.086448454
Flint-Saginaw-Bay City,48457,7843,238,220,220,678,0.086446513
Cleveland-Akron (Canton),44680,4176,115,105,141,361,0.08644636
St. Louis,63626,937,33,25,23,81,0.086446105
San Diego,92081,29556,648,776,1131,2555,0.086446068
Tulsa,74053,5437,193,156,121,470,0.086444731
Lexington,41041,7635,242,216,202,660,0.086444008
San Diego,91902,17815,492,514,534,1540,0.086444008
Kansas City,66061,68287,2457,1914,1532,5903,0.086443979
Bluefield-Beckley-Oak Hill,24641,5634,142,163,182,487,0.086439475
Macon,31023,14114,422,424,374,1220,0.086438997
Minneapolis-St. Paul,56281,671,32,16,10,58,0.086438152
Albany-Schenectady-Troy,12839,13374,415,355,386,1156,0.086436369
Los Angeles,90291,27778,384,687,1330,2401,0.086435309
Shreveport,71256,914,24,23,32,79,0.08643326
Knoxville,37806,3309,92,105,89,286,0.086430946
Chicago,60043,2314,94,70,36,200,0.086430424
Elmira (Corning),14904,14694,451,400,419,1270,0.086429835
New York,8846,15031,420,416,463,1299,0.086421396
Traverse City-Cadillac,49686,26637,615,813,874,2302,0.086421144
Knoxville,40939,162,4,5,5,14,0.086419753
Grand Rapids-Kalmzoo-B.Crk,49245,4374,151,112,115,378,0.086419753
Butte-Bozeman,59732,81,3,2,2,7,0.086419753
Los Angeles,92368,810,24,22,24,70,0.086419753
Memphis,38666,6654,206,188,181,575,0.086414187
Birmingham (Ann and Tusc),35581,5034,162,148,125,435,0.086412396
Toledo,43521,2627,87,63,77,227,0.086410354
Atlanta,30527,5011,147,151,135,433,0.086409898
"Portland, OR",98626,27636,828,797,763,2388,0.086409032
Elmira (Corning),14855,949,37,24,21,82,0.086406744
New York,11731,29767,879,933,760,2572,0.086404408
Myrtle Beach-Florence,29571,14004,436,397,377,1210,0.086403885
Terre Haute,47438,3970,125,116,102,343,0.086397985
"Portland, OR",97121,1632,49,44,48,141,0.086397059
Cincinnati,41063,3646,139,101,75,315,0.08639605
Paducah-Cape Girard-Harsbg,42088,2859,99,82,66,247,0.086393844
Chicago,60560,29852,1024,852,703,2579,0.086392871
Augusta-Aiken,29843,1146,39,32,28,99,0.086387435
Bismarck-Mnt-Dcknsn(Wlstn),58733,382,13,11,9,33,0.086387435
Philadelphia,19468,29426,957,839,746,2542,0.086386189
Philadelphia,8051,10129,260,296,319,875,0.086385625
Ft. Smith-Fay-Sprngdl-Rgrs,74930,3114,100,90,79,269,0.086384072
Reno,89408,24741,792,696,649,2137,0.086374843
"Lafayette, LA",70546,16290,547,447,413,1407,0.086372007
Miami-Ft. Lauderdale,33167,18594,551,532,523,1606,0.086371948
Yakima-Pasco-Rchlnd-Knnwck,99352,39528,1227,1110,1077,3414,0.086369156
Clarksburg-Weston,26218,2640,83,80,65,228,0.086363636
Cleveland-Akron (Canton),44223,18110,452,559,553,1564,0.086361126
Miami-Ft. Lauderdale,33330,14428,480,430,336,1246,0.086359856
Grand Rapids-Kalmzoo-B.Crk,49043,2038,54,68,54,176,0.086359176
Jacksonville,32222,19952,584,546,593,1723,0.086357257
Lansing,48835,2536,83,72,64,219,0.086356467
Indianapolis,47334,3254,93,93,95,281,0.086355255
New York,7078,14684,633,414,221,1268,0.086352493
New York,12575,2432,80,71,59,210,0.086348684
Indianapolis,47452,5142,173,134,137,444,0.086347725
Oklahoma City,73763,1355,41,39,37,117,0.086346863
Dothan,36346,996,32,30,24,86,0.086345382
Charleston-Huntington,41503,498,14,13,16,43,0.086345382
Dallas-Ft. Worth,75423,3486,110,103,88,301,0.086345382
Nashville,37091,23522,703,659,669,2031,0.086344699
Evansville,47670,12022,378,318,342,1038,0.086341707
Duluth-Superior,54855,915,37,22,20,79,0.086338798
New York,12549,9683,294,280,262,836,0.086336879
Nashville,42286,1471,46,44,37,127,0.086335826
Detroit,48162,29200,820,828,873,2521,0.086335616
"Lafayette, LA",70535,16772,542,460,446,1448,0.086334367
"Washington, DC (Hagrstwn)",20868,139,4,4,4,12,0.086330935
Columbus-Tupelo-West Point,39772,1668,57,46,41,144,0.086330935
Monroe-El Dorado,71642,556,18,14,16,48,0.086330935
Tulsa,74364,1807,60,51,45,156,0.086330935
Tucson (Sierra Vista),85629,33638,1254,927,723,2904,0.086330935
Miami-Ft. Lauderdale,33186,67256,1837,1905,2064,5806,0.08632687
Cedar Rapids-Wtrlo-IWC&Dub,52144,1309,38,38,37,113,0.086325439
Chattanooga,37110,33791,1064,944,909,2917,0.086324761
Jacksonville,32011,16288,532,463,411,1406,0.086321218
Minneapolis-St. Paul,56264,2039,65,61,50,176,0.086316822
Los Angeles,90603,20587,617,605,555,1777,0.086316608
Charleston-Huntington,41231,950,31,34,17,82,0.086315789
Omaha,51562,475,20,9,12,41,0.086315789
Wichita Falls & Lawton,73533,27934,862,807,742,2411,0.086310589
Austin,78733,9211,396,260,139,795,0.086309847
Milwaukee,53916,23126,690,635,671,1996,0.086309781
Lexington,41729,336,10,10,9,29,0.086309524
Fargo,56732,1008,34,31,22,87,0.086309524
Chicago,61364,18005,574,489,491,1554,0.086309359
San Francisco-Oak-San Jose,94577,47423,1232,1343,1518,4093,0.086308331
Toledo,43567,13255,417,370,357,1144,0.086307054
San Francisco-Oak-San Jose,94566,44586,1510,1378,960,3848,0.086305118
Richmond-Petersburg,23120,15816,700,429,236,1365,0.086305008
"Albany, GA",31635,6651,199,180,195,574,0.086302812
Minneapolis-St. Paul,55016,43281,1533,1155,1047,3735,0.086296527
New York,11735,32852,858,961,1016,2835,0.086296116
San Francisco-Oak-San Jose,94041,17498,301,485,724,1510,0.086295577
Boston (Manchester),2542,591,7,14,30,51,0.086294416
"Springfield, MO",65707,2225,76,66,50,192,0.086292135
Cedar Rapids-Wtrlo-IWC&Dub,50668,1240,49,23,35,107,0.086290323
Tulsa,74436,4566,159,133,102,394,0.086289969
Cedar Rapids-Wtrlo-IWC&Dub,52068,5076,207,139,92,438,0.086288416
Duluth-Superior,55711,649,25,16,15,56,0.086286595
Atlanta,30223,39798,1175,1103,1156,3434,0.086285743
Greenvll-Spart-Ashevll-And,29644,24361,800,660,642,2102,0.086285456
"Washington, DC (Hagrstwn)",22405,36589,1153,1012,992,3157,0.086282763
Wichita Falls & Lawton,73501,19135,475,580,596,1651,0.086281683
Houston,77389,46383,1630,1231,1141,4002,0.086281612
Panama City,32448,8171,253,218,234,705,0.086280749
Seattle-Tacoma,98597,28744,926,716,838,2480,0.086278876
Phoenix (Prescott),85083,21570,857,600,404,1861,0.086277237
Providence-New Bedford,2861,27528,739,782,854,2375,0.086275792
Macon,31015,18279,549,519,509,1577,0.086273866
Seattle-Tacoma,98198,40326,1079,1141,1259,3479,0.086271884
Ft. Smith-Fay-Sprngdl-Rgrs,72921,13945,465,383,355,1203,0.086267479
"Columbus, OH",45812,1762,53,50,49,152,0.086265607
Nashville,37216,19394,289,493,891,1673,0.086263793
Birmingham (Ann and Tusc),35956,8903,270,249,249,768,0.086263057
Charleston-Huntington,41219,1878,68,49,45,162,0.086261981
Detroit,48312,34918,895,949,1168,3012,0.086259236
New York,12553,27279,817,780,756,2353,0.086256828
Boise,83619,9495,339,275,205,819,0.086255924
Sacramnto-Stkton-Modesto,95693,7501,246,217,184,647,0.086255166
Augusta-Aiken,30669,3223,98,100,80,278,0.086255042
Casper-Riverton,82501,18631,637,507,463,1607,0.086254093
Indianapolis,46157,4452,142,130,112,384,0.086253369
Pittsburgh,15697,2829,72,78,94,244,0.086249558
Columbia-Jefferson City,65459,7374,232,216,188,636,0.086248983
Wilmington,28441,2887,99,72,78,249,0.086248701
Dayton,43078,20441,608,564,591,1763,0.086248227
Cleveland-Akron (Canton),44637,2516,74,73,70,217,0.086248013
Savannah,31551,858,30,24,20,74,0.086247086
"Jackson, MS",39641,4035,132,112,104,348,0.086245353
Cedar Rapids-Wtrlo-IWC&Dub,52328,3293,132,99,53,284,0.086243547
Harrisburg-Lncstr-Leb-York,17345,8105,252,224,223,699,0.08624306
Houston,77962,3409,118,90,86,294,0.0862423
Mobile-Pensacola (Ft Walt),36526,40156,1270,1108,1085,3463,0.086238669
Harrisburg-Lncstr-Leb-York,17055,44435,1425,1209,1198,3832,0.086238326
Tyler-Longview(Lfkn&Ncgd),75937,1264,45,38,26,109,0.086234177
Charleston-Huntington,41101,18044,493,544,519,1556,0.086233651
New York,7857,3595,95,99,116,310,0.086230876
Grand Rapids-Kalmzoo-B.Crk,49066,719,24,19,19,62,0.086230876
Cleveland-Akron (Canton),44110,17059,476,454,541,1471,0.086230142
Wilmington,28337,9440,288,293,233,814,0.086228814
Spokane,83815,43412,1288,1215,1240,3743,0.0862204
Albany-Schenectady-Troy,12090,6182,207,157,169,533,0.086218052
New York,10901,25343,783,729,673,2185,0.086217101
South Bend-Elkhart,47957,1705,53,56,38,147,0.086217009
New York,6897,18385,729,544,312,1585,0.086211586
Fresno-Visalia,93210,18223,538,516,517,1571,0.086209735
"Lafayette, LA",70582,18629,575,523,508,1606,0.086209673
"Washington, DC (Hagrstwn)",20143,1276,50,34,26,110,0.086206897
Charleston-Huntington,26152,58,2,2,1,5,0.086206897
Nashville,37151,522,17,14,14,45,0.086206897
Memphis,38642,2378,68,63,74,205,0.086206897
Lexington,40921,232,6,9,5,20,0.086206897
"Tri-Cities, TN-VA",41762,116,4,3,3,10,0.086206897
Sioux City,51239,3538,122,99,84,305,0.086206897
Sioux Falls(Mitchell),57364,58,2,1,2,5,0.086206897
Bismarck-Mnt-Dcknsn(Wlstn),58856,174,6,4,5,15,0.086206897
Sioux City,68733,1276,41,34,35,110,0.086206897
Little Rock-Pine Bluff,72524,348,11,11,8,30,0.086206897
Albuquerque-Santa Fe,87573,232,8,8,4,20,0.086206897
Denver,80236,15150,454,429,423,1306,0.08620462
Hattiesburg-Laurel,39119,4037,123,108,117,348,0.086202626
San Francisco-Oak-San Jose,95492,26183,812,786,659,2257,0.08620097
Shreveport,75640,5557,193,160,126,479,0.086197589
Peoria-Bloomington,61529,2854,101,86,59,246,0.086194814
Charleston-Huntington,25517,1984,65,54,52,171,0.086189516
Hattiesburg-Laurel,39667,11487,364,339,287,990,0.086184382
Miami-Ft. Lauderdale,33189,24181,699,732,653,2084,0.086183367
Los Angeles,91801,51228,1076,1400,1939,4415,0.086183337
Erie,16402,731,26,18,19,63,0.086183311
Indianapolis,47283,3307,96,106,83,285,0.086180829
New York,7731,38919,1219,1120,1015,3354,0.086178987
Ft. Wayne,45880,2402,78,69,60,207,0.086178185
Idaho Fals-Pocatllo(Jcksn),83211,6533,233,182,148,563,0.086177866
Houston,77979,17604,544,524,449,1517,0.086173597
Greenvll-Spart-Ashevll-And,29673,32506,1038,844,919,2801,0.086168707
Pittsburgh,15601,58886,1734,1807,1533,5074,0.086166491
Tampa-St. Pete (Sarasota),33626,32786,1083,940,802,2825,0.086164826
Bluefield-Beckley-Oak Hill,25174,383,14,11,8,33,0.08616188
La Crosse-Eau Claire,54479,3830,133,103,94,330,0.08616188
Little Rock-Pine Bluff,72042,4538,142,123,126,391,0.086161305
Buffalo,14772,4097,157,103,93,353,0.086160605
Los Angeles,91740,25453,699,737,757,2193,0.086158802
"Charleston, SC",29474,2507,81,66,69,216,0.086158755
Boise,83604,708,27,18,16,61,0.086158192
Shreveport,71852,9622,306,296,227,829,0.086156724
Grand Rapids-Kalmzoo-B.Crk,48860,1358,43,35,39,117,0.086156112
Memphis,38106,22181,669,627,615,1911,0.086154817
San Francisco-Oak-San Jose,94025,45745,1369,1251,1321,3941,0.086151492
Dallas-Ft. Worth,75072,54544,2052,1559,1088,4699,0.086150631
Little Rock-Pine Bluff,72010,6094,195,169,161,525,0.086150312
Chicago,60083,9472,295,295,226,816,0.086148649
Albuquerque-Santa Fe,87557,6396,200,180,171,551,0.086147592
Louisville,40212,16321,505,444,457,1406,0.086146682
"Washington, DC (Hagrstwn)",20815,31133,903,950,829,2682,0.086146533
Chattanooga,30755,10018,298,279,286,863,0.086144939
Bismarck-Mnt-Dcknsn(Wlstn),58779,534,17,14,15,46,0.086142322
Lubbock,79527,267,11,7,5,23,0.086142322
Cleveland-Akron (Canton),44875,14186,442,396,384,1222,0.086141266
Waco-Temple-Bryan,76682,2821,88,82,73,243,0.086139667
"Springfield, MO",65759,1277,45,36,29,110,0.086139389
Myrtle Beach-Florence,29530,2972,99,73,84,256,0.086137281
Lincoln & Hastings-Krny,68944,1219,37,32,36,105,0.086136177
Little Rock-Pine Bluff,72019,29547,925,806,814,2545,0.086133956
Pittsburgh,15376,1637,56,41,44,141,0.08613317
Peoria-Bloomington,61738,4145,134,116,107,357,0.086127865
Waco-Temple-Bryan,76569,2833,94,80,70,244,0.08612778
Dayton,45303,2148,70,57,58,185,0.086126629
Atlanta,30256,3135,103,83,84,270,0.086124402
Ft. Wayne,46781,836,24,23,25,72,0.086124402
"Portland, OR",97357,209,7,6,5,18,0.086124402
Philadelphia,19977,29574,953,812,782,2547,0.086122946
Orlando-Daytona Bch-Melbrn,34482,25406,522,715,951,2188,0.086121389
Minneapolis-St. Paul,55397,3019,101,83,76,260,0.086121232
Beaumont-Port Arthur,77611,9928,318,245,292,855,0.086120064
Eureka,95540,13993,434,392,379,1205,0.086114486
Raleigh-Durham (Fayetvlle),27537,22923,699,660,615,1974,0.086114383
Los Angeles,92648,44952,1080,1351,1440,3871,0.086114077
Harrisburg-Lncstr-Leb-York,17268,31052,940,894,840,2674,0.086113616
Detroit,48084,17930,504,510,530,1544,0.08611266
Detroit,48872,7444,208,213,220,641,0.086109618
Greenwood-Greenville,38762,2102,71,47,63,181,0.086108468
Wichita-Hutchinson Plus,67954,511,17,15,12,44,0.086105675
Charlotte,29727,1324,37,37,40,114,0.086102719
New York,6820,21579,885,635,338,1858,0.086102229
Huntsville-Decatur (Flor),35968,4878,161,133,126,420,0.086100861
Wichita-Hutchinson Plus,67878,2172,78,60,49,187,0.086095764
Philadelphia,19952,11104,338,302,316,956,0.086095101
"Washington, DC (Hagrstwn)",22044,13404,347,363,444,1154,0.086093703
Grand Rapids-Kalmzoo-B.Crk,49345,13404,395,407,352,1154,0.086093703
Seattle-Tacoma,98148,11558,320,304,371,995,0.086087558
Minneapolis-St. Paul,55434,32990,1040,885,915,2840,0.086086693
South Bend-Elkhart,46524,2393,82,62,62,206,0.086084413
Chicago,60404,20435,699,549,511,1759,0.086077808
Boston (Manchester),1588,10607,316,296,301,913,0.086075233
New York,8865,31322,983,856,857,2696,0.086073686
Cincinnati,47011,1034,37,26,26,89,0.086073501
Philadelphia,19054,17369,506,490,499,1495,0.086072888
New York,11777,10468,275,311,315,901,0.086071838
New York,7604,12025,364,317,354,1035,0.086070686
Charlotte,29728,9864,298,274,277,849,0.08607056
Dallas-Ft. Worth,75209,15104,287,405,608,1300,0.086069915
Lake Charles,70634,25678,822,709,679,2210,0.086065893
Birmingham (Ann and Tusc),35062,8552,253,228,255,736,0.08606174
Atlanta,30178,4125,125,108,122,355,0.086060606
Tampa-St. Pete (Sarasota),33624,39879,1046,1139,1247,3432,0.086060333
Paducah-Cape Girard-Harsbg,63841,13235,385,389,365,1139,0.08605969
Philadelphia,8045,3393,84,97,111,292,0.086059534
Myrtle Beach-Florence,29540,4648,154,136,110,400,0.08605852
Paducah-Cape Girard-Harsbg,62957,581,13,22,15,50,0.08605852
Philadelphia,8225,8634,262,251,230,743,0.086055131
Indianapolis,46122,17571,585,464,463,1512,0.086050879
Omaha,68601,30761,987,848,812,2647,0.086050519
Cleveland-Akron (Canton),44705,17513,508,484,515,1507,0.086050363
Columbia-Jefferson City,65011,2824,102,71,70,243,0.086048159
Ft. Wayne,45887,4730,157,135,115,407,0.086046512
Indianapolis,47345,1290,40,40,31,111,0.086046512
Terre Haute,47519,860,30,22,22,74,0.086046512
Boston (Manchester),3275,12319,366,365,329,1060,0.086045945
Elmira (Corning),14819,616,21,18,14,53,0.086038961
Nashville,42276,15098,459,413,427,1299,0.086037886
Providence-New Bedford,2874,5916,185,200,124,509,0.086037863
Minneapolis-St. Paul,55301,13994,530,372,302,1204,0.086036873
Shreveport,71106,33544,1065,961,860,2886,0.086036251
Buffalo,14701,37393,1024,1105,1088,3217,0.086032145
"Washington, DC (Hagrstwn)",22630,35510,1049,1070,936,3055,0.086032104
Grand Rapids-Kalmzoo-B.Crk,49093,18087,554,509,493,1556,0.086028639
Cleveland-Akron (Canton),44840,3092,102,93,71,266,0.086028461
New York,11787,36326,1107,1136,882,3125,0.086026537
Mobile-Pensacola (Ft Walt),39362,2569,82,67,72,221,0.086025691
Roanoke-Lynchburg,24569,837,26,24,22,72,0.086021505
"Charleston, SC",29434,744,18,21,25,64,0.086021505
"Columbus, OH",45836,1302,41,35,36,112,0.086021505
Bismarck-Mnt-Dcknsn(Wlstn),58775,279,11,7,6,24,0.086021505
Paducah-Cape Girard-Harsbg,62926,2046,54,61,61,176,0.086021505
Idaho Fals-Pocatllo(Jcksn),83271,465,19,15,6,40,0.086021505
St. Louis,62558,3662,101,116,98,315,0.086018569
Dallas-Ft. Worth,76021,34726,842,959,1186,2987,0.086016241
Phoenix (Prescott),85539,4104,116,127,110,353,0.086013645
Atlanta,30171,3918,126,105,106,337,0.086013272
Charlotte,29101,2988,94,74,89,257,0.08601071
New York,7928,19184,781,537,332,1650,0.086009174
Augusta-Aiken,29828,779,22,21,24,67,0.086007702
"Washington, DC (Hagrstwn)",20878,67960,2109,1926,1810,5845,0.086006474
Cleveland-Akron (Canton),43945,2744,95,67,74,236,0.086005831
Sioux Falls(Mitchell),57078,20487,624,631,507,1762,0.08600576
Grand Rapids-Kalmzoo-B.Crk,49094,4244,141,116,108,365,0.08600377
Norfolk-Portsmth-Newpt Nws,23434,54312,1568,1516,1587,4671,0.086003093
"Washington, DC (Hagrstwn)",20657,20593,634,573,564,1771,0.086000097
Kansas City,64016,4907,173,130,119,422,0.085999592
New York,8810,9291,345,263,191,799,0.085997202
Albany-Schenectady-Troy,12143,4849,117,148,152,417,0.085997113
Erie,16410,1628,58,40,42,140,0.085995086
Paducah-Cape Girard-Harsbg,63940,1221,40,36,29,105,0.085995086
San Diego,91941,33619,891,895,1105,2891,0.08599304
Minneapolis-St. Paul,55303,53218,1638,1461,1477,4576,0.085985945
Spokane,83851,1919,68,53,44,165,0.085982282
Atlanta,30025,10596,335,297,279,911,0.08597584
Little Rock-Pine Bluff,72116,22251,556,595,762,1913,0.085973664
Little Rock-Pine Bluff,72080,663,24,19,14,57,0.085972851
Grand Rapids-Kalmzoo-B.Crk,49078,9771,299,272,269,840,0.085968683
New York,7882,15099,441,445,412,1298,0.085965958
Ft. Smith-Fay-Sprngdl-Rgrs,74948,12284,391,364,301,1056,0.085965484
Macon,31092,5258,140,179,133,452,0.085964245
Nashville,37342,4025,123,133,90,346,0.085962733
Nashville,37037,10470,376,265,259,900,0.085959885
Cleveland-Akron (Canton),44272,5014,142,164,125,431,0.085959314
Los Angeles,91773,33342,898,956,1012,2866,0.085957651
Ft. Myers-Naples,33901,24757,633,786,709,2128,0.085955487
Indianapolis,47396,7248,256,198,169,623,0.085954746
Los Angeles,91501,20569,482,588,698,1768,0.085954592
Champaign&Sprngfld-Decatur,62671,477,16,14,11,41,0.085953878
Sacramnto-Stkton-Modesto,95661,32879,976,939,911,2826,0.085951519
Pittsburgh,15112,3281,81,88,113,282,0.085949406
San Francisco-Oak-San Jose,94301,16836,486,447,514,1447,0.085946781
Dallas-Ft. Worth,75431,1978,67,50,53,170,0.085945399
"Jackson, MS",39159,2909,101,80,69,250,0.085940186
Louisville,40014,23342,908,662,436,2006,0.085939508
Chicago,60202,31720,804,910,1012,2726,0.08593947
Norfolk-Portsmth-Newpt Nws,23488,128,4,3,4,11,0.0859375
"Tri-Cities, TN-VA",24265,640,23,15,17,55,0.0859375
Bluefield-Beckley-Oak Hill,24823,640,20,15,20,55,0.0859375
Greenvll-Spart-Ashevll-And,29349,39250,1215,1051,1107,3373,0.085936306
Spokane,99016,18665,602,523,479,1604,0.085936244
Harrisburg-Lncstr-Leb-York,17554,8076,223,225,246,694,0.085933631
Dallas-Ft. Worth,76626,1699,53,45,48,146,0.085932902
New York,11545,12126,352,402,288,1042,0.085931057
Buffalo,14020,22042,668,635,591,1894,0.085926867
Indianapolis,47234,1350,47,39,30,116,0.085925926
St. Louis,63369,3247,96,85,98,279,0.08592547
"Washington, DC (Hagrstwn)",21787,12185,382,346,319,1047,0.085925318
Greenwood-Greenville,38773,2316,64,63,72,199,0.085924007
Charleston-Huntington,41527,547,16,15,16,47,0.085923218
Atlanta,36268,5412,166,152,147,465,0.085920177
Richmond-Petersburg,23079,419,14,13,9,36,0.085918854
Louisville,47141,1548,53,44,36,133,0.085917313
Harrisonburg,22832,1129,37,34,26,97,0.08591674
Reno,93546,8427,232,247,245,724,0.085914323
Kansas City,64089,14538,487,428,334,1249,0.08591278
Butte-Bozeman,59701,34861,936,1036,1023,2995,0.085912624
Ft. Wayne,46733,19043,601,504,531,1636,0.085910833
Traverse City-Cadillac,49679,1164,37,27,36,100,0.085910653
"Portland, OR",97389,1781,48,47,58,153,0.085906794
Evansville,42320,8230,248,239,220,707,0.085905225
Kansas City,66221,26111,1086,704,453,2243,0.085902493
Dallas-Ft. Worth,76259,7858,275,210,190,675,0.08589972
Philadelphia,18059,1234,34,42,30,106,0.085899514
Salt Lake City,82932,617,26,17,10,53,0.085899514
"Washington, DC (Hagrstwn)",22485,27509,909,741,713,2363,0.08589916
Kansas City,64747,3737,119,101,101,321,0.085897779
Columbia-Jefferson City,65051,4680,146,134,122,402,0.085897436
Dayton,45883,4098,140,108,104,352,0.085895559
Birmingham (Ann and Tusc),35126,21049,648,552,608,1808,0.085894817
Oklahoma City,74079,4331,144,120,108,372,0.085892404
Bluefield-Beckley-Oak Hill,24882,489,16,12,14,42,0.085889571
Lincoln & Hastings-Krny,68358,1956,83,46,39,168,0.085889571
Minneapolis-St. Paul,56073,17150,555,552,366,1473,0.085889213
Houston,77459,94390,3294,2635,2178,8107,0.085888336
Nashville,37030,7475,222,197,223,642,0.085886288
New York,8863,12214,308,335,406,1049,0.08588505
Paducah-Cape Girard-Harsbg,63848,1176,41,32,28,101,0.085884354
Greenvll-Spart-Ashevll-And,29624,14997,420,398,470,1288,0.085883843
Lubbock,79322,1700,67,36,43,146,0.085882353
Lubbock,79041,2911,102,85,63,250,0.085881141
Louisville,40008,4320,130,121,120,371,0.08587963
Topeka,66088,2422,83,62,63,208,0.085879438
New York,12569,10084,298,288,280,866,0.08587862
Honolulu,96789,54776,1656,1575,1473,4704,0.085877026
Shreveport,75691,4751,165,132,111,408,0.085876658
Grand Rapids-Kalmzoo-B.Crk,49064,3738,117,107,97,321,0.085874799
"Lafayette, IN",47971,1805,54,51,50,155,0.085872576
Richmond-Petersburg,23060,39804,1227,1108,1083,3418,0.085870767
Dallas-Ft. Worth,75449,1281,43,30,37,110,0.085870414
Yakima-Pasco-Rchlnd-Knnwck,99353,19355,694,544,424,1662,0.085869284
Nashville,37355,29941,912,840,819,2571,0.085868875
Dallas-Ft. Worth,75007,51731,1462,1492,1488,4442,0.085867275
Salt Lake City,84754,4507,173,122,92,387,0.08586643
South Bend-Elkhart,46542,4903,166,131,124,421,0.085865796
Peoria-Bloomington,61741,1514,51,38,41,130,0.085865258
Philadelphia,19036,13312,346,362,435,1143,0.08586238
Charleston-Huntington,41189,2376,74,73,57,204,0.085858586
"Tri-Cities, TN-VA",37891,3867,115,120,97,332,0.085854668
Harrisburg-Lncstr-Leb-York,17522,34548,982,990,994,2966,0.085851569
Indianapolis,46994,2516,88,62,66,216,0.085850556
Green Bay-Appleton,54107,3774,122,106,96,324,0.085850556
San Francisco-Oak-San Jose,95037,52638,1640,1608,1271,4519,0.085850526
Portland-Auburn,4254,2947,86,71,96,253,0.085850017
Jacksonville,32207,40233,1080,1132,1242,3454,0.085849924
"Alexandria, LA",71430,2120,71,61,50,182,0.085849057
Little Rock-Pine Bluff,71670,1060,38,31,22,91,0.085849057
Tyler-Longview(Lfkn&Ncgd),75644,12126,387,359,295,1041,0.08584859
Johnstown-Altoona-St Colge,16641,2388,75,69,61,205,0.085845896
Charlotte,28086,27503,808,779,774,2361,0.085845181
St. Louis,62204,4182,124,137,98,359,0.085844094
Tulsa,74437,10403,326,298,269,893,0.085840623
Pittsburgh,15949,699,19,24,17,60,0.08583691
Charlotte,28032,3367,91,94,104,289,0.085833086
Dayton,45828,6443,190,175,188,553,0.085829582
Tampa-St. Pete (Sarasota),34251,7620,257,206,191,654,0.085826772
Huntsville-Decatur (Flor),35620,10568,338,287,282,907,0.085825132
Traverse City-Cadillac,49601,21894,690,606,583,1879,0.0858226
Shreveport,75683,4020,149,102,94,345,0.085820896
Paducah-Cape Girard-Harsbg,42459,4055,139,100,109,348,0.085819975
Little Rock-Pine Bluff,71671,7842,245,224,204,673,0.085819944
Cleveland-Akron (Canton),44103,14391,355,446,434,1235,0.085817525
St. Louis,62052,12352,371,343,346,1060,0.085816062
Detroit,48188,46367,1429,1274,1276,3979,0.085815343
Philadelphia,8031,11700,301,326,377,1004,0.085811966
Augusta-Aiken,29831,3671,121,105,89,315,0.085807682
Chicago,60107,38004,1081,1040,1140,3261,0.085806757
Greenville-N.Bern-Washngtn,28454,3135,96,74,99,269,0.085805423
Macon,31060,1585,56,45,35,136,0.085804416
Tampa-St. Pete (Sarasota),33849,641,18,17,20,55,0.085803432
San Diego,92082,22319,726,606,583,1915,0.085801335
Minneapolis-St. Paul,55055,3648,103,102,108,313,0.085800439
New York,11801,42261,1035,1211,1380,3626,0.085800147
"Tri-Cities, TN-VA",41731,1014,32,29,26,87,0.085798817
Joplin-Pittsburg,64752,676,21,23,14,58,0.085798817
Wichita-Hutchinson Plus,67735,5175,170,145,129,444,0.085797101
Birmingham (Ann and Tusc),35121,16248,485,477,432,1394,0.085795175
Utica,13318,1457,41,39,45,125,0.085792725
New York,11771,9593,282,301,240,823,0.085791723
Indianapolis,46256,22462,517,613,797,1927,0.085789333
Cleveland-Akron (Canton),44112,18732,491,528,588,1607,0.085789024
Albuquerque-Santa Fe,88346,3089,102,81,82,265,0.085788281
Milwaukee,53158,18349,547,497,530,1574,0.085781241
Bangor,4412,9571,252,291,278,821,0.08577996
Detroit,48183,42027,1113,1207,1285,3605,0.08577819
Atlanta,36272,12987,375,386,353,1114,0.085778086
Dallas-Ft. Worth,76689,4092,130,124,97,351,0.085777126
Knoxville,37877,8872,275,262,224,761,0.085775473
Dothan,36345,8639,279,250,212,741,0.085773816
Cincinnati,45042,27666,791,780,802,2373,0.085773151
"Springfield, MO",65536,29730,951,821,778,2550,0.085771948
Baton Rouge,70777,4069,135,117,97,349,0.08577046
Dallas-Ft. Worth,75077,39874,1273,1146,1001,3420,0.085770176
Kansas City,64641,513,13,19,12,44,0.085769981
New York,11209,71379,1605,1932,2585,6122,0.085767523
San Francisco-Oak-San Jose,95133,30012,703,833,1038,2574,0.085765694
Waco-Temple-Bryan,76638,3358,125,95,68,288,0.085765337
St. Joseph,64443,1166,28,41,31,100,0.085763293
Kansas City,64085,8850,249,245,265,759,0.085762712
Montgomery-Selma,36078,13771,406,400,375,1181,0.08575993
Grand Rapids-Kalmzoo-B.Crk,49417,33468,950,984,936,2870,0.085753556
Champaign&Sprngfld-Decatur,60957,5201,165,154,127,446,0.08575274
Sacramnto-Stkton-Modesto,95366,17994,597,513,433,1543,0.085750806
Portland-Auburn,4061,3417,116,81,96,293,0.085747732
Ft. Wayne,47380,1796,58,52,44,154,0.085746102
Bluefield-Beckley-Oak Hill,24870,3802,120,109,97,326,0.085744345
Dallas-Ft. Worth,75140,7861,246,232,196,674,0.085739728
Boston (Manchester),3055,16527,443,501,473,1417,0.085738489
"Columbus, OH",43138,18370,576,513,486,1575,0.085737616
"Columbus, OH",43347,1353,51,35,30,116,0.085735403
"Portland, OR",97220,31726,759,931,1030,2720,0.085734098
Greenville-N.Bern-Washngtn,28518,7885,249,219,208,676,0.085732403
Minneapolis-St. Paul,55070,9052,306,255,215,776,0.085726911
Minneapolis-St. Paul,55398,18012,623,507,414,1544,0.085720631
Cincinnati,47025,23542,723,681,614,2018,0.08571914
Ft. Wayne,45879,5973,178,175,159,512,0.085719069
Harrisburg-Lncstr-Leb-York,17262,1715,61,43,43,147,0.085714286
Bluefield-Beckley-Oak Hill,25855,70,2,2,2,6,0.085714286
Birmingham (Ann and Tusc),36256,1435,50,39,34,123,0.085714286
Charleston-Huntington,41524,280,9,9,6,24,0.085714286
Louisville,47110,385,13,11,9,33,0.085714286
Flint-Saginaw-Bay City,48878,1540,46,44,42,132,0.085714286
Des Moines-Ames,50062,980,34,28,22,84,0.085714286
Champaign&Sprngfld-Decatur,61913,1785,68,47,38,153,0.085714286
Omaha,68382,35,1,1,1,3,0.085714286
"Lafayette, LA",71356,280,11,6,7,24,0.085714286
Ft. Smith-Fay-Sprngdl-Rgrs,72749,35,1,1,1,3,0.085714286
Tulsa,74041,2415,85,64,58,207,0.085714286
Las Vegas,89017,175,7,5,3,15,0.085714286
Flint-Saginaw-Bay City,48768,9579,316,250,255,821,0.08570832
Oklahoma City,73065,11796,397,338,276,1011,0.085707019
Shreveport,71119,10116,296,316,255,867,0.085705813
Terre Haute,47501,17257,519,475,485,1479,0.085704352
Salisbury,21837,2812,106,80,55,241,0.085704125
"Lafayette, LA",70578,15892,495,424,443,1362,0.085703499
Denver,80651,5239,184,151,114,449,0.085703379
Marquette,49913,7246,229,227,165,621,0.085702457
New York,12545,4609,124,139,132,395,0.085701888
Tulsa,74964,2252,75,61,57,193,0.085701599
Grand Rapids-Kalmzoo-B.Crk,49092,2112,70,58,53,181,0.085700758
Savannah,30427,12357,401,326,332,1059,0.085700413
Milwaukee,53219,34738,906,997,1074,2977,0.085698659
Beaumont-Port Arthur,77662,25555,788,716,686,2190,0.085697515
"Washington, DC (Hagrstwn)",22211,1517,21,45,64,130,0.085695452
Bowling Green,42210,4236,130,120,113,363,0.085694051
Hattiesburg-Laurel,39443,22873,746,656,558,1960,0.085690552
Dothan,36376,2299,66,66,65,197,0.08568943
Chicago,60148,53461,1313,1462,1806,4581,0.085688633
Boston (Manchester),1844,54793,1525,1568,1602,4695,0.085686128
Syracuse,13101,2019,65,53,55,173,0.085685983
Louisville,47142,887,29,26,21,76,0.085682074
Sioux City,68030,817,25,26,19,70,0.085679315
Roanoke-Lynchburg,24540,31105,935,863,867,2665,0.085677544
Charleston-Huntington,25286,1529,57,44,30,131,0.085676913
Los Angeles,91776,36311,834,1015,1262,3111,0.085676517
Memphis,72386,1494,48,43,37,128,0.085676037
Ft. Wayne,43526,5941,187,161,161,509,0.085675812
New Orleans,70438,18781,577,544,488,1609,0.085671689
Charlotte,28134,13400,356,366,426,1148,0.085671642
Des Moines-Ames,50050,642,24,17,14,55,0.085669782
Champaign&Sprngfld-Decatur,62712,10097,313,297,255,865,0.085669011
Shreveport,71235,4319,122,130,118,370,0.085667979
Knoxville,37771,18105,549,483,519,1551,0.085666943
Louisville,40245,39199,1221,1086,1051,3358,0.085665451
Oklahoma City,73755,572,16,20,13,49,0.085664336
Jacksonville,32177,26779,793,759,742,2294,0.08566414
Charleston-Huntington,25301,2790,41,83,115,239,0.085663082
Hartford & New Haven,6512,30013,751,860,960,2571,0.085662879
Buffalo,14032,8872,315,273,172,760,0.085662759
Bluefield-Beckley-Oak Hill,24740,16250,472,469,451,1392,0.085661538
"Albany, GA",31624,1576,45,47,43,135,0.085659898
Paducah-Cape Girard-Harsbg,42001,31894,870,867,995,2732,0.085658745
Kansas City,64630,502,18,11,14,43,0.085657371
Montgomery-Selma,36020,1471,43,38,45,126,0.085656016
Kansas City,65334,934,32,23,25,80,0.085653105
Houston,77355,32224,1073,927,760,2760,0.085650447
Jonesboro,72425,432,14,12,11,37,0.085648148
Augusta-Aiken,30434,5336,148,156,153,457,0.085644678
Minneapolis-St. Paul,55318,33594,1135,929,813,2877,0.085640293
Paducah-Cape Girard-Harsbg,62872,1156,39,28,32,99,0.085640138
Wichita-Hutchinson Plus,67867,1518,48,38,44,130,0.085638999
Minneapolis-St. Paul,55129,36865,1462,980,715,3157,0.085636783
Hartford & New Haven,6417,4344,119,139,114,372,0.085635359
Pittsburgh,16045,1086,33,28,32,93,0.085635359
Toledo,43536,362,13,10,8,31,0.085635359
Chicago,60487,26450,813,733,719,2265,0.08563327
Grand Rapids-Kalmzoo-B.Crk,49323,10183,359,273,240,872,0.085632918
Salt Lake City,83228,689,33,10,16,59,0.08563135
Chicago,60517,31963,857,884,996,2737,0.08563026
Chicago,46365,1016,37,25,25,87,0.085629921
Memphis,38058,11106,343,307,301,951,0.08562939
St. Louis,63050,16782,579,488,370,1437,0.085627458
New York,7512,11515,286,345,355,986,0.085627442
Little Rock-Pine Bluff,71667,7124,221,206,183,610,0.085626053
Louisville,40057,3457,119,96,81,296,0.085623373
Orlando-Daytona Bch-Melbrn,34736,31686,1000,906,807,2713,0.08562141
Nashville,42266,2768,81,76,80,237,0.085621387
Detroit,48426,911,30,28,20,78,0.085620198
Las Vegas,89008,1203,39,42,22,103,0.085619285
Buffalo,14775,2336,76,64,60,200,0.085616438
New Orleans,70357,2266,61,64,69,194,0.085613416
Shreveport,75656,4532,142,131,115,388,0.085613416
Ottumwa-Kirksville,63530,841,28,22,22,72,0.085612366
Toledo,44817,1390,45,38,36,119,0.085611511
"Columbus, OH",43148,2710,95,65,72,232,0.085608856
Dayton,45860,2605,81,77,65,223,0.085604607
Cincinnati,47250,22534,609,616,704,1929,0.085603976
Shreveport,71854,35676,1054,937,1063,3054,0.085603767
Champaign&Sprngfld-Decatur,62530,1437,40,42,41,123,0.08559499
Macon,31069,25317,780,678,709,2167,0.08559466
Evansville,42431,26194,818,709,715,2242,0.08559212
Medford-Klamath Falls,97633,1402,48,37,35,120,0.085592011
New York,7012,12805,323,349,424,1096,0.085591566
Knoxville,40828,4393,143,123,110,376,0.085590712
Greensboro-H.Point-W.Salem,27455,30530,875,828,910,2613,0.085587946
Detroit,48892,4288,135,118,114,367,0.085587687
Jonesboro,72461,3143,105,82,82,269,0.085587019
Orlando-Daytona Bch-Melbrn,34471,28182,801,800,811,2412,0.085586545
Austin,78749,36677,818,846,1475,3139,0.085584972
Louisville,47165,6076,190,168,162,520,0.08558262
Chicago,60407,1519,44,46,40,130,0.08558262
Cedar Rapids-Wtrlo-IWC&Dub,52213,4487,182,115,87,384,0.085580566
Sacramnto-Stkton-Modesto,95638,2337,75,62,63,200,0.085579803
New York,8835,10903,308,300,325,933,0.085572778
Dallas-Ft. Worth,76064,1753,52,54,44,150,0.085567598
Wilkes Barre-Scranton-Hztn,17855,970,31,27,25,83,0.08556701
Memphis,38647,1344,40,34,41,115,0.085565476
Minneapolis-St. Paul,55341,4336,167,121,83,371,0.085562731
Lexington,42501,19027,570,516,542,1628,0.085562622
"Rochester, NY",14415,187,7,5,4,16,0.085561497
Grand Rapids-Kalmzoo-B.Crk,48865,1683,47,59,38,144,0.085561497
Macon,31089,4348,136,126,110,372,0.085556578
Colorado Springs-Pueblo,80928,1087,37,29,27,93,0.085556578
Dayton,45885,12483,358,341,369,1068,0.085556357
Baltimore,21215,52270,1386,1480,1606,4472,0.085555768
New York,11598,14400,553,391,288,1232,0.085555556
Champaign&Sprngfld-Decatur,62513,1613,70,36,32,138,0.085554867
Monroe-El Dorado,71238,3226,117,86,73,276,0.085554867
Savannah,30450,2478,78,73,61,212,0.085552865
New York,6807,7446,288,209,140,637,0.085549288
Minneapolis-St. Paul,54812,6055,179,178,161,518,0.085549133
Nashville,38482,1882,60,58,43,161,0.08554729
Champaign&Sprngfld-Decatur,62677,2373,86,57,60,203,0.085545723
Elmira (Corning),16912,2455,60,69,81,210,0.085539715
Des Moines-Ames,51462,982,37,26,21,84,0.085539715
Philadelphia,8063,3098,86,80,99,265,0.085539057
Charleston-Huntington,45651,5214,162,158,126,446,0.085538934
Yakima-Pasco-Rchlnd-Knnwck,97826,1134,44,22,31,97,0.085537919
Burlington-Plattsburgh,5732,643,21,21,13,55,0.085536547
Boston (Manchester),2368,34980,928,960,1104,2992,0.085534591
Los Angeles,91748,42580,1054,1217,1371,3642,0.085533114
Indianapolis,46913,1251,41,37,29,107,0.085531575
Atlanta,30547,3566,105,94,106,305,0.085530006
New York,11370,31615,738,893,1073,2704,0.085529021
Detroit,48074,9763,288,285,262,835,0.08552699
New Orleans,70356,1976,63,51,55,169,0.085526316
New York,7828,14487,439,397,403,1239,0.085524953
Boise,83676,5215,189,147,110,446,0.085522531
Pittsburgh,15010,28309,963,783,675,2421,0.085520506
Charleston-Huntington,41179,7589,240,222,187,649,0.085518514
Little Rock-Pine Bluff,72150,12407,406,329,326,1061,0.085516241
Atlanta,30558,6151,187,168,171,526,0.08551455
Austin,76574,20593,618,589,554,1761,0.085514495
Dallas-Ft. Worth,75238,32603,947,902,939,2788,0.085513603
Minneapolis-St. Paul,56229,1684,58,45,41,144,0.085510689
New York,10920,8537,263,235,232,730,0.085510132
Salt Lake City,84092,29296,1057,811,637,2505,0.085506554
"Columbia, SC",29040,8327,232,227,253,712,0.085504984
Boston (Manchester),1475,10327,292,287,304,883,0.085504019
Beaumont-Port Arthur,77630,29742,917,806,820,2543,0.085501984
"Jackson, TN",38347,269,10,8,5,23,0.085501859
Charlotte,28211,33438,957,945,957,2859,0.085501525
Indianapolis,47203,27251,857,738,735,2330,0.085501449
Lansing,48849,5813,186,153,158,497,0.085498022
Jacksonville,32234,8316,251,219,241,711,0.085497835
Tyler-Longview(Lfkn&Ncgd),75667,1579,52,47,36,135,0.08549715
Albuquerque-Santa Fe,88045,2971,100,82,72,254,0.0854931
"Springfield, MO",65712,8492,280,209,237,726,0.085492228
Philadelphia,8079,11311,343,300,324,967,0.085491999
Hartford & New Haven,6492,44531,1265,1223,1319,3807,0.085491006
St. Louis,62010,11124,304,304,343,951,0.085490831
St. Louis,62294,15335,490,428,393,1311,0.085490708
Mobile-Pensacola (Ft Walt),36582,25162,706,727,718,2151,0.08548605
Tampa-St. Pete (Sarasota),33603,18939,393,538,688,1619,0.085484978
Augusta-Aiken,29006,9955,307,267,277,851,0.085484681
Charleston-Huntington,25567,620,17,17,19,53,0.085483871
Binghamton,13752,737,25,26,12,63,0.085481682
Green Bay-Appleton,54180,3416,116,95,81,292,0.085480094
Charlotte,28270,34628,1157,970,833,2960,0.085479958
New York,7728,56762,1627,1653,1572,4852,0.085479722
Huntsville-Decatur (Flor),35650,13454,410,369,371,1150,0.085476438
Paducah-Cape Girard-Harsbg,62864,22755,651,642,652,1945,0.08547572
Minneapolis-St. Paul,55052,1907,57,55,51,163,0.085474567
Nashville,37090,21902,619,611,642,1872,0.085471646
Indianapolis,46142,31720,909,841,961,2711,0.085466583
Los Angeles,91320,42485,1361,1257,1013,3631,0.085465458
Dallas-Ft. Worth,76225,4107,136,113,102,351,0.085463842
New York,11704,40263,1108,1108,1225,3441,0.08546308
Boise,83660,6810,228,193,161,582,0.085462555
New York,7028,8144,315,239,142,696,0.08546169
Youngstown,44471,10239,302,273,300,875,0.085457564
Montgomery-Selma,36042,1334,48,38,28,114,0.085457271
Las Vegas,89109,8683,107,328,307,742,0.085454336
Philadelphia,8078,7864,206,202,264,672,0.085452696
Seattle-Tacoma,98311,28273,765,763,888,2416,0.085452552
Los Angeles,91007,32815,958,971,875,2804,0.085448728
"Portland, OR",97206,50943,1115,1342,1896,4353,0.085448442
Rapid City,82801,27339,904,717,715,2336,0.0854457
Chattanooga,35744,2645,78,74,74,226,0.085444234
Los Angeles,91205,35731,748,952,1353,3053,0.085444012
Detroit,48040,10112,325,302,237,864,0.085443038
Philadelphia,19094,4506,136,124,125,385,0.085441633
Montgomery-Selma,36726,4506,130,138,117,385,0.085441633
Boston (Manchester),3878,12254,306,321,420,1047,0.085441488
Sherman-Ada,74572,1346,38,42,35,115,0.085438336
Hartford & New Haven,6330,3289,85,100,96,281,0.085436303
Cleveland-Akron (Canton),44645,2458,66,74,70,210,0.085435313
Columbus-Tupelo-West Point,39354,1627,63,43,33,139,0.085433313
Seattle-Tacoma,98264,24417,823,668,595,2086,0.085432281
Boston (Manchester),1543,9610,335,275,211,821,0.085431842
Little Rock-Pine Bluff,72823,6473,211,179,163,553,0.085431794
Madison,53913,20894,600,587,598,1785,0.085431224
Champaign&Sprngfld-Decatur,61858,2704,102,65,64,231,0.085428994
Huntsville-Decatur (Flor),35603,32495,912,909,955,2776,0.085428527
St. Louis,63379,29159,905,805,781,2491,0.08542817
Louisville,42361,597,21,15,15,51,0.085427136
Wichita-Hutchinson Plus,67842,398,14,10,10,34,0.085427136
Houston,77371,8358,282,223,209,714,0.085427136
Anchorage,99645,30893,1037,904,698,2639,0.085423882
Topeka,66539,2751,101,73,61,235,0.085423482
Buffalo,14784,1077,23,35,34,92,0.08542247
New York,7072,6626,171,187,208,566,0.085421069
New York,12590,35097,913,1038,1047,2998,0.085420406
Seattle-Tacoma,98408,21248,589,551,675,1815,0.085419804
North Platte,69101,27629,875,771,714,2360,0.085417496
Knoxville,37890,7399,222,211,199,632,0.085416948
Evansville,42453,480,17,10,14,41,0.085416667
Wichita-Hutchinson Plus,67223,480,17,13,11,41,0.085416667
"Rochester, NY",14464,6966,221,174,200,595,0.085414872
Youngstown,44483,24504,702,706,685,2093,0.085414626
Lincoln & Hastings-Krny,68955,2084,73,59,46,178,0.085412668
Baton Rouge,70390,6533,197,193,168,558,0.085412521
Shreveport,75692,5374,179,154,126,459,0.085411239
Chicago,60541,3009,101,90,66,257,0.085410435
Lubbock,79351,1124,40,30,26,96,0.085409253
Cleveland-Akron (Canton),44004,31098,904,833,919,2656,0.085407422
New York,7642,10011,296,297,262,855,0.085406053
Pittsburgh,15747,2131,72,59,51,182,0.085405913
Joplin-Pittsburg,64755,2775,94,78,65,237,0.085405405
Memphis,38834,27317,841,763,729,2333,0.085404693
Hattiesburg-Laurel,39577,10831,309,309,307,925,0.08540301
San Antonio,78014,5117,164,138,135,437,0.085401603
New York,8876,24789,629,655,833,2117,0.085400783
"Washington, DC (Hagrstwn)",20170,41511,1148,1183,1214,3545,0.085399051
Quincy-Hannibal-Keokuk,62320,2260,82,64,47,193,0.08539823
Juneau,99835,8162,224,237,236,697,0.085395736
Norfolk-Portsmth-Newpt Nws,23847,12612,382,355,340,1077,0.085394862
Columbus-Tupelo-West Point,39730,10516,334,294,270,898,0.085393686
Oklahoma City,73760,445,16,12,10,38,0.085393258
Ft. Smith-Fay-Sprngdl-Rgrs,72916,9076,250,260,265,775,0.08539004
Cincinnati,41056,13737,415,399,359,1173,0.085389823
Philadelphia,19380,51646,1310,1492,1608,4410,0.085388994
Youngstown,44431,4743,150,134,121,405,0.085388994
Ft. Wayne,46732,2881,97,74,75,246,0.085387018
Charleston-Huntington,25704,14429,398,419,415,1232,0.085383602
Albany-Schenectady-Troy,1230,8983,427,174,166,767,0.085383502
Lansing,48842,21562,662,583,596,1841,0.08538169
St. Louis,63622,773,28,20,18,66,0.08538163
Portland-Auburn,4073,17699,473,508,530,1511,0.085372055
Tampa-St. Pete (Sarasota),33781,28816,747,824,889,2460,0.085369239
New York,7627,4838,181,144,88,413,0.085365854
Johnstown-Altoona-St Colge,15562,82,3,2,2,7,0.085365854
Johnstown-Altoona-St Colge,16682,82,3,2,2,7,0.085365854
Wichita Falls & Lawton,73434,574,18,19,12,49,0.085365854
Boston (Manchester),2492,20875,800,661,321,1782,0.085365269
Los Angeles,91780,34418,893,1021,1024,2938,0.08536231
Indianapolis,46917,1605,56,45,36,137,0.085358255
Las Vegas,89117,55275,1218,1521,1979,4718,0.085355043
Atlanta,30214,33730,1061,920,898,2879,0.085354284
Chicago,60174,31797,904,899,911,2714,0.085353964
Detroit,48065,11564,329,357,301,987,0.08535109
"Columbus, OH",43080,5788,178,169,147,494,0.085348998
Corpus Christi,78409,2730,82,75,76,233,0.085347985
Memphis,38625,1324,37,39,37,113,0.085347432
Seattle-Tacoma,98203,38398,1011,1077,1189,3277,0.085342987
Louisville,47114,457,15,16,8,39,0.085339168
Champaign&Sprngfld-Decatur,62673,457,7,13,19,39,0.085339168
Bowling Green,42749,5402,159,155,147,461,0.085338763
New York,7704,6328,264,184,92,540,0.085335019
Shreveport,75561,5039,152,158,120,430,0.085334392
St. Louis,63119,34676,1108,1073,778,2959,0.085332795
Ottumwa-Kirksville,63437,1418,49,39,33,121,0.085331453
Evansville,42455,3305,120,88,74,282,0.085325265
Toledo,43537,28667,800,844,802,2446,0.085324589
Raleigh-Durham (Fayetvlle),28366,4395,130,131,114,375,0.085324232
Toledo,43619,8298,228,239,241,708,0.085321764
Oklahoma City,74875,1090,35,31,27,93,0.085321101
Burlington-Plattsburgh,5775,504,19,13,11,43,0.08531746
Salt Lake City,84022,504,12,16,15,43,0.08531746
Richmond-Petersburg,23027,1430,38,42,42,122,0.085314685
"Columbus, OH",43728,1137,41,32,24,97,0.085312225
Des Moines-Ames,50525,3411,112,92,87,291,0.085312225
Wichita Falls & Lawton,73552,1348,47,43,25,115,0.085311573
Denver,80023,28332,1058,776,583,2417,0.085309897
Minneapolis-St. Paul,56434,211,8,6,4,18,0.085308057
"Washington, DC (Hagrstwn)",22046,19401,668,504,483,1655,0.085304881
Beaumont-Port Arthur,77659,5498,177,164,128,469,0.085303747
Miami-Ft. Lauderdale,33166,32872,813,881,1110,2804,0.08530056
Youngstown,44420,14619,389,433,425,1247,0.085299952
Greenvll-Spart-Ashevll-And,29687,45757,1334,1192,1377,3903,0.085298424
Roanoke-Lynchburg,24138,1571,48,42,44,134,0.08529599
Atlanta,30530,7058,207,192,203,602,0.085293284
New York,12548,1278,38,33,38,109,0.085289515
Denver,82633,9884,312,277,254,843,0.085289357
Bluefield-Beckley-Oak Hill,25848,469,15,15,10,40,0.085287846
Nashville,37049,3764,121,103,97,321,0.085281615
Ottumwa-Kirksville,52553,1712,60,42,44,146,0.085280374
Evansville,42442,2955,92,82,78,252,0.085279188
Tampa-St. Pete (Sarasota),33837,50283,1443,1365,1480,4288,0.08527733
Los Angeles,90254,18962,457,518,642,1617,0.085275815
Roanoke-Lynchburg,24124,4550,129,136,123,388,0.085274725
Bluefield-Beckley-Oak Hill,25932,387,12,10,11,33,0.085271318
Bowling Green,42285,387,14,10,9,33,0.085271318
New York,10591,24909,677,762,685,2124,0.085270384
St. Louis,63125,32204,778,913,1055,2746,0.085268911
Little Rock-Pine Bluff,72029,1982,55,58,56,169,0.085267407
Minneapolis-St. Paul,55320,5219,160,135,150,445,0.085265377
Columbus-Tupelo-West Point,38824,7940,220,225,232,677,0.085264484
"Portland, OR",97355,34118,911,925,1073,2909,0.085262911
Philadelphia,8244,10239,244,301,328,873,0.085262233
Memphis,72327,1384,46,35,37,118,0.085260116
Lincoln & Hastings-Krny,68761,563,22,13,13,48,0.085257549
Detroit,48377,19928,464,517,718,1699,0.085256925
Harrisburg-Lncstr-Leb-York,17601,56887,1552,1747,1551,4850,0.085256737
Lexington,41093,2123,66,64,51,181,0.085256712
Oklahoma City,73044,26884,909,692,691,2292,0.08525517
Bangor,4967,3906,125,119,89,333,0.085253456
Chicago,60950,11718,376,335,288,999,0.085253456
Little Rock-Pine Bluff,71675,1736,48,54,46,148,0.085253456
Philadelphia,8057,21747,743,614,497,1854,0.085253138
"Columbus, GA (Opelika, AL)",36879,3085,111,84,68,263,0.085251216
Atlanta,31064,10733,337,314,264,915,0.085251095
Pittsburgh,15218,13009,252,368,489,1109,0.085248674
Lansing,49282,305,10,8,8,26,0.085245902
Fargo,56566,305,10,9,7,26,0.085245902
Austin,78641,105309,3646,2895,2436,8977,0.085244376
"Lafayette, LA",70380,20344,622,553,559,1734,0.085233976
Birmingham (Ann and Tusc),35005,7239,219,199,199,617,0.085232767
Syracuse,13209,12155,323,365,348,1036,0.085232415
"Charleston, SC",29450,4048,124,117,104,345,0.085227273
New York,11720,28829,761,811,885,2457,0.085226681
Philadelphia,19606,36233,1103,1025,960,3088,0.085226175
Minneapolis-St. Paul,56058,6254,203,174,156,533,0.085225456
Charleston-Huntington,25313,12156,336,322,378,1036,0.085225403
San Francisco-Oak-San Jose,94579,21508,567,612,654,1833,0.085224103
Cincinnati,45002,16134,526,445,404,1375,0.085223751
"Tri-Cities, TN-VA",41749,3086,88,83,92,263,0.08522359
Omaha,51570,1103,31,25,38,94,0.085222121
Philadelphia,8340,751,21,21,22,64,0.085219707
Macon,31063,4471,128,135,118,381,0.085215835
Sioux Falls(Mitchell),57353,798,31,21,16,68,0.085213033
Monroe-El Dorado,71295,13883,443,388,352,1183,0.08521213
Cleveland-Akron (Canton),44851,4835,142,138,132,412,0.085211996
Rockford,61010,7546,245,209,189,643,0.085210708
Dayton,45348,1021,33,30,24,87,0.085210578
Oklahoma City,74059,5950,198,140,169,507,0.085210084
Boise,83627,622,21,19,13,53,0.085209003
Boston (Manchester),2451,18767,347,460,792,1599,0.08520275
Utica,13339,6244,197,168,167,532,0.085201794
Cheyenne-Scottsbluff,69356,1784,60,54,38,152,0.085201794
New York,10918,12547,365,349,355,1069,0.085199649
Little Rock-Pine Bluff,72120,35389,1048,993,974,3015,0.085195965
Peoria-Bloomington,61729,1209,45,29,29,103,0.085194376
Chattanooga,35978,5200,168,136,139,443,0.085192308
"Columbus, OH",43113,24134,718,697,641,2056,0.085191017
Birmingham (Ann and Tusc),35117,6691,210,181,179,570,0.08518906
Miami-Ft. Lauderdale,33183,35111,948,1023,1020,2991,0.085186978
Topeka,66449,810,32,18,19,69,0.085185185
Salt Lake City,89828,270,12,6,5,23,0.085185185
Atlanta,30565,4778,147,130,130,407,0.085182085
Monterey-Salinas,95062,34750,782,1037,1141,2960,0.085179856
Harrisburg-Lncstr-Leb-York,17319,11329,352,302,311,965,0.085179628
Cedar Rapids-Wtrlo-IWC&Dub,52247,5964,220,158,130,508,0.085177733
Hattiesburg-Laurel,39425,1538,47,44,40,131,0.085175553
Topeka,66547,9275,311,254,225,790,0.085175202
Ft. Smith-Fay-Sprngdl-Rgrs,72927,8371,240,229,244,713,0.085175009
Denver,80503,35352,1017,1018,976,3011,0.085171985
Knoxville,37819,775,29,16,21,66,0.08516129
New Orleans,70345,8631,284,224,227,735,0.085158151
"Columbus, OH",43123,68532,1962,1907,1967,5836,0.085157299
"Lafayette, LA",70584,7680,246,212,196,654,0.08515625
Cleveland-Akron (Canton),44212,45646,1411,1288,1188,3887,0.085155326
Denver,80643,4439,121,134,123,378,0.085154314
Cincinnati,47023,1785,64,48,40,152,0.085154062
Miami-Ft. Lauderdale,33176,50803,1357,1498,1471,4326,0.085152452
Kansas City,66215,26212,639,728,865,2232,0.085151839
Cincinnati,41015,20094,540,556,615,1711,0.085149796
Cincinnati,45660,7810,233,232,200,665,0.085147247
Richmond-Petersburg,23112,60155,2016,1650,1456,5122,0.085146704
Atlanta,36262,1656,52,45,44,141,0.085144928
Indianapolis,46055,17394,674,456,351,1481,0.085144303
Atlanta,30188,73324,2193,2107,1943,6243,0.085142655
Philadelphia,19137,8304,253,223,231,707,0.085139692
Chicago,60479,646,19,17,19,55,0.085139319
Cleveland-Akron (Canton),44094,38197,971,1098,1183,3252,0.085137576
Tulsa,74352,6202,197,165,166,528,0.085133828
Detroit,48362,14953,425,418,430,1273,0.085133418
Sioux Falls(Mitchell),51243,787,19,26,22,67,0.085133418
Detroit,48472,1621,59,40,39,138,0.085132634
Wilkes Barre-Scranton-Hztn,18346,2455,67,67,75,209,0.085132383
Evansville,47611,881,24,25,26,75,0.085130533
Davenport-R.Island-Moline,52254,881,39,18,18,75,0.085130533
Louisville,47172,20451,648,562,531,1741,0.085130311
Indianapolis,47926,1069,36,27,28,91,0.085126286
Beaumont-Port Arthur,77656,17539,569,468,456,1493,0.08512458
Dallas-Ft. Worth,76431,3536,121,97,83,301,0.085124434
Augusta-Aiken,29809,2420,74,66,66,206,0.085123967
Denver,80504,65975,2131,1810,1675,5616,0.085123153
Minneapolis-St. Paul,54013,3818,143,108,74,325,0.085123101
Detroit,48094,20441,658,581,501,1740,0.085123037
Oklahoma City,73059,2702,98,64,68,230,0.085122132
Macon,31054,1539,39,49,43,131,0.085120208
"Columbus, OH",45690,13534,393,388,371,1152,0.08511896
Chattanooga,30711,3454,100,94,100,294,0.085118703
Birmingham (Ann and Tusc),36750,2996,90,81,84,255,0.085113485
Chattanooga,30728,19057,537,537,548,1622,0.085113082
New York,10911,47,1,1,2,4,0.085106383
Wheeling-Steubenville,26162,141,5,4,3,12,0.085106383
Cincinnati,41052,141,5,4,3,12,0.085106383
"Tri-Cities, TN-VA",41845,141,4,4,4,12,0.085106383
Des Moines-Ames,50149,987,39,26,19,84,0.085106383
Billings,59081,47,1,1,2,4,0.085106383
Wichita-Hutchinson Plus,67568,282,11,8,5,24,0.085106383
Ft. Wayne,46706,20504,601,586,558,1745,0.085105345
Anchorage,99611,16533,514,480,413,1407,0.085102522
Seattle-Tacoma,98338,32573,1054,900,818,2772,0.085101157
Nashville,42206,6087,189,164,165,518,0.085099392
Charlotte,29717,1422,48,42,31,121,0.085091421
Ft. Smith-Fay-Sprngdl-Rgrs,72727,6887,212,193,181,586,0.085087847
Ft. Smith-Fay-Sprngdl-Rgrs,74902,4231,117,122,121,360,0.085086268
Tampa-St. Pete (Sarasota),34639,28901,864,777,818,2459,0.085083561
Fresno-Visalia,93619,54326,1938,1480,1204,4622,0.085078968
Charleston-Huntington,45638,19559,541,548,575,1664,0.085075924
Champaign&Sprngfld-Decatur,60929,670,25,13,19,57,0.085074627
Youngstown,44512,32736,840,923,1022,2785,0.085074536
Champaign&Sprngfld-Decatur,62401,19242,540,525,572,1637,0.085074317
"Washington, DC (Hagrstwn)",21783,9580,323,262,230,815,0.085073069
Birmingham (Ann and Tusc),35952,7958,247,211,219,677,0.085071626
Greenvll-Spart-Ashevll-And,29365,15058,462,418,401,1281,0.085071059
Zanesville,43734,1199,44,31,27,102,0.085070892
Richmond-Petersburg,23229,35149,1121,1020,849,2990,0.085066431
Cincinnati,45244,28814,959,828,664,2451,0.085062817
Lexington,42516,482,19,12,10,41,0.085062241
Philadelphia,19114,30813,806,853,962,2621,0.0850615
San Francisco-Oak-San Jose,94605,44415,1180,1290,1308,3778,0.085061353
Albany-Schenectady-Troy,12185,1881,55,52,53,160,0.085061138
Sioux City,68791,1787,52,46,54,152,0.085058758
Amarillo,79245,2175,60,68,57,185,0.085057471
Tampa-St. Pete (Sarasota),33811,29051,830,790,851,2471,0.085057313
Bluefield-Beckley-Oak Hill,24828,1258,41,36,30,107,0.085055644
Evansville,47630,40340,1368,1076,987,3431,0.085052058
New York,10580,19106,785,517,323,1625,0.085051816
Greenville-N.Bern-Washngtn,28501,17413,528,470,483,1481,0.085051398
Birmingham (Ann and Tusc),35619,5385,172,147,139,458,0.085051068
New Orleans,70083,2187,81,63,42,186,0.085048011
Cleveland-Akron (Canton),44134,37391,966,996,1218,3180,0.085047204
Joplin-Pittsburg,66763,3210,93,99,81,273,0.085046729
"Lafayette, LA",70563,19166,593,526,511,1630,0.085046436
Lexington,41721,682,25,17,16,58,0.085043988
Oklahoma City,73173,4433,174,117,86,377,0.085043988
Idaho Fals-Pocatllo(Jcksn),83423,682,19,18,21,58,0.085043988
New York,11763,28998,798,806,862,2466,0.085040348
Monroe-El Dorado,71730,30609,951,837,815,2603,0.085040348
Indianapolis,47356,5821,192,164,139,495,0.085036935
Shreveport,71024,1223,37,40,27,104,0.085036795
Ft. Smith-Fay-Sprngdl-Rgrs,72834,10031,332,265,256,853,0.085036387
Huntsville-Decatur (Flor),35986,8420,264,239,213,716,0.085035629
New York,7450,25872,974,783,443,2200,0.085034014
Nashville,37148,26460,835,730,685,2250,0.085034014
Bismarck-Mnt-Dcknsn(Wlstn),59221,1964,68,51,48,167,0.08503055
Kansas City,64062,6245,212,180,139,531,0.085028022
Lincoln & Hastings-Krny,68810,1082,32,35,25,92,0.085027726
New York,11795,24792,697,733,678,2108,0.085027428
Panama City,32401,20864,560,617,597,1774,0.08502684
Philadelphia,8061,3740,129,93,96,318,0.085026738
Los Angeles,92660,36238,932,996,1153,3081,0.085021248
Wilkes Barre-Scranton-Hztn,18837,2964,99,86,67,252,0.085020243
Bluefield-Beckley-Oak Hill,25917,1882,58,54,48,160,0.08501594
Birmingham (Ann and Tusc),35043,14809,534,379,346,1259,0.085015869
Watertown,13630,1635,57,44,38,139,0.085015291
Indianapolis,46910,3270,102,99,77,278,0.085015291
"Albany, GA",31622,1788,61,52,39,152,0.085011186
"Columbus, OH",45613,3129,99,83,84,266,0.085011186
Shreveport,75643,1988,57,59,53,169,0.08501006
Minneapolis-St. Paul,56209,2341,82,63,54,199,0.085006408
Louisville,40078,2447,75,71,62,208,0.085002043
Louisville,40291,41705,1194,1125,1226,3545,0.085001798
Lexington,41745,200,7,5,5,17,0.085
Des Moines-Ames,50218,200,7,5,5,17,0.085
Baltimore,21015,31956,1036,899,781,2716,0.084991864
Des Moines-Ames,50327,12731,417,347,318,1082,0.084989396
Champaign&Sprngfld-Decatur,60955,1612,61,37,39,137,0.084987593
Victoria,77968,3483,116,106,74,296,0.084984209
Omaha,51549,506,10,15,18,43,0.084980237
Baton Rouge,70453,1012,31,29,26,86,0.084980237
Bluefield-Beckley-Oak Hill,25007,659,24,21,11,56,0.084977238
Knoxville,37863,6696,193,187,189,569,0.084976105
Philadelphia,8027,4872,124,152,138,414,0.084975369
Indianapolis,47929,812,23,23,23,69,0.084975369
Monterey-Salinas,95043,812,34,14,21,69,0.084975369
South Bend-Elkhart,49120,36705,1094,1058,967,3119,0.084974799
New York,10704,33199,762,975,1084,2821,0.084972439
Milwaukee,53129,14676,450,424,373,1247,0.084968656
"Columbus, GA (Opelika, AL)",31831,4590,159,119,112,390,0.08496732
Charleston-Huntington,41169,5661,178,171,132,481,0.08496732
Billings,59006,918,37,18,23,78,0.08496732
New Orleans,70354,4237,132,113,115,360,0.084965778
Paducah-Cape Girard-Harsbg,62918,11440,342,318,312,972,0.084965035
"Columbus, GA (Opelika, AL)",31807,2554,82,76,59,217,0.084964761
Dallas-Ft. Worth,75479,1942,69,49,47,165,0.084963955
Los Angeles,92679,31661,1030,957,703,2690,0.084962572
Binghamton,14892,7733,220,236,201,657,0.084960559
Pittsburgh,15132,19268,557,503,577,1637,0.084959518
Dothan,36351,3908,133,105,94,332,0.084953941
San Francisco-Oak-San Jose,94066,45166,1015,1302,1520,3837,0.084953283
Champaign&Sprngfld-Decatur,61875,824,19,21,30,70,0.084951456
Joplin-Pittsburg,67357,11489,348,313,315,976,0.084950823
Wichita-Hutchinson Plus,67871,5050,173,115,141,429,0.084950495
Davenport-R.Island-Moline,52069,1495,54,38,35,127,0.084949833
Mobile-Pensacola (Ft Walt),32501,11042,287,254,397,938,0.084948379
Lexington,40358,671,18,19,20,57,0.084947839
Cincinnati,45153,1813,59,48,47,154,0.084942085
Joplin-Pittsburg,67351,518,15,14,15,44,0.084942085
Seattle-Tacoma,98036,43336,1195,1220,1266,3681,0.084940927
New Orleans,70450,2696,84,81,64,229,0.084940653
"Columbus, GA (Opelika, AL)",31787,1660,50,51,40,141,0.084939759
Louisville,40165,37615,1160,987,1048,3195,0.084939519
Richmond-Petersburg,23923,2543,76,74,66,216,0.084939048
Minneapolis-St. Paul,55748,1248,45,28,33,106,0.084935897
Little Rock-Pine Bluff,72084,989,34,27,23,84,0.084934277
Dothan,36360,19074,510,582,528,1620,0.084932369
Wilkes Barre-Scranton-Hztn,17842,8926,293,230,235,758,0.084920457
San Francisco-Oak-San Jose,94506,25344,996,762,394,2152,0.084911616
Salisbury,19973,27417,812,764,752,2328,0.084910822
Mobile-Pensacola (Ft Walt),39423,2167,66,60,58,184,0.084910014
Lincoln & Hastings-Krny,68516,50795,1585,1318,1410,4313,0.084909932
Clarksburg-Weston,26267,530,16,15,14,45,0.08490566
Cedar Rapids-Wtrlo-IWC&Dub,50104,106,4,3,2,9,0.08490566
Sioux Falls(Mitchell),56156,6207,217,166,144,527,0.08490414
Detroit,48193,15100,398,422,462,1282,0.084900662
Nashville,37306,2768,78,87,70,235,0.084898844
West Palm Beach-Ft. Pierce,33486,22592,712,691,515,1918,0.084897309
Greenvll-Spart-Ashevll-And,29625,30050,760,767,1024,2551,0.084891847
Shreveport,71866,589,21,16,13,50,0.084889643
"Portland, OR",97217,37615,605,1017,1571,3193,0.084886349
Nashville,38506,30877,903,822,896,2621,0.08488519
Dallas-Ft. Worth,75446,3652,128,99,83,310,0.084884995
Indianapolis,46072,9142,271,249,256,776,0.084882958
New York,7077,2851,83,76,83,242,0.084882497
Paducah-Cape Girard-Harsbg,63755,28463,914,749,753,2416,0.084882128
Paducah-Cape Girard-Harsbg,62819,377,10,8,14,32,0.084880637
Tulsa,74010,10686,347,312,248,907,0.08487741
Birmingham (Ann and Tusc),35078,2274,69,69,55,193,0.084872471
Cleveland-Akron (Canton),44870,39392,1075,1147,1121,3343,0.084864947
Panama City,32539,33854,998,890,985,2873,0.084864418
Tucson (Sierra Vista),85712,32276,672,888,1179,2739,0.084861817
Myrtle Beach-Florence,29511,6328,185,165,187,537,0.084860936
Paducah-Cape Girard-Harsbg,62984,1473,47,43,35,125,0.084860828
Dallas-Ft. Worth,75421,1037,34,30,24,88,0.084860174
Birmingham (Ann and Tusc),35057,14471,457,390,381,1228,0.084859374
Denver,80729,601,16,17,18,51,0.084858569
New York,8886,6729,215,188,168,571,0.084856591
Nashville,38464,24336,702,705,658,2065,0.084853715
Honolulu,96730,1591,45,37,53,135,0.084852294
Providence-New Bedford,2806,17136,660,495,299,1454,0.084850607
Duluth-Superior,55808,5881,182,138,179,499,0.084849515
Milwaukee,53402,33695,974,959,926,2859,0.084849384
Greenville-N.Bern-Washngtn,28504,19741,608,532,535,1675,0.084848792
Charleston-Huntington,25133,495,17,15,10,42,0.084848485
Champaign&Sprngfld-Decatur,60973,330,12,8,8,28,0.084848485
Baton Rouge,70773,165,5,5,4,14,0.084848485
Seattle-Tacoma,98284,28298,823,757,821,2401,0.084846986
Louisville,47124,4962,162,139,120,421,0.084844821
Ft. Wayne,46725,25046,727,689,709,2125,0.084843887
Mobile-Pensacola (Ft Walt),36585,884,25,23,27,75,0.084841629
Paducah-Cape Girard-Harsbg,62933,1273,42,33,33,108,0.084838963
Chicago,46304,27912,851,784,733,2368,0.084838062
Charlotte,29708,44697,1631,1209,952,3792,0.084837909
Columbia-Jefferson City,65026,11363,339,309,316,964,0.084836751
Seattle-Tacoma,98513,38085,1057,960,1214,3231,0.08483655
Cleveland-Akron (Canton),44688,2947,90,88,72,250,0.084832033
New York,7852,4008,110,126,104,340,0.084830339
Lansing,49262,1002,21,37,27,85,0.084830339
Greenville-N.Bern-Washngtn,28393,1615,54,41,42,137,0.084829721
Jacksonville,32259,75304,3146,2003,1239,6388,0.084829491
Wichita-Hutchinson Plus,67209,13298,392,348,388,1128,0.084824786
Los Angeles,93562,1733,46,53,48,147,0.084824005
Milwaukee,53121,19134,625,557,441,1623,0.084822828
South Bend-Elkhart,46536,3525,113,97,89,299,0.084822695
Grand Rapids-Kalmzoo-B.Crk,49420,6720,200,190,180,570,0.084821429
Rockford,61049,448,14,12,12,38,0.084821429
Lincoln & Hastings-Krny,68623,224,8,6,5,19,0.084821429
Oklahoma City,73835,224,8,6,5,19,0.084821429
Los Angeles,92028,53041,1479,1465,1555,4499,0.084821176
Buffalo,14895,9019,254,271,240,765,0.084820934
Los Angeles,92675,38658,1163,1125,991,3279,0.084820736
Boston (Manchester),1005,5671,166,183,132,481,0.084817493
Albuquerque-Santa Fe,87002,21564,677,596,556,1829,0.084817288
San Francisco-Oak-San Jose,95046,6178,172,192,160,524,0.084817093
Hartford & New Haven,6089,4775,132,133,140,405,0.084816754
"Columbus, OH",43326,13123,398,386,329,1113,0.084812924
Huntsville-Decatur (Flor),35775,507,15,14,14,43,0.084812623
Meridian,36921,1014,28,29,29,86,0.084812623
Nashville,42157,507,19,13,11,43,0.084812623
Cincinnati,47353,5530,168,150,151,469,0.084810127
Amarillo,79068,2936,102,83,64,249,0.084809264
Flint-Saginaw-Bay City,48817,5648,165,152,162,479,0.084808782
Atlanta,30316,36966,591,892,1652,3135,0.084807661
New York,12563,7641,226,192,230,648,0.084805654
Cedar Rapids-Wtrlo-IWC&Dub,52202,1132,45,27,24,96,0.084805654
Sioux Falls(Mitchell),57465,283,11,7,6,24,0.084805654
South Bend-Elkhart,46531,1474,47,38,40,125,0.084803256
"Columbus, OH",43221,33584,897,936,1015,2848,0.084802287
Harrisburg-Lncstr-Leb-York,17078,23632,713,653,638,2004,0.084800271
Portland-Auburn,4072,21191,518,628,651,1797,0.084800151
San Antonio,78011,1993,62,54,53,169,0.084796789
Evansville,47666,1368,51,33,32,116,0.084795322
Laredo,78067,684,25,21,12,58,0.084795322
Nashville,37179,20780,815,565,382,1762,0.08479307
Oklahoma City,73111,11475,341,302,330,973,0.084793028
"Portland, OR",97215,18221,394,491,660,1545,0.084792273
Minneapolis-St. Paul,55389,2689,95,79,54,228,0.084789885
Boston (Manchester),3038,35276,949,991,1051,2991,0.084788525
Knoxville,40820,401,15,10,9,34,0.08478803
Oklahoma City,73162,28354,784,826,794,2404,0.084785215
Dayton,45503,31928,871,926,910,2707,0.084784515
New York,7648,5803,196,157,139,492,0.084783733
Peoria-Bloomington,61728,1380,49,40,28,117,0.084782609
Wichita-Hutchinson Plus,67732,460,19,11,9,39,0.084782609
Denver,80758,3739,127,95,95,317,0.084782027
Madison,53580,519,16,12,16,44,0.08477842
"Springfield, MO",65753,5190,172,141,127,440,0.08477842
Raleigh-Durham (Fayetvlle),28323,4907,165,127,124,416,0.084776849
Amarillo,79043,1274,36,31,41,108,0.08477237
Flint-Saginaw-Bay City,48867,27167,759,785,759,2303,0.084771966
Bismarck-Mnt-Dcknsn(Wlstn),58770,1451,48,40,35,123,0.084769125
Charlotte,28677,38021,1113,1056,1054,3223,0.084768943
Grand Rapids-Kalmzoo-B.Crk,48885,755,26,20,18,64,0.084768212
"Tri-Cities, TN-VA",37643,33846,985,949,935,2869,0.084766294
"Portland, OR",97027,12057,321,348,353,1022,0.084764037
Boston (Manchester),3033,5887,211,191,97,499,0.084763037
Knoxville,37931,34249,1009,920,974,2903,0.084761599
Knoxville,37807,11031,355,290,290,935,0.084761128
Atlanta,30126,43110,1317,1153,1184,3654,0.084759916
Boston (Manchester),2171,20623,326,553,869,1748,0.084759734
Boston (Manchester),2760,29248,902,792,785,2479,0.084757932
Flint-Saginaw-Bay City,48879,18193,531,514,497,1542,0.084757874
Birmingham (Ann and Tusc),35096,9014,268,238,258,764,0.084757045
Minneapolis-St. Paul,56071,13191,478,356,284,1118,0.084754757
New York,11705,8094,265,225,196,686,0.084754139
Kansas City,65360,4637,149,124,120,393,0.084753073
Savannah,31302,9463,271,262,269,802,0.084751136
Philadelphia,19734,15292,558,403,335,1296,0.084750196
Denver,80759,4531,152,121,111,384,0.084749503
Dallas-Ft. Worth,76044,9475,324,256,223,803,0.08474934
"Springfield, MO",65631,6124,202,160,157,519,0.08474853
Albany-Schenectady-Troy,12158,6655,174,216,174,564,0.08474831
Davenport-R.Island-Moline,52601,27399,821,770,731,2322,0.084747619
New York,7976,354,15,11,4,30,0.084745763
Bluefield-Beckley-Oak Hill,24862,118,4,3,3,10,0.084745763
Clarksburg-Weston,26587,236,6,7,7,20,0.084745763
Greenvll-Spart-Ashevll-And,28803,36049,810,928,1317,3055,0.084745763
Indianapolis,46977,59,2,2,1,5,0.084745763
Sioux Falls(Mitchell),57324,472,18,13,9,40,0.084745763
Fargo,58057,118,4,3,3,10,0.084745763
Tulsa,74008,36038,1255,951,848,3054,0.084743881
Salt Lake City,84049,7564,294,206,141,641,0.084743522
Philadelphia,17569,7116,247,183,173,603,0.084738617
New York,11757,45071,1217,1205,1397,3819,0.084732977
Dallas-Ft. Worth,75147,8828,284,243,221,748,0.084730403
Kansas City,64733,1074,32,31,28,91,0.084729981
Greenwood-Greenville,38967,6385,195,190,156,541,0.084729836
Minneapolis-St. Paul,54016,34452,1132,959,828,2919,0.084726576
Beaumont-Port Arthur,75951,13975,419,411,354,1184,0.084722719
Sioux City,51036,720,28,18,15,61,0.084722222
Baltimore,21226,7082,204,181,215,600,0.08472183
San Francisco-Oak-San Jose,95054,26062,514,633,1061,2208,0.08472105
Myrtle Beach-Florence,29570,3612,102,97,107,306,0.084717608
Raleigh-Durham (Fayetvlle),27851,5206,155,149,137,441,0.08470995
"Washington, DC (Hagrstwn)",21557,1877,50,49,60,159,0.084709643
Cedar Rapids-Wtrlo-IWC&Dub,50681,425,14,11,11,36,0.084705882
Reno,89509,36846,734,1051,1336,3121,0.084703903
Philadelphia,19343,9008,324,241,198,763,0.084702487
Chicago,60534,10779,304,273,336,913,0.084701735
Rochestr-Mason City-Austin,55923,4699,156,127,115,398,0.084698872
Atlanta,30205,3601,121,100,84,305,0.084698695
Los Angeles,91016,40733,1049,1143,1258,3450,0.084697911
Greenville-N.Bern-Washngtn,27812,2444,78,70,59,207,0.084697218
"Albany, GA",31779,7273,220,192,204,616,0.084696824
Grand Rapids-Kalmzoo-B.Crk,49437,7155,206,224,176,606,0.084696017
Seattle-Tacoma,99116,2208,74,46,67,187,0.084692029
Huntsville-Decatur (Flor),35585,1535,41,45,44,130,0.084690554
Odessa-Midland,79735,12918,414,352,328,1094,0.084688032
Detroit,48422,6093,201,163,152,516,0.084687346
Albuquerque-Santa Fe,87020,14654,416,393,432,1241,0.084686775
Greensboro-H.Point-W.Salem,27258,7451,235,214,182,631,0.084686619
Philadelphia,19004,12671,399,348,326,1073,0.084681556
Lake Charles,70633,9093,267,266,237,770,0.084680523
Terre Haute,47553,7830,240,222,201,663,0.08467433
Columbia-Jefferson City,65265,14952,450,390,426,1266,0.084670947
Oklahoma City,73010,22759,834,596,497,1927,0.084669801
Tulsa,74072,1311,51,32,28,111,0.084668192
San Francisco-Oak-San Jose,95129,39744,1282,1144,939,3365,0.084666868
Dayton,45362,1063,38,30,22,90,0.08466604
Tampa-St. Pete (Sarasota),33592,13323,420,346,362,1128,0.084665616
Sacramnto-Stkton-Modesto,95220,7819,244,212,206,662,0.084665558
Nashville,37183,3756,127,97,94,318,0.084664537
"Albany, GA",31774,6331,200,179,157,536,0.08466277
Charlotte,29706,19135,596,517,507,1620,0.084661615
Los Angeles,92587,17919,553,500,464,1517,0.084658742
Duluth-Superior,54846,567,24,14,10,48,0.084656085
Columbia-Jefferson City,65452,3036,113,83,61,257,0.084650856
Minneapolis-St. Paul,56364,5694,218,146,118,482,0.084650509
Paducah-Cape Girard-Harsbg,63771,3485,109,100,86,295,0.084648494
Detroit,48045,23652,525,631,846,2002,0.084644005
New York,12501,2103,71,55,52,178,0.084640989
Norfolk-Portsmth-Newpt Nws,23455,50119,1159,1312,1771,4242,0.08463856
Detroit,48310,43693,1129,1201,1368,3698,0.084635983
Chicago,60145,2245,72,50,68,190,0.084632517
Boise,97914,19650,597,571,495,1663,0.084631043
Los Angeles,92399,56753,1774,1551,1478,4803,0.084629887
Watertown,13679,1737,56,44,47,147,0.08462867
Dallas-Ft. Worth,75229,31999,1019,921,768,2708,0.084627645
Indianapolis,47302,25382,731,690,727,2148,0.084626901
Los Angeles,91803,28503,680,791,941,2412,0.084622671
Nashville,37166,15386,461,411,430,1302,0.084622384
Birmingham (Ann and Tusc),35543,1359,41,39,35,115,0.084621045
Evansville,42345,11002,308,337,286,931,0.084620978
Houston,77480,8225,282,204,210,696,0.084620061
Odessa-Midland,79707,39128,1090,1096,1125,3311,0.08461971
Cleveland-Akron (Canton),44618,7646,241,219,187,647,0.084619409
New Orleans,70433,44545,1298,1271,1200,3769,0.084611067
Cleveland-Akron (Canton),43837,1761,56,47,46,149,0.084611016
Lexington,40741,23874,718,666,636,2020,0.084610874
Boise,83624,1501,49,43,35,127,0.08461026
Tampa-St. Pete (Sarasota),33810,55267,1649,1427,1600,4676,0.084607451
"Columbus, GA (Opelika, AL)",31780,1832,47,62,46,155,0.084606987
Raleigh-Durham (Fayetvlle),27592,20743,687,573,495,1755,0.084606855
Binghamton,13760,42799,1161,1180,1280,3621,0.08460478
West Palm Beach-Ft. Pierce,33404,33734,952,1007,895,2854,0.084603071
New York,7865,3085,117,79,65,261,0.084602917
Los Angeles,91326,40058,1188,1121,1080,3389,0.084602327
Green Bay-Appleton,54110,5780,186,153,150,489,0.084602076
New York,6870,8014,317,228,133,678,0.084601947
Fargo,58301,9929,297,289,254,840,0.084600665
Chicago,60098,32861,923,935,922,2780,0.084598764
Detroit,48306,28464,1057,817,534,2408,0.084598089
Salt Lake City,84328,1714,62,51,32,145,0.084597433
Monroe-El Dorado,71483,7979,271,207,197,675,0.084597067
Charlotte,28016,14445,404,393,425,1222,0.084596746
Indianapolis,46978,1915,72,48,42,162,0.0845953
Mobile-Pensacola (Ft Walt),32548,23052,568,629,753,1950,0.084591359
Hattiesburg-Laurel,39429,15569,486,426,405,1317,0.084591175
South Bend-Elkhart,46635,6762,167,189,216,572,0.084590358
Hartford & New Haven,6029,16314,454,437,489,1380,0.084589923
Toledo,43462,1064,30,31,29,90,0.084586466
Roanoke-Lynchburg,24593,2270,70,61,61,192,0.084581498
Cincinnati,45150,34535,1058,961,902,2921,0.08458086
Montgomery-Selma,36037,12769,385,338,357,1080,0.084579842
Birmingham (Ann and Tusc),35022,25231,687,672,775,2134,0.084578495
Orlando-Daytona Bch-Melbrn,34711,74381,2121,2123,2047,6291,0.084578051
Evansville,62806,3086,103,84,74,261,0.084575502
New York,10973,2152,71,57,54,182,0.084572491
Champaign&Sprngfld-Decatur,62550,2625,84,77,61,222,0.084571429
"Jackson, TN",38006,4990,170,127,125,422,0.084569138
Knoxville,40870,473,22,9,9,40,0.084566596
Des Moines-Ames,52531,5688,180,154,147,481,0.084563994
Macon,31549,1490,45,43,38,126,0.084563758
Cincinnati,45679,3051,86,87,85,258,0.084562439
"Washington, DC (Hagrstwn)",20169,31114,1196,861,574,2631,0.084560005
Harrisburg-Lncstr-Leb-York,17219,544,19,13,14,46,0.084558824
Duluth-Superior,55726,1088,36,31,25,92,0.084558824
San Francisco-Oak-San Jose,94134,39393,923,1119,1289,3331,0.08455817
Charlotte,28602,29733,923,752,839,2514,0.084552517
Minneapolis-St. Paul,56633,4731,169,119,112,400,0.084548721
Bluefield-Beckley-Oak Hill,25048,343,14,8,7,29,0.084548105
Birmingham (Ann and Tusc),35006,3087,102,87,72,261,0.084548105
Baltimore,21043,50954,1659,1391,1258,4308,0.084546846
Salt Lake City,84757,1656,65,49,26,140,0.084541063
Boston (Manchester),1830,28436,705,807,892,2404,0.084540723
Kansas City,66048,37095,1103,1067,966,3136,0.084539695
Detroit,48079,12373,379,355,312,1046,0.084538915
Phoenix (Prescott),85298,44572,1918,1171,679,3768,0.084537378
Paducah-Cape Girard-Harsbg,62932,1455,42,40,41,123,0.084536082
Indianapolis,46147,2638,94,64,65,223,0.084533738
Burlington-Plattsburgh,12957,1597,52,46,37,135,0.0845335
Albany-Schenectady-Troy,12565,1112,37,33,24,94,0.084532374
Evansville,42376,6885,231,176,175,582,0.08453159
"Columbus, OH",43315,7583,236,209,196,641,0.084531188
Charlotte,29745,35124,1117,953,899,2969,0.084529097
Omaha,68116,35870,1129,948,955,3032,0.08452746
New York,7920,28417,1036,833,533,2402,0.084526868
Denver,80550,51110,1625,1344,1351,4320,0.084523577
"Lafayette, LA",70586,20101,622,537,540,1699,0.084523158
"Washington, DC (Hagrstwn)",20685,6235,202,167,158,527,0.084522855
Memphis,38008,8554,262,239,222,723,0.084521861
Terre Haute,62449,2875,86,80,77,243,0.084521739
La Crosse-Eau Claire,54758,5123,166,145,122,433,0.084520789
Louisville,40330,20646,631,572,542,1745,0.084520004
Cincinnati,45140,57277,1840,1634,1367,4841,0.084519091
Nashville,42217,3514,110,97,90,297,0.084519067
Kansas City,66025,8223,297,226,172,695,0.084519032
Atlanta,30173,6046,187,153,171,511,0.08451869
Dallas-Ft. Worth,75093,49374,1363,1415,1395,4173,0.084518167
Utica,13335,1621,47,48,42,137,0.084515731
Atlanta,30277,23227,746,662,555,1963,0.084513712
Lubbock,79064,2473,98,60,51,209,0.084512738
Philadelphia,8518,5514,155,169,142,466,0.084512151
Buffalo,14219,11880,258,335,411,1004,0.084511785
Rochestr-Mason City-Austin,55934,3325,125,90,66,281,0.084511278
Columbus-Tupelo-West Point,38855,4887,152,126,135,413,0.084509924
Greenvll-Spart-Ashevll-And,29330,8934,254,255,246,755,0.084508619
Lexington,40903,710,26,20,14,60,0.084507042
Cincinnati,47010,213,7,6,5,18,0.084507042
St. Louis,62255,923,31,24,23,78,0.084507042
St. Louis,65441,4757,156,130,116,402,0.084507042
Shreveport,71839,284,10,8,6,24,0.084507042
Denver,80861,284,12,7,5,24,0.084507042
Cleveland-Akron (Canton),44146,28791,706,830,897,2433,0.084505575
Louisville,47136,4840,153,140,116,409,0.084504132
"Columbia, SC",29039,3562,116,103,82,301,0.084503088
"Tri-Cities, TN-VA",24216,2284,71,67,55,193,0.084500876
Wilmington,28457,11420,366,319,280,965,0.084500876
Cincinnati,45246,15006,420,421,427,1268,0.084499534
"Lafayette, LA",71322,5728,178,171,135,484,0.084497207
Louisville,40019,4095,134,107,105,346,0.084493284
La Crosse-Eau Claire,54652,1006,44,18,23,85,0.084493042
Terre Haute,47879,2805,80,85,72,237,0.084491979
Honolulu,96793,32940,983,968,832,2783,0.084486946
New York,11755,12795,311,357,413,1081,0.084486127
Detroit,48335,26608,490,661,1097,2248,0.084485869
Albany-Schenectady-Troy,12803,9907,267,280,290,837,0.084485717
Syracuse,13081,1018,34,37,15,86,0.084479371
Evansville,47711,31487,878,861,921,2660,0.084479309
Boise,83641,3788,133,101,86,320,0.084477297
Cincinnati,45050,12323,437,318,286,1041,0.084476183
Baltimore,21144,37195,1131,1039,972,3142,0.08447372
Champaign&Sprngfld-Decatur,62650,24126,811,627,600,2038,0.084473182
Boise,83672,9293,358,236,191,785,0.084472183
Sioux Falls(Mitchell),57656,805,30,25,13,68,0.08447205
Little Rock-Pine Bluff,72207,10773,249,272,389,910,0.084470435
Macon,31006,4404,127,117,128,372,0.084468665
Tulsa,74063,30734,979,857,760,2596,0.084466714
San Francisco-Oak-San Jose,94015,65518,1339,1756,2439,5534,0.084465338
Columbia-Jefferson City,65270,17238,516,489,451,1456,0.084464555
Sherman-Ada,74523,5600,176,159,138,473,0.084464286
Chattanooga,37323,32358,964,856,913,2733,0.084461339
Greenvll-Spart-Ashevll-And,29369,17926,595,478,441,1514,0.084458329
Birmingham (Ann and Tusc),36051,2297,72,68,54,194,0.084457989
Medford-Klamath Falls,96134,2001,62,61,46,169,0.084457771
New Orleans,70458,39878,1179,1099,1090,3368,0.084457596
Columbus-Tupelo-West Point,39776,1705,53,49,42,144,0.084457478
New York,11224,48238,1284,1429,1361,4074,0.084456238
Reno,89706,20508,552,566,614,1732,0.084454847
Joplin-Pittsburg,64784,1338,46,37,30,113,0.08445441
Chattanooga,30740,8407,243,235,232,710,0.084453432
Charleston-Huntington,45623,3434,119,94,77,290,0.084449621
Norfolk-Portsmth-Newpt Nws,23828,450,14,13,11,38,0.084444444
Bluefield-Beckley-Oak Hill,25044,225,9,5,5,19,0.084444444
Kansas City,64633,4725,128,146,125,399,0.084444444
"Washington, DC (Hagrstwn)",20181,10279,385,277,206,868,0.084444012
Cleveland-Akron (Canton),44667,13370,391,357,381,1129,0.084442782
Charlotte,28605,3920,90,147,94,331,0.084438776
Chattanooga,37397,9759,267,295,262,824,0.084434881
"Columbus, OH",43358,2499,75,67,69,211,0.084433774
St. Joseph,64449,379,14,10,8,32,0.084432718
Lincoln & Hastings-Krny,68840,2807,102,67,68,237,0.084431778
Buffalo,14738,3494,115,95,85,295,0.084430452
Sacramnto-Stkton-Modesto,95677,28841,897,774,764,2435,0.084428418
Atlanta,30041,80546,3075,2219,1506,6800,0.084423808
Wichita-Hutchinson Plus,67010,13847,489,354,326,1169,0.084422619
"Portland, OR",97101,3980,120,104,112,336,0.084422111
"Rochester, NY",14411,12189,320,345,364,1029,0.084420379
Rockford,61071,13042,392,367,342,1101,0.084419568
Columbus-Tupelo-West Point,39750,3151,89,90,87,266,0.084417645
Watertown,13614,308,13,6,7,26,0.084415584
Indianapolis,46040,19558,774,526,351,1651,0.084415584
Great Falls,59419,154,5,4,4,13,0.084415584
Ft. Wayne,47371,11787,359,314,322,995,0.084415034
Albany-Schenectady-Troy,12303,30635,926,804,856,2586,0.084413253
Cleveland-Akron (Canton),44621,4561,126,131,128,385,0.084411313
Los Angeles,91775,23125,626,686,640,1952,0.084410811
Minneapolis-St. Paul,55056,15733,496,430,402,1328,0.084408568
Greenville-N.Bern-Washngtn,27852,2559,89,71,56,216,0.084407972
Myrtle Beach-Florence,29565,6208,192,171,161,524,0.084407216
Albuquerque-Santa Fe,87104,12286,301,348,388,1037,0.084405014
Wilkes Barre-Scranton-Hztn,18829,782,28,18,20,66,0.084398977
Jonesboro,72436,1019,29,32,25,86,0.084396467
Kansas City,64659,865,31,23,19,73,0.084393064
Colorado Springs-Pueblo,80919,28688,732,818,871,2421,0.084390686
Greenwood-Greenville,38928,237,7,7,6,20,0.084388186
Indianapolis,46162,474,17,12,11,40,0.084388186
Philadelphia,8550,21105,777,585,419,1781,0.084387586
St. Joseph,66090,3164,94,87,86,267,0.084386852
Anchorage,99577,26640,816,710,722,2248,0.084384384
Cleveland-Akron (Canton),44811,12455,370,345,336,1051,0.084383782
Madison,53717,12882,246,330,511,1087,0.084381307
Dothan,36321,1754,42,46,60,148,0.084378563
"Alexandria, LA",71350,4551,141,128,115,384,0.08437706
Chattanooga,30736,44953,1422,1224,1147,3793,0.084377016
New York,11751,14625,400,419,415,1234,0.084376068
Kansas City,64653,640,22,15,17,54,0.084375
Oklahoma City,74824,1280,44,39,25,108,0.084375
New York,11023,10323,344,297,230,871,0.084374697
Minneapolis-St. Paul,55437,19876,446,551,680,1677,0.084373113
Indianapolis,46011,17032,532,477,428,1437,0.084370597
Grand Rapids-Kalmzoo-B.Crk,49329,8439,259,243,210,712,0.084370186
Greenville-N.Bern-Washngtn,28458,5630,175,149,151,475,0.084369449
Omaha,68022,37372,1338,944,871,3153,0.084367976
Indianapolis,47918,5559,156,159,154,469,0.084367692
Dallas-Ft. Worth,75127,1861,66,48,43,157,0.084363246
Denver,80224,19049,368,506,733,1607,0.084361384
Minneapolis-St. Paul,55992,5275,179,148,118,445,0.08436019
"Alexandria, LA",71407,1138,32,31,33,96,0.084358524
Cincinnati,47038,1221,42,33,28,103,0.084357084
Shreveport,71018,1304,40,34,36,110,0.084355828
"Portland, OR",97058,21446,622,592,595,1809,0.084351394
Philadelphia,18929,8951,314,264,177,755,0.084348118
Savannah,31557,3367,108,83,93,284,0.084348084
Kansas City,66218,9805,395,262,170,827,0.084344722
Boston (Manchester),3235,8904,230,255,266,751,0.084344115
Watertown,13646,2146,76,58,47,181,0.084342964
Providence-New Bedford,2763,2229,67,66,55,188,0.084342755
Los Angeles,92835,24591,687,665,722,2074,0.084339799
Johnstown-Altoona-St Colge,15565,83,3,2,2,7,0.084337349
Jonesboro,72440,166,5,5,4,14,0.084337349
Salt Lake City,84306,581,23,15,11,49,0.084337349
Amarillo,88112,166,6,5,3,14,0.084337349
San Francisco-Oak-San Jose,95128,35371,761,996,1226,2983,0.084334624
New York,7506,19755,550,558,558,1666,0.08433308
Greensboro-H.Point-W.Salem,27249,14194,425,372,400,1197,0.084331408
Albany-Schenectady-Troy,12306,27096,723,722,840,2285,0.08432979
Chicago,60442,13732,476,345,337,1158,0.084328576
Dallas-Ft. Worth,75075,37390,878,1000,1275,3153,0.08432736
"Portland, OR",97051,17776,561,473,465,1499,0.084327183
Knoxville,37757,9226,263,266,249,778,0.084326902
Toledo,49247,5704,185,159,137,481,0.084326788
Los Angeles,90703,47565,1316,1362,1333,4011,0.084326711
Oklahoma City,73045,11835,379,302,317,998,0.084326151
Mobile-Pensacola (Ft Walt),32570,35802,1031,977,1011,3019,0.084324898
Dayton,45869,4625,150,122,118,390,0.084324324
"Portland, OR",97381,16520,537,482,374,1393,0.084322034
Sioux Falls(Mitchell),57456,759,27,19,18,64,0.084321476
Milwaukee,53179,5989,199,164,142,505,0.084321256
Greenvll-Spart-Ashevll-And,29323,17612,528,465,492,1485,0.084317511
Cedar Rapids-Wtrlo-IWC&Dub,52403,23459,644,685,649,1978,0.08431732
"Washington, DC (Hagrstwn)",21719,1186,41,34,25,100,0.084317032
Greensboro-H.Point-W.Salem,27205,34240,1032,977,878,2887,0.084316589
Fargo,56621,4590,153,119,115,387,0.084313725
Boise,83623,1530,50,48,31,129,0.084313725
Wichita Falls & Lawton,73527,5527,196,149,121,466,0.084313371
Buffalo,14065,1957,78,46,41,165,0.084312724
Billings,59044,12952,436,348,308,1092,0.084311303
Quincy-Hannibal-Keokuk,62325,427,15,10,11,36,0.084309133
Little Rock-Pine Bluff,72137,2479,84,70,55,209,0.084308189
Little Rock-Pine Bluff,72063,1542,54,41,35,130,0.084306096
New York,7980,2230,56,69,63,188,0.084304933
Indianapolis,46259,14768,545,390,310,1245,0.0843039
Boston (Manchester),1560,4816,147,133,126,406,0.084302326
Spokane,99023,688,26,20,12,58,0.084302326
"Columbus, OH",43764,8185,248,227,215,690,0.08430055
Peoria-Bloomington,61733,1210,34,32,36,102,0.084297521
New Orleans,70471,23524,740,679,564,1983,0.084296888
Syracuse,13425,1993,62,53,53,168,0.084295033
Paducah-Cape Girard-Harsbg,62859,5125,150,149,133,432,0.084292683
Roanoke-Lynchburg,24087,3654,114,99,95,308,0.084291188
Sioux City,68745,1400,37,33,48,118,0.084285714
Louisville,42754,15246,427,418,440,1285,0.084284402
New York,11791,26114,913,738,550,2201,0.084284292
Rockford,61007,439,15,14,8,37,0.08428246
Minneapolis-St. Paul,55374,19411,701,527,408,1636,0.084282108
Harrisburg-Lncstr-Leb-York,17094,2373,70,60,70,200,0.0842815
Terre Haute,62439,6253,156,180,191,527,0.084279546
Seattle-Tacoma,98550,11628,337,334,309,980,0.084279326
Greenvll-Spart-Ashevll-And,29691,11581,384,316,276,976,0.084275969
Philadelphia,8096,36713,946,1002,1146,3094,0.084275325
New York,10919,1151,27,35,35,97,0.084274544
New York,10514,12673,459,380,229,1068,0.084273653
Bangor,4411,1507,47,43,37,127,0.084273391
Oklahoma City,74855,4521,157,129,95,381,0.084273391
Philadelphia,8002,24290,581,701,765,2047,0.084273364
Waco-Temple-Bryan,76578,1863,63,53,41,157,0.084272678
"Tri-Cities, TN-VA",24237,1068,35,31,24,90,0.084269663
"Washington, DC (Hagrstwn)",20678,13707,422,381,352,1155,0.084263515
Pittsburgh,15074,8343,186,232,285,703,0.084262256
Bangor,4426,4949,158,142,117,417,0.084259446
Spokane,99019,14966,506,429,326,1261,0.084257651
New Orleans,39426,19049,617,519,469,1605,0.084256391
Los Angeles,91745,52186,1354,1504,1539,4397,0.084256314
Tallahassee-Thomasville,39859,1175,34,34,31,99,0.084255319
Detroit,48164,9400,296,252,244,792,0.084255319
Birmingham (Ann and Tusc),35019,2362,78,61,60,199,0.084250635
Cincinnati,45237,20689,600,595,548,1743,0.084247668
Detroit,48062,9211,255,252,269,776,0.084247096
Detroit,48461,7953,281,212,177,670,0.084244939
Chicago,60060,37617,1188,1002,979,3169,0.084243826
Champaign&Sprngfld-Decatur,61843,2564,80,75,61,216,0.08424337
Atlanta,30633,9164,293,236,243,772,0.084242689
Louisville,47220,5698,171,138,171,480,0.084240084
Spokane,99013,1567,52,41,39,132,0.084237396
Toledo,43410,10518,352,262,272,886,0.084236547
Cincinnati,47331,22615,679,631,595,1905,0.084236126
Los Angeles,92886,49872,1538,1475,1188,4201,0.084235643
"Lafayette, IN",47977,2220,71,58,58,187,0.084234234
"Washington, DC (Hagrstwn)",20855,18592,476,534,556,1566,0.084229776
Nashville,37085,5307,201,134,112,447,0.084228378
"Washington, DC (Hagrstwn)",20141,9047,354,244,164,762,0.084226816
"Albany, GA",31773,4108,131,106,109,346,0.084225901
Rockford,61030,2054,64,58,51,173,0.084225901
Minneapolis-St. Paul,55449,36830,1384,957,761,3102,0.084224817
Denver,80610,4488,146,119,113,378,0.084224599
New York,11040,42933,1219,1228,1169,3616,0.084224256
New York,11010,25088,675,708,730,2113,0.084223533
New York,11725,28841,834,871,724,2429,0.084220381
Flint-Saginaw-Bay City,48640,31656,925,948,793,2666,0.084217842
Little Rock-Pine Bluff,71701,16897,530,456,437,1423,0.084216133
Clarksburg-Weston,26301,28320,814,764,807,2385,0.084216102
Harrisburg-Lncstr-Leb-York,17512,17895,532,494,481,1507,0.084213467
Charleston-Huntington,25015,3788,110,107,102,319,0.084213305
Los Angeles,91750,32869,929,924,915,2768,0.084213088
Denver,81623,16969,548,460,421,1429,0.084212387
Wilmington,28382,6448,202,185,156,543,0.084212159
Grand Rapids-Kalmzoo-B.Crk,48838,19558,593,544,510,1647,0.084211065
Lexington,41727,760,26,17,21,64,0.084210526
Des Moines-Ames,50842,95,3,3,2,8,0.084210526
Wichita-Hutchinson Plus,67857,190,7,5,4,16,0.084210526
Lincoln & Hastings-Krny,68980,380,11,10,11,32,0.084210526
Monroe-El Dorado,71401,190,6,6,4,16,0.084210526
Little Rock-Pine Bluff,72057,1045,29,34,25,88,0.084210526
"Springfield, MO",72578,95,3,3,2,8,0.084210526
Minneapolis-St. Paul,56353,9821,323,272,232,827,0.084207311
Lexington,41049,2577,80,68,69,217,0.084206442
Fargo,56763,4869,159,123,128,410,0.084206203
Cincinnati,45106,11852,405,298,295,998,0.084205197
Cincinnati,45144,3824,120,114,88,322,0.084205021
"Jackson, MS",39047,40960,1257,1058,1134,3449,0.084204102
Phoenix (Prescott),85533,3254,110,82,82,274,0.084204057
Albany-Schenectady-Troy,12072,2779,80,74,80,234,0.084202951
Presque Isle,4769,8729,221,290,224,735,0.084202085
Kansas City,66018,6912,236,174,172,582,0.084201389
Champaign&Sprngfld-Decatur,62549,6176,212,171,137,520,0.084196891
Toledo,43616,20084,608,550,533,1691,0.084196375
Watertown,13613,2708,85,78,65,228,0.084194978
Topeka,66937,677,22,20,15,57,0.084194978
Abilene-Sweetwater,76821,4549,149,139,95,383,0.084194328
St. Louis,63071,1164,37,32,29,98,0.08419244
Kansas City,64720,4074,134,102,107,343,0.08419244
Charlotte,28678,5048,160,132,133,425,0.084191759
Denver,80534,22259,707,611,556,1874,0.084190664
Little Rock-Pine Bluff,72081,7495,217,208,206,631,0.08418946
New York,12528,14420,377,397,440,1214,0.084188627
Minneapolis-St. Paul,55375,4490,177,129,72,378,0.084187082
Madison,53548,19220,553,561,504,1618,0.084183143
New York,7073,10406,223,298,355,876,0.084182203
Tampa-St. Pete (Sarasota),33556,36445,1227,995,846,3068,0.084181644
Peoria-Bloomington,61375,1081,26,33,32,91,0.084181314
Norfolk-Portsmth-Newpt Nws,27805,3053,106,82,69,257,0.084179496
Boston (Manchester),2030,6023,210,196,101,507,0.08417732
Greenwood-Greenville,38771,2768,82,79,72,233,0.084176301
Huntsville-Decatur (Flor),35582,4253,124,122,112,358,0.084175876
Columbus-Tupelo-West Point,38833,2376,74,69,57,200,0.084175084
Des Moines-Ames,50254,297,12,7,6,25,0.084175084
Bluefield-Beckley-Oak Hill,25140,796,29,24,14,67,0.084170854
Des Moines-Ames,50560,499,19,9,14,42,0.084168337
Green Bay-Appleton,54932,998,36,25,23,84,0.084168337
Philadelphia,8026,2198,74,55,56,185,0.084167425
Denver,80654,3410,120,87,80,287,0.084164223
St. Louis,63052,29799,983,784,741,2508,0.084163898
Topeka,67449,2709,98,70,60,228,0.084163898
Bluefield-Beckley-Oak Hill,25062,202,7,6,4,17,0.084158416
Grand Rapids-Kalmzoo-B.Crk,49425,4040,131,108,101,340,0.084158416
Columbia-Jefferson City,65025,808,23,30,15,68,0.084158416
Oklahoma City,73053,606,24,17,10,51,0.084158416
Chicago,60451,36669,1205,999,882,3086,0.084158281
Charlotte,28150,29778,875,821,810,2506,0.084156088
Philadelphia,19046,19607,571,530,549,1650,0.084153619
Juneau,99824,2032,54,56,61,171,0.084153543
Dallas-Ft. Worth,75173,8865,306,227,213,746,0.084151156
Tampa-St. Pete (Sarasota),34291,12573,402,352,304,1058,0.084148572
Cincinnati,45130,3482,108,97,88,293,0.084147042
"Washington, DC (Hagrstwn)",20772,53811,1518,1459,1551,4528,0.084146364
Hattiesburg-Laurel,39439,4409,137,119,115,371,0.084146065
"Washington, DC (Hagrstwn)",22101,31327,1164,917,555,2636,0.084144668
Pittsburgh,16224,1438,44,42,35,121,0.084144645
"Columbus, GA (Opelika, AL)",36874,9044,274,246,241,761,0.084144184
Huntsville-Decatur (Flor),35801,24851,554,741,796,2091,0.084141483
Lincoln & Hastings-Krny,69033,2377,84,55,61,200,0.084139672
Grand Rapids-Kalmzoo-B.Crk,49457,10447,329,295,255,879,0.084138987
"Columbia, SC",29123,7250,232,178,200,610,0.084137931
Houston,77517,5919,177,178,143,498,0.084135834
Philadelphia,19543,6335,216,180,137,533,0.084135754
Mobile-Pensacola (Ft Walt),32571,43763,1544,1132,1006,3682,0.084135
New York,8535,5206,154,148,136,438,0.084133692
New York,10924,13954,430,374,370,1174,0.084133582
Greensboro-H.Point-W.Salem,27288,23273,658,619,681,1958,0.084131827
"Portland, OR",98686,22976,693,637,603,1933,0.084131267
Atlanta,30628,7417,228,194,202,624,0.08413105
Watertown,13652,2092,64,66,46,176,0.084130019
Boston (Manchester),2460,9557,285,241,278,804,0.084126818
Columbus-Tupelo-West Point,38864,1474,42,39,43,124,0.08412483
"Lafayette, LA",70555,10033,350,249,245,844,0.084122396
Casper-Riverton,82649,1058,38,28,23,89,0.084120983
Salt Lake City,84532,10485,312,288,282,882,0.084120172
Jacksonville,32092,60010,2311,1620,1117,5048,0.084119313
Orlando-Daytona Bch-Melbrn,34972,19615,605,570,475,1650,0.084119296
Seattle-Tacoma,98247,9653,323,239,250,812,0.084118927
Duluth-Superior,55780,107,4,3,2,9,0.08411215
Oklahoma City,73851,107,4,3,2,9,0.08411215
Dayton,45323,5148,159,139,135,433,0.084110334
Dallas-Ft. Worth,76093,2473,83,64,61,208,0.08410837
Raleigh-Durham (Fayetvlle),27525,19689,613,517,526,1656,0.084107877
Paducah-Cape Girard-Harsbg,62960,10760,337,298,270,905,0.084107807
Myrtle Beach-Florence,29583,4756,148,132,120,400,0.084104289
Greenvll-Spart-Ashevll-And,30634,2271,68,66,57,191,0.084103919
Detroit,48167,24874,774,664,654,2092,0.084103884
Evansville,42355,1950,67,58,39,164,0.084102564
Dallas-Ft. Worth,75248,38572,817,1059,1368,3244,0.084102458
Bismarck-Mnt-Dcknsn(Wlstn),58740,761,21,23,20,64,0.084099869
Albuquerque-Santa Fe,87111,55672,1333,1497,1852,4682,0.084099727
Minneapolis-St. Paul,54025,7729,256,203,191,650,0.084098848
Roanoke-Lynchburg,24067,2069,59,59,56,174,0.084098598
Sacramnto-Stkton-Modesto,95621,42034,1050,1097,1388,3535,0.084098587
New York,7074,3163,83,89,94,266,0.084097376
Boise,83661,11368,326,301,329,956,0.084095707
Terre Haute,47524,440,17,9,11,37,0.084090909
Tulsa,74070,15733,537,454,332,1323,0.084090765
Tulsa,74014,45547,1553,1219,1058,3830,0.084088963
Greensboro-H.Point-W.Salem,27030,36546,1065,1017,991,3073,0.08408581
Wichita-Hutchinson Plus,67544,3104,105,85,71,261,0.084085052
Charleston-Huntington,25253,3437,108,97,84,289,0.084084958
Chico-Redding,96080,29530,863,809,811,2483,0.084083982
St. Louis,62203,6125,205,164,146,515,0.084081633
Norfolk-Portsmth-Newpt Nws,23456,60251,1941,1712,1413,5066,0.084081592
Sacramnto-Stkton-Modesto,95982,3235,100,91,81,272,0.084080371
St. Louis,63139,21456,256,494,1054,1804,0.084079045
Toledo,43407,559,17,16,14,47,0.084078712
Tulsa,74450,1677,58,39,44,141,0.084078712
New York,11733,18031,551,503,462,1516,0.084077422
Minneapolis-St. Paul,55118,30497,815,867,882,2564,0.084073843
Kansas City,66212,34137,805,907,1158,2870,0.084073
"Washington, DC (Hagrstwn)",20112,28392,976,827,584,2387,0.084072978
Syracuse,13421,12430,355,344,346,1045,0.084070796
Paducah-Cape Girard-Harsbg,62869,2486,84,67,58,209,0.084070796
"Washington, DC (Hagrstwn)",20659,24349,750,681,616,2047,0.084069161
Waco-Temple-Bryan,76520,8279,276,233,187,696,0.084068124
"Columbia, SC",29104,1249,37,36,32,105,0.084067254
Houston,77465,7613,223,198,219,640,0.084066728
Myrtle Beach-Florence,29569,19271,616,535,469,1620,0.084064138
Binghamton,13743,3545,105,107,86,298,0.084062059
Raleigh-Durham (Fayetvlle),27530,36616,1057,972,1049,3078,0.084061612
Birmingham (Ann and Tusc),35016,17737,529,476,486,1491,0.084061566
Detroit,48382,23459,775,649,548,1972,0.084061554
Minneapolis-St. Paul,56119,916,29,26,22,77,0.084061135
Savannah,29924,3902,118,109,101,328,0.084059457
Cincinnati,41002,2415,74,65,64,203,0.084057971
Little Rock-Pine Bluff,72843,2189,72,62,50,184,0.084056647
Raleigh-Durham (Fayetvlle),27591,29290,942,757,763,2462,0.084055992
Tyler-Longview(Lfkn&Ncgd),75949,8423,282,208,218,708,0.084055562
New York,7628,17774,482,490,522,1494,0.084055362
St. Louis,63026,45780,1453,1249,1146,3848,0.084054172
Columbia-Jefferson City,65043,10410,324,261,290,875,0.084053794
Dallas-Ft. Worth,76066,4295,152,114,95,361,0.084051222
Flint-Saginaw-Bay City,49310,2915,91,82,72,245,0.084048027
Providence-New Bedford,2894,702,19,19,21,59,0.084045584
Wheeling-Steubenville,26031,1761,49,45,54,148,0.084043157
Atlanta,36264,8805,272,227,241,740,0.084043157
Eugene,97478,40063,1160,1089,1118,3367,0.084042633
Kansas City,64067,5759,166,164,154,484,0.084042368
Boston (Manchester),2718,7175,212,202,189,603,0.084041812
Charlotte,28098,3891,123,97,107,327,0.084040093
Jacksonville,32140,1892,53,52,54,159,0.084038055
Philadelphia,17073,6640,215,178,165,558,0.084036145
New York,11753,13661,496,398,254,1148,0.084034844
New York,11934,8211,265,213,212,690,0.084033613
Johnstown-Altoona-St Colge,16622,119,3,3,4,10,0.084033613
Lexington,40510,1428,45,40,35,120,0.084033613
Terre Haute,47516,1309,42,36,32,110,0.084033613
Reno,96133,119,4,2,4,10,0.084033613
Rochestr-Mason City-Austin,55976,8580,292,224,205,721,0.084032634
Charlotte,28625,39473,1161,1087,1069,3317,0.084032123
"Columbus, OH",43044,5010,159,138,124,421,0.084031936
Chicago,60076,33095,987,912,882,2781,0.08403082
Lincoln & Hastings-Krny,68832,1916,62,56,43,161,0.084029228
Lexington,40361,18399,533,506,507,1546,0.084026306
Traverse City-Cadillac,49643,7593,206,267,165,638,0.08402476
Knoxville,38555,19816,570,523,572,1665,0.084023012
Hattiesburg-Laurel,39168,6070,173,169,168,510,0.084019769
Louisville,42784,2916,94,76,75,245,0.084019204
Birmingham (Ann and Tusc),35218,6094,178,163,171,512,0.084017066
Richmond-Petersburg,23832,41125,1292,1121,1042,3455,0.084012158
Albany-Schenectady-Troy,12065,44887,1168,1239,1364,3771,0.084010961
Monroe-El Dorado,71276,369,12,9,10,31,0.08401084
Mankato,56090,619,19,15,18,52,0.084006462
Lincoln & Hastings-Krny,68956,1238,40,35,29,104,0.084006462
Paducah-Cape Girard-Harsbg,42029,5702,167,167,145,479,0.084005612
Des Moines-Ames,50073,1488,50,40,35,125,0.084005376
Nashville,37184,6464,203,186,154,543,0.084003713
Paducah-Cape Girard-Harsbg,63933,2988,99,89,63,251,0.084002677
Raleigh-Durham (Fayetvlle),27526,69392,2335,1837,1657,5829,0.084001038
Tulsa,74006,28107,933,722,706,2361,0.084000427
Kansas City,64474,750,26,19,18,63,0.084
Nashville,37062,14179,486,375,330,1191,0.083997461
Norfolk-Portsmth-Newpt Nws,23844,631,17,19,17,53,0.083993661
Meridian,36925,3167,96,81,89,266,0.083991159
Chicago,60030,35921,1043,1022,952,3017,0.083989867
Sioux Falls(Mitchell),57331,381,15,10,7,32,0.083989501
"Washington, DC (Hagrstwn)",22066,17538,598,514,361,1473,0.083989052
Detroit,48843,49376,1388,1336,1423,4147,0.083988172
Wichita-Hutchinson Plus,67039,3060,111,78,68,257,0.083986928
New York,11740,9692,297,307,210,814,0.083986793
Elmira (Corning),14898,1405,42,40,36,118,0.083985765
Philadelphia,19808,38459,1083,1114,1033,3230,0.083985543
Lexington,42541,512,11,18,14,43,0.083984375
Phoenix (Prescott),85020,34364,785,1026,1075,2886,0.083983238
San Francisco-Oak-San Jose,94702,16420,357,436,586,1379,0.083982948
Buffalo,14781,1929,63,62,37,162,0.083981337
Montgomery-Selma,36032,2060,59,59,55,173,0.083980583
Monroe-El Dorado,71220,19957,611,577,488,1676,0.083980558
Davenport-R.Island-Moline,61448,3608,111,103,89,303,0.083980044
Augusta-Aiken,30803,774,22,20,23,65,0.083979328
Birmingham (Ann and Tusc),35046,5037,146,138,139,423,0.083978559
Boston (Manchester),1570,18136,441,530,552,1523,0.083976621
Detroit,48097,5192,152,148,136,436,0.083975347
New York,12533,26116,842,724,627,2193,0.083971512
Albany-Schenectady-Troy,1343,131,5,3,3,11,0.083969466
San Francisco-Oak-San Jose,94104,393,6,8,19,33,0.083969466
Springfield-Holyoke,1118,14327,393,376,434,1203,0.083967334
"Columbia, SC",29114,1846,60,49,46,155,0.08396533
Albany-Schenectady-Troy,12010,29179,794,822,834,2450,0.083964495
Youngstown,44609,3704,104,104,103,311,0.083963283
Baltimore,21401,39780,911,1121,1308,3340,0.08396179
Des Moines-Ames,50213,7444,226,191,208,625,0.083960236
"Tri-Cities, TN-VA",41723,1334,44,34,34,112,0.083958021
"Portland, OR",97038,17092,499,454,482,1435,0.083957407
Charleston-Huntington,41240,6420,171,193,175,539,0.083956386
Presque Isle,4786,1739,53,57,36,146,0.083956297
Denver,80514,6825,218,185,170,573,0.083956044
Salt Lake City,84623,405,15,11,8,34,0.083950617
Columbia-Jefferson City,65074,3109,95,84,82,261,0.083949823
Los Angeles,91362,35164,1005,1084,863,2952,0.083949494
New York,12603,42764,1220,1197,1173,3590,0.083949116
North Platte,69151,679,24,20,13,57,0.083946981
Peoria-Bloomington,61760,2311,74,64,56,194,0.083946344
Bluefield-Beckley-Oak Hill,25882,2049,63,53,56,172,0.083943387
Charlotte,27020,6159,181,178,158,517,0.083942198
Chicago,46371,3836,135,111,76,322,0.083941606
"Washington, DC (Hagrstwn)",22645,4682,139,134,120,393,0.083938488
Sacramnto-Stkton-Modesto,95304,16441,445,470,465,1380,0.0839365
Ft. Smith-Fay-Sprngdl-Rgrs,74966,4015,134,119,84,337,0.083935243
Chicago,46350,44249,1267,1231,1216,3714,0.0839341
Bluefield-Beckley-Oak Hill,25876,417,14,12,9,35,0.083932854
"Columbus, OH",45835,417,14,11,10,35,0.083932854
Davenport-R.Island-Moline,61486,1394,39,37,41,117,0.083931133
Seattle-Tacoma,98541,11152,338,317,281,936,0.083931133
Paducah-Cape Girard-Harsbg,42039,1680,51,42,48,141,0.083928571
St. Louis,63051,14429,472,389,350,1211,0.0839282
Toledo,43611,17801,445,500,549,1494,0.083927869
Phoenix (Prescott),85018,37581,891,1009,1254,3154,0.083925388
Minneapolis-St. Paul,56159,2681,83,73,69,225,0.083923909
Sacramnto-Stkton-Modesto,95681,989,27,30,26,83,0.083923155
Salisbury,19940,6816,228,166,178,572,0.083920188
Idaho Fals-Pocatllo(Jcksn),83236,2419,93,60,50,203,0.083918975
Dallas-Ft. Worth,76226,47987,1776,1256,995,4027,0.083918561
Omaha,68659,143,5,3,4,12,0.083916084
Denver,69334,2002,64,55,49,168,0.083916084
Salt Lake City,84667,429,16,12,8,36,0.083916084
"Charleston, SC",29479,7019,236,192,161,589,0.083915088
New Orleans,70374,6590,227,184,142,553,0.083915023
Lexington,40371,3015,93,80,80,253,0.083913765
Boston (Manchester),2152,18591,425,507,628,1560,0.08391157
Salt Lake City,83252,4612,172,121,94,387,0.083911535
Omaha,51653,1299,53,32,24,109,0.083910701
Abilene-Sweetwater,76470,3325,115,95,69,279,0.083909774
Paducah-Cape Girard-Harsbg,62894,870,25,31,17,73,0.083908046
Lincoln & Hastings-Krny,68826,4064,129,96,116,341,0.08390748
Chicago,60518,3194,96,90,82,268,0.083907326
Philadelphia,19090,20916,547,568,640,1755,0.083907057
Rapid City,82839,1454,50,40,32,122,0.083906465
Grand Rapids-Kalmzoo-B.Crk,49040,3492,115,85,93,293,0.083906071
Madison,54664,1752,62,50,35,147,0.08390411
Los Angeles,92673,29606,1112,813,559,2484,0.083901912
Albuquerque-Santa Fe,88061,17665,505,553,424,1482,0.083894707
Columbus-Tupelo-West Point,38821,11300,335,313,300,948,0.083893805
Lexington,41828,596,23,15,12,50,0.083892617
Rapid City,57543,894,28,27,20,75,0.083892617
Oklahoma City,74640,298,13,7,5,25,0.083892617
Sherman-Ada,74738,596,19,12,19,50,0.083892617
Grand Junction-Montrose,81521,17201,597,445,401,1443,0.083890471
Cincinnati,41046,1800,65,47,39,151,0.083888889
Minneapolis-St. Paul,55060,30028,960,833,726,2519,0.083888371
Knoxville,40988,453,14,17,7,38,0.08388521
Sacramnto-Stkton-Modesto,95687,71766,1898,2014,2108,6020,0.083883733
Amarillo,79097,1061,38,27,24,89,0.083883129
Meridian,35459,608,14,19,18,51,0.083881579
Louisville,40115,608,21,16,14,51,0.083881579
Seattle-Tacoma,98033,43133,1197,1236,1185,3618,0.083880092
St. Louis,63627,2921,91,78,76,245,0.083875385
Jonesboro,72455,13854,413,386,363,1162,0.083874693
Chicago,60514,10182,362,277,215,854,0.083873502
Nashville,37036,6820,212,185,175,572,0.083870968
Charleston-Huntington,45695,775,25,23,17,65,0.083870968
New Orleans,70456,3112,98,79,84,261,0.083868895
Los Angeles,92610,13879,400,384,380,1164,0.083867714
Salisbury,21817,4722,134,143,119,396,0.08386277
Atlanta,30139,4567,130,136,117,383,0.083862492
Topeka,66616,5521,155,164,144,463,0.083861619
Colorado Springs-Pueblo,80904,20880,372,592,787,1751,0.083860153
Raleigh-Durham (Fayetvlle),27544,3804,107,106,106,319,0.083859096
Boston (Manchester),1453,44098,1175,1224,1299,3698,0.083858678
Pittsburgh,15759,2707,94,77,56,227,0.083856668
Reno,89501,4484,63,140,173,376,0.083853702
Richmond-Petersburg,23238,26631,713,782,738,2233,0.083849649
Cleveland-Akron (Canton),44905,11807,331,330,329,990,0.083848564
Denver,80027,32845,1081,845,828,2754,0.083848379
Seattle-Tacoma,98223,48816,1509,1344,1240,4093,0.083845461
St. Louis,62081,489,12,14,15,41,0.083844581
Louisville,40047,24617,805,638,621,2064,0.083844498
"Columbus, OH",43725,18964,541,515,534,1590,0.083843071
Savannah,31308,9339,292,254,237,783,0.083841953
Watertown,13471,2958,109,76,63,248,0.083840433
Charlotte,27028,27171,811,771,696,2278,0.083839388
Columbia-Jefferson City,65350,1813,63,45,44,152,0.083838941
Charlotte,28104,37501,1419,1029,696,3144,0.083837764
Milwaukee,53188,35247,930,982,1043,2955,0.083836922
Evansville,42350,1324,46,33,32,111,0.083836858
"Columbus, OH",43766,1491,50,38,37,125,0.083836351
Savannah,30420,1825,53,55,45,153,0.083835616
New Orleans,39573,9495,299,256,241,796,0.083833597
Grand Rapids-Kalmzoo-B.Crk,49412,11833,355,322,315,992,0.083833347
Minneapolis-St. Paul,56222,2004,62,53,53,168,0.083832335
St. Louis,62807,835,26,24,20,70,0.083832335
Traverse City-Cadillac,49685,21353,605,603,582,1790,0.08382897
Salt Lake City,82937,3197,118,91,59,268,0.083828589
Waco-Temple-Bryan,76655,11798,407,307,275,989,0.083827767
Memphis,72360,5237,147,153,139,439,0.083826618
Philadelphia,19964,1372,47,36,32,115,0.083819242
Philadelphia,19475,12181,375,335,311,1021,0.083819062
Denver,80120,29397,735,839,890,2464,0.083818077
"Washington, DC (Hagrstwn)",26836,6228,200,171,151,522,0.083815029
Quincy-Hannibal-Keokuk,63543,346,15,9,5,29,0.083815029
"Jackson, TN",38315,3818,130,103,87,320,0.083813515
Miami-Ft. Lauderdale,33014,41903,1032,1202,1278,3512,0.083812615
Tampa-St. Pete (Sarasota),33809,31071,838,876,890,2604,0.083808053
San Francisco-Oak-San Jose,94112,76118,1689,1972,2718,6379,0.083804094
Sherman-Ada,75020,25393,748,671,709,2128,0.083802623
Tulsa,74058,3556,119,91,88,298,0.083802025
Milwaukee,53172,20095,546,582,556,1684,0.083801941
Oklahoma City,74884,6062,177,173,158,508,0.083800726
Augusta-Aiken,30477,2506,66,75,69,210,0.083798883
Cincinnati,45248,24058,727,674,615,2016,0.083797489
Greenville-N.Bern-Washngtn,28513,10812,357,283,266,906,0.083795782
Memphis,72419,1623,50,47,39,136,0.083795441
Memphis,38337,1265,42,33,31,106,0.083794466
New York,7439,2351,54,59,84,197,0.08379413
Cleveland-Akron (Canton),43832,7077,199,209,185,593,0.083792567
Los Angeles,91214,29621,898,857,727,2482,0.083791904
Waco-Temple-Bryan,77808,16040,526,407,411,1344,0.083790524
Augusta-Aiken,30808,4404,143,116,110,369,0.083787466
Portland-Auburn,4096,9023,307,266,183,756,0.083785881
Green Bay-Appleton,54165,7949,252,212,202,666,0.083784124
Ft. Smith-Fay-Sprngdl-Rgrs,72744,5586,166,155,147,468,0.083780881
Charlotte,28040,7114,222,179,195,596,0.083778465
"Columbus, OH",45661,7114,200,209,187,596,0.083778465
Dallas-Ft. Worth,75153,752,27,20,16,63,0.083776596
Chico-Redding,96003,45132,1177,1207,1397,3781,0.083776478
Honolulu,96782,36347,941,1039,1065,3045,0.083775827
Huntsville-Decatur (Flor),35674,19278,525,545,545,1615,0.08377425
New Orleans,70031,1325,45,35,31,111,0.083773585
Waco-Temple-Bryan,76853,1516,59,40,28,127,0.083773087
Savannah,31555,2853,84,80,75,239,0.083771469
Detroit,48215,10302,249,282,332,863,0.083770142
Clarksburg-Weston,26560,191,7,5,4,16,0.083769634
Nashville,42265,967,34,25,22,81,0.083764219
Boston (Manchester),1720,22958,755,686,482,1923,0.083761652
"Jackson, TN",38369,1946,62,47,54,163,0.083761562
New York,7631,30647,855,803,909,2567,0.083760238
Louisville,42776,2734,86,72,71,229,0.083760059
Minneapolis-St. Paul,55358,5468,181,147,130,458,0.083760059
New York,8691,17013,600,472,353,1425,0.083759478
Eureka,95519,18219,518,483,525,1526,0.083758713
Joplin-Pittsburg,67354,788,31,17,18,66,0.083756345
Little Rock-Pine Bluff,72041,1182,43,28,28,99,0.083756345
St. Louis,62265,4537,124,133,123,380,0.083755786
Charleston-Huntington,45656,6340,204,167,160,531,0.083753943
Peoria-Bloomington,61554,39736,1079,1097,1152,3328,0.083752768
Charleston-Huntington,25306,6269,156,176,193,525,0.083745414
St. Louis,63021,56016,1626,1626,1439,4691,0.08374393
Macon,30470,609,19,16,16,51,0.083743842
Shreveport,71051,2030,62,57,51,170,0.083743842
Raleigh-Durham (Fayetvlle),27803,21626,611,591,609,1811,0.083741792
Louisville,40328,1230,48,28,27,103,0.083739837
"Lafayette, LA",71367,1230,37,34,32,103,0.083739837
St. Louis,63028,28959,910,755,760,2425,0.083739079
Memphis,38117,26141,624,665,900,2189,0.083738189
Bluefield-Beckley-Oak Hill,25801,33056,965,937,866,2768,0.083736689
"Alexandria, LA",71369,2281,73,65,53,191,0.083735204
Pittsburgh,15684,418,9,16,10,35,0.083732057
Jacksonville,32003,31303,1051,891,679,2621,0.083729994
Greensboro-H.Point-W.Salem,27292,40275,1197,1079,1096,3372,0.083724395
Harrisburg-Lncstr-Leb-York,17043,5972,151,145,204,500,0.083724046
Wichita-Hutchinson Plus,67561,1493,60,39,26,125,0.083724046
Lansing,49082,6402,227,172,137,536,0.083723836
Joplin-Pittsburg,65723,3643,119,101,85,305,0.083722207
Los Angeles,92545,46165,1290,1304,1271,3865,0.083721434
Richmond-Petersburg,23934,645,21,17,16,54,0.08372093
Champaign&Sprngfld-Decatur,61852,215,6,7,5,18,0.08372093
Amarillo,79062,215,8,6,4,18,0.08372093
Eureka,95564,430,8,8,20,36,0.08372093
"Washington, DC (Hagrstwn)",20191,32298,745,902,1057,2704,0.083720354
Los Angeles,91030,26744,830,755,654,2239,0.083719713
Knoxville,37874,16078,470,449,427,1346,0.08371688
Chattanooga,37302,5268,160,160,121,441,0.083712984
Dallas-Ft. Worth,76636,1768,64,39,45,148,0.083710407
Indianapolis,47921,1111,31,35,27,93,0.083708371
Paducah-Cape Girard-Harsbg,62912,1123,34,32,28,94,0.083704363
Charleston-Huntington,25214,454,9,16,13,38,0.083700441
Raleigh-Durham (Fayetvlle),27508,2043,54,61,56,171,0.083700441
Louisville,40036,227,8,6,5,19,0.083700441
Sioux City,51231,227,9,4,6,19,0.083700441
Great Falls,59454,227,8,5,6,19,0.083700441
Quincy-Hannibal-Keokuk,62361,454,18,12,8,38,0.083700441
Beaumont-Port Arthur,77612,9331,288,270,223,781,0.083699496
Santabarbra-Sanmar-Sanluob,93433,12557,301,345,405,1051,0.083698336
"Washington, DC (Hagrstwn)",22657,12581,354,331,368,1053,0.083697639
Rochestr-Mason City-Austin,55979,920,33,25,19,77,0.083695652
New Orleans,70047,12199,394,330,297,1021,0.083695385
Louisville,40145,932,32,25,21,78,0.083690987
La Crosse-Eau Claire,54437,3059,104,76,76,256,0.08368748
Clarksburg-Weston,26250,5927,162,172,162,496,0.083684832
Providence-New Bedford,2876,239,7,8,5,20,0.083682008
Minneapolis-St. Paul,56330,1912,69,52,39,160,0.083682008
Baton Rouge,70817,37823,1064,1018,1083,3165,0.083679243
Minneapolis-St. Paul,55124,57219,1743,1493,1552,4788,0.083678498
Meridian,39325,5593,173,164,131,468,0.083676024
Charleston-Huntington,41571,490,16,14,11,41,0.083673469
Toledo,45858,2952,85,78,84,247,0.083672087
Terre Haute,47841,2223,77,52,57,186,0.083670715
Detroit,48014,3992,133,108,93,334,0.083667335
St. Louis,62024,8534,210,232,272,714,0.083665339
"Portland, OR",97028,251,6,6,9,21,0.083665339
Boston (Manchester),2420,15885,624,443,262,1329,0.083663834
St. Louis,62239,4566,133,125,124,382,0.083661848
"Lafayette, LA",70518,17523,551,457,458,1466,0.083661473
South Bend-Elkhart,46574,8164,258,206,219,683,0.083659971
Denver,69301,9479,286,265,242,793,0.083658614
Cedar Rapids-Wtrlo-IWC&Dub,52324,2582,92,71,53,216,0.083656081
Cincinnati,41010,2845,92,75,71,238,0.083655536
Mankato,56062,3132,107,83,72,262,0.083652618
Minneapolis-St. Paul,55076,21183,616,572,584,1772,0.083651985
Philadelphia,18031,12313,403,322,305,1030,0.083651425
Cleveland-Akron (Canton),44641,20108,602,560,520,1682,0.083648299
"Columbus, GA (Opelika, AL)",31824,1590,48,47,38,133,0.083647799
Indianapolis,46001,10616,291,298,299,888,0.083647325
"Rochester, NY",14624,36427,979,997,1071,3047,0.083646746
Joplin-Pittsburg,64840,2941,88,81,77,246,0.083645019
Cincinnati,41083,1339,38,32,42,112,0.083644511
Tampa-St. Pete (Sarasota),33890,4555,161,110,110,381,0.083644347
Wichita-Hutchinson Plus,67860,2953,101,71,75,247,0.083643752
Denver,82301,8608,273,228,219,720,0.083643123
Savannah,29927,10569,326,286,272,884,0.083640836
"Jackson, TN",38334,1901,63,54,42,159,0.083640189
Omaha,68649,1901,73,51,35,159,0.083640189
Philadelphia,8009,14515,411,389,414,1214,0.083637616
Bluefield-Beckley-Oak Hill,25902,275,9,7,7,23,0.083636364
Chattanooga,35740,3300,94,80,102,276,0.083636364
Dayton,45333,1375,46,40,29,115,0.083636364
Greensboro-H.Point-W.Salem,27041,7712,245,217,183,645,0.083635892
Evansville,47615,1387,42,34,40,116,0.083633742
Knoxville,37924,13918,397,399,368,1164,0.083632706
Indianapolis,47930,1124,29,30,35,94,0.083629893
Champaign&Sprngfld-Decatur,61864,1686,58,44,39,141,0.083629893
Philadelphia,18902,21954,719,655,462,1836,0.083629407
Chicago,46385,42462,1359,1152,1040,3551,0.083627714
Spokane,83858,19874,654,536,472,1662,0.083626849
Seattle-Tacoma,98001,37895,1062,1060,1047,3169,0.083625808
Greenvll-Spart-Ashevll-And,30553,8060,226,220,228,674,0.083622829
"Columbus, OH",43136,2320,80,64,50,194,0.08362069
Houston,77430,2320,71,69,54,194,0.08362069
Louisville,40146,4162,114,111,123,348,0.083613647
Yuma-El Centro,85347,299,11,7,7,25,0.08361204
Savannah,31519,3612,111,99,92,302,0.083610188
Orlando-Daytona Bch-Melbrn,32180,3947,125,104,101,330,0.083607803
Cleveland-Akron (Canton),44663,25536,733,738,664,2135,0.083607456
Omaha,51553,921,36,23,18,77,0.083604777
Louisville,40228,18277,505,487,536,1528,0.083602342
Ft. Wayne,46723,7440,236,196,190,622,0.083602151
Paducah-Cape Girard-Harsbg,62994,622,22,11,19,52,0.083601286
Evansville,47610,5658,176,145,152,473,0.083598445
Des Moines-Ames,50054,3553,112,112,73,297,0.083591331
West Palm Beach-Ft. Pierce,34946,6819,209,188,173,570,0.083589969
Charlotte,29710,44564,1474,1168,1083,3725,0.083587649
Syracuse,13111,1651,44,51,43,138,0.083585706
Tampa-St. Pete (Sarasota),33881,41432,1306,1115,1042,3463,0.083582738
Great Falls,59484,335,11,8,9,28,0.08358209
Kansas City,64664,335,8,11,9,28,0.08358209
"Columbia, SC",29160,8196,247,222,216,685,0.083577355
Los Angeles,90504,31564,788,847,1003,2638,0.083576226
Spokane,99223,35872,992,1019,987,2998,0.083574933
Ottumwa-Kirksville,63552,7598,219,227,189,635,0.083574625
Knoxville,42647,3470,121,92,77,290,0.083573487
Sioux Falls(Mitchell),57005,12839,483,321,269,1073,0.083573487
Dallas-Ft. Worth,76681,694,25,20,13,58,0.083573487
Flint-Saginaw-Bay City,48473,21538,644,611,545,1800,0.083573219
Austin,78654,21145,626,634,507,1767,0.083565855
Detroit,48760,1436,44,39,37,120,0.08356546
Houston,75960,1077,34,27,29,90,0.08356546
Charlotte,29520,12733,375,352,337,1064,0.083562397
Tallahassee-Thomasville,31641,2190,71,57,55,183,0.083561644
Terre Haute,47561,1472,55,34,34,123,0.083559783
Denver,80130,26389,1033,657,515,2205,0.083557543
Monroe-El Dorado,71254,4859,152,144,110,406,0.083556287
New York,8733,2621,61,72,86,219,0.083555895
Rapid City,57717,8629,252,235,234,721,0.083555453
Cleveland-Akron (Canton),44657,9778,290,270,257,817,0.083554919
Syracuse,13069,23686,692,633,654,1979,0.083551465
Monroe-El Dorado,71269,12340,398,327,306,1031,0.083549433
Little Rock-Pine Bluff,71940,1544,49,47,33,129,0.083549223
Corpus Christi,78377,3483,122,101,68,291,0.083548665
"Rochester, NY",13148,10102,281,276,287,844,0.083547812
South Bend-Elkhart,46534,11299,341,310,293,944,0.083547217
Chicago,60118,16590,417,443,526,1386,0.083544304
Birmingham (Ann and Tusc),35210,15118,297,375,591,1263,0.083542797
Oklahoma City,74630,802,15,25,27,67,0.083541147
Minneapolis-St. Paul,55044,63742,2183,1694,1448,5325,0.083539895
Charleston-Huntington,45640,15801,461,430,429,1320,0.083539017
Dothan,36352,5674,198,151,125,474,0.08353895
Philadelphia,19018,22864,598,602,710,1910,0.083537439
Charleston-Huntington,25523,2466,76,72,58,206,0.083536091
Cedar Rapids-Wtrlo-IWC&Dub,52210,826,33,21,15,69,0.083535109
Shreveport,71055,17442,524,458,475,1457,0.083533998
Tyler-Longview(Lfkn&Ncgd),75968,1664,64,46,29,139,0.083533654
Tulsa,74036,7518,245,212,171,628,0.083532854
Nashville,42170,1676,57,44,39,140,0.08353222
Denver,80741,838,25,24,21,70,0.08353222
New York,8859,24901,619,688,773,2080,0.083530782
Davenport-R.Island-Moline,52802,9817,283,285,252,820,0.083528573
New York,7605,9003,270,267,215,752,0.083527713
Knoxville,37860,3879,106,111,107,324,0.083526682
Youngstown,44505,16953,465,464,487,1416,0.08352504
Bowling Green,42141,32721,1009,874,850,2733,0.083524342
Lexington,40334,443,12,12,13,37,0.083521445
Panama City,32431,5340,179,137,130,446,0.083520599
"Albany, GA",31738,2227,77,51,58,186,0.083520431
Houston,77564,2263,78,59,52,189,0.083517455
Cleveland-Akron (Canton),44646,47260,1347,1261,1339,3947,0.083516716
Watertown,13694,1365,39,43,32,114,0.083516484
Des Moines-Ames,50441,5460,185,144,127,456,0.083516484
La Crosse-Eau Claire,54619,4095,149,95,98,342,0.083516484
"Washington, DC (Hagrstwn)",25414,21589,712,580,511,1803,0.083514753
South Bend-Elkhart,46573,3712,105,92,113,310,0.083512931
Detroit,48192,24751,620,683,764,2067,0.083511777
Los Angeles,92653,28081,746,804,795,2345,0.083508422
Shreveport,74963,479,13,12,15,40,0.083507307
Philadelphia,19320,54033,1674,1489,1349,4512,0.083504525
"Washington, DC (Hagrstwn)",22025,16610,520,450,417,1387,0.083503913
Green Bay-Appleton,54301,23975,671,684,647,2002,0.08350365
Sioux Falls(Mitchell),57048,982,36,31,15,82,0.083503055
Little Rock-Pine Bluff,71725,491,11,16,14,41,0.083503055
Salt Lake City,84036,9832,331,245,245,821,0.083502848
"Washington, DC (Hagrstwn)",21793,10850,370,290,246,906,0.083502304
Roanoke-Lynchburg,24015,15317,311,438,530,1279,0.083501991
Peoria-Bloomington,61769,527,22,10,12,44,0.083491461
Dallas-Ft. Worth,76085,13283,432,363,314,1109,0.083490175
"Columbus, OH",43102,4312,147,114,99,360,0.083487941
Charleston-Huntington,41143,14134,414,415,351,1180,0.083486628
Cincinnati,45113,3821,126,110,83,319,0.083485998
Detroit,48370,1653,63,42,33,138,0.083484574
"Portland, OR",98675,7547,274,190,166,630,0.083476878
Birmingham (Ann and Tusc),35087,2360,68,68,61,197,0.083474576
Detroit,48353,6565,193,197,158,548,0.083472963
Spokane,99021,10159,359,296,193,848,0.083472783
Mobile-Pensacola (Ft Walt),36401,6589,213,179,158,550,0.083472454
Philadelphia,19020,58175,1473,1545,1838,4856,0.083472282
Buffalo,14530,5439,163,141,150,454,0.083471226
Philadelphia,8349,1821,54,55,43,152,0.083470621
Harrisburg-Lncstr-Leb-York,17366,4924,139,139,133,411,0.083468725
Erie,16360,1234,36,38,29,103,0.083468395
Tampa-St. Pete (Sarasota),34637,12604,442,336,274,1052,0.083465566
Baltimore,21114,26478,901,685,624,2210,0.083465519
Wichita Falls & Lawton,76255,5703,176,150,150,476,0.083464843
Atlanta,30534,35908,1021,937,1039,2997,0.083463295
Seattle-Tacoma,98275,21483,608,618,567,1793,0.083461342
Jacksonville,32250,32123,690,849,1142,2681,0.083460449
Phoenix (Prescott),85631,3295,114,77,84,275,0.083459788
Detroit,48435,1989,68,46,52,166,0.083459025
Utica,13431,2001,60,55,52,167,0.083458271
Evansville,42451,671,21,22,13,56,0.083457526
Orlando-Daytona Bch-Melbrn,34705,2708,69,82,75,226,0.083456425
Dallas-Ft. Worth,76271,2037,71,55,44,170,0.083456063
Norfolk-Portsmth-Newpt Nws,23661,13624,362,379,396,1137,0.083455666
Chicago,60403,20550,541,557,617,1715,0.083454988
Wilkes Barre-Scranton-Hztn,17737,6866,208,182,183,573,0.083454704
Dayton,43072,5692,185,148,142,475,0.083450457
Grand Rapids-Kalmzoo-B.Crk,49301,20695,792,594,341,1727,0.083450109
"Columbus, OH",43025,5764,148,163,170,481,0.083448994
Palm Springs,92276,8089,240,231,204,675,0.083446656
Louisville,40067,5896,215,153,124,492,0.083446404
Indianapolis,47990,1474,49,38,36,123,0.083446404
Ft. Smith-Fay-Sprngdl-Rgrs,72932,1474,46,38,39,123,0.083446404
Tulsa,74029,5189,186,117,130,433,0.083445751
Charlotte,28634,5333,171,136,138,445,0.083442715
"Portland, OR",97013,26102,814,692,672,2178,0.083441882
Dothan,36467,10031,281,291,265,837,0.083441332
Los Angeles,93003,49544,1345,1375,1414,4134,0.083440982
Harrisburg-Lncstr-Leb-York,17578,7131,214,197,184,595,0.083438508
Lake Charles,70655,2421,67,80,55,202,0.083436596
Toledo,43420,29160,884,808,741,2433,0.083436214
New York,7755,6532,179,185,181,545,0.083435395
Peoria-Bloomington,61542,3344,101,86,92,279,0.083433014
Cleveland-Akron (Canton),44270,8378,238,236,225,699,0.0834328
Jacksonville,31566,3428,101,93,92,286,0.083430572
Erie,16506,24020,636,654,714,2004,0.083430475
Memphis,38632,31236,1075,795,736,2606,0.083429376
Raleigh-Durham (Fayetvlle),28334,23661,725,661,588,1974,0.083428427
Twin Falls,83347,3512,126,88,79,293,0.083428246
Yakima-Pasco-Rchlnd-Knnwck,98908,40469,1212,1124,1040,3376,0.083421878
Wichita-Hutchinson Plus,67835,2829,106,66,64,236,0.083421704
Toledo,49279,947,33,24,22,79,0.083421331
Shreveport,71001,3848,93,116,112,321,0.083419958
Lincoln & Hastings-Krny,69001,9027,267,244,242,753,0.083416417
Chattanooga,37826,5119,148,148,131,427,0.083414729
Norfolk-Portsmth-Newpt Nws,27921,5143,168,145,116,429,0.08341435
Baltimore,21163,7349,258,213,142,613,0.083412709
Hartford & New Haven,6702,4220,93,135,124,352,0.083412322
Ft. Myers-Naples,33905,42440,1088,1173,1279,3540,0.083411876
Cheyenne-Scottsbluff,69336,2122,70,52,55,177,0.083411876
Syracuse,13409,2158,65,62,53,180,0.083410565
Burlington-Plattsburgh,12913,1139,32,30,33,95,0.083406497
Quincy-Hannibal-Keokuk,63445,3597,105,94,101,300,0.083402836
Columbus-Tupelo-West Point,39752,2470,72,63,71,206,0.08340081
Kansas City,64097,1247,40,34,30,104,0.08340016
Atlanta,30040,92686,3420,2525,1785,7730,0.083399866
Boston (Manchester),2189,15228,388,384,498,1270,0.083399002
Norfolk-Portsmth-Newpt Nws,23692,19773,594,600,455,1649,0.083396551
Pittsburgh,15436,2722,89,68,70,227,0.083394563
"Portland, OR",98606,11008,378,299,241,918,0.083393895
"Washington, DC (Hagrstwn)",22015,43229,1389,1226,990,3605,0.083393093
Knoxville,37729,1403,50,38,29,117,0.08339273
Zanesville,43727,1403,46,39,32,117,0.08339273
Wilmington,28312,20134,629,567,483,1679,0.083391278
Dayton,45373,38399,1132,1068,1002,3202,0.083387588
Paducah-Cape Girard-Harsbg,62952,3082,104,84,69,257,0.083387411
Richmond-Petersburg,23111,39287,1225,1055,996,3276,0.083386362
Chattanooga,37380,6296,179,170,176,525,0.083386277
Minneapolis-St. Paul,56401,31876,986,871,801,2658,0.083385619
New York,10536,10854,387,307,211,905,0.083379399
New York,7733,17331,600,504,341,1445,0.083376608
Philadelphia,19006,23136,802,657,470,1929,0.083376556
Boston (Manchester),2184,39244,1118,1115,1039,3272,0.083375803
Oklahoma City,73084,6729,224,177,160,561,0.083370486
Augusta-Aiken,29832,4750,145,125,126,396,0.083368421
Cleveland-Akron (Canton),44706,16745,475,441,480,1396,0.08336817
Indianapolis,46158,24770,792,670,603,2065,0.083366976
Dayton,45338,5026,171,128,120,419,0.083366494
Columbus-Tupelo-West Point,38915,3239,107,94,69,270,0.083359061
Wilkes Barre-Scranton-Hztn,18360,28324,753,803,805,2361,0.08335687
Little Rock-Pine Bluff,72556,3551,107,95,94,296,0.083356801
Minneapolis-St. Paul,56329,7498,256,203,166,625,0.083355561
Ft. Wayne,46970,23190,683,659,591,1933,0.083354894
Eugene,97408,15740,408,448,456,1312,0.083354511
Columbus-Tupelo-West Point,38868,4799,139,122,139,400,0.083350698
Chicago,60013,26023,798,732,639,2169,0.083349345
Ft. Myers-Naples,33966,16197,336,420,594,1350,0.083348768
New York,11001,27163,702,805,757,2264,0.083348673
New York,11427,22952,514,648,751,1913,0.083347856
Charlotte,28138,11327,373,303,268,944,0.08334069
New York,7436,12515,355,399,289,1043,0.083339992
New York,7806,36,1,1,1,3,0.083333333
New York,11252,756,30,18,15,63,0.083333333
Utica,13834,24,1,1,0,2,0.083333333
Binghamton,13863,408,13,12,9,34,0.083333333
Buffalo,14039,96,2,3,3,8,0.083333333
"Rochester, NY",14480,648,16,19,19,54,0.083333333
Pittsburgh,16228,192,6,5,5,16,0.083333333
Harrisburg-Lncstr-Leb-York,17014,24,1,0,1,2,0.083333333
Johnstown-Altoona-St Colge,17239,300,9,9,7,25,0.083333333
Philadelphia,19029,3948,108,106,115,329,0.083333333
"Washington, DC (Hagrstwn)",20621,1164,38,28,31,97,0.083333333
Charleston-Huntington,25204,72,2,2,2,6,0.083333333
Atlanta,31085,1236,37,37,29,103,0.083333333
Birmingham (Ann and Tusc),35458,696,18,21,19,58,0.083333333
Montgomery-Selma,36013,564,19,17,11,47,0.083333333
Nashville,37022,6120,194,159,157,510,0.083333333
Memphis,38846,1836,48,54,51,153,0.083333333
Louisville,40007,240,9,7,4,20,0.083333333
"Tri-Cities, TN-VA",40816,36,1,1,1,3,0.083333333
Knoxville,40964,84,3,2,2,7,0.083333333
Charleston-Huntington,41647,1152,28,34,34,96,0.083333333
Charleston-Huntington,41663,120,4,3,3,10,0.083333333
Cleveland-Akron (Canton),44428,2832,85,79,72,236,0.083333333
Lima,45809,108,4,2,3,9,0.083333333
"Columbus, OH",45843,3660,118,94,93,305,0.083333333
Cincinnati,47016,780,29,20,16,65,0.083333333
Detroit,48475,2736,80,75,73,228,0.083333333
Des Moines-Ames,50594,240,9,5,6,20,0.083333333
Des Moines-Ames,50861,264,9,7,6,22,0.083333333
Fargo,56565,96,3,3,2,8,0.083333333
Rockford,61112,144,3,4,5,12,0.083333333
Champaign&Sprngfld-Decatur,62512,384,12,10,10,32,0.083333333
Champaign&Sprngfld-Decatur,62539,1152,32,38,26,96,0.083333333
Paducah-Cape Girard-Harsbg,63747,456,14,14,10,38,0.083333333
Kansas City,64745,96,3,3,2,8,0.083333333
Joplin-Pittsburg,64771,456,15,14,9,38,0.083333333
Columbia-Jefferson City,65243,2604,91,70,56,217,0.083333333
"Springfield, MO",65754,1128,40,29,25,94,0.083333333
Wichita-Hutchinson Plus,67118,684,26,18,13,57,0.083333333
Wichita-Hutchinson Plus,67131,312,10,9,7,26,0.083333333
Joplin-Pittsburg,67332,252,9,5,7,21,0.083333333
Sioux City,68641,1092,39,23,29,91,0.083333333
Oklahoma City,73855,168,7,4,3,14,0.083333333
Oklahoma City,74869,672,23,22,11,56,0.083333333
Amarillo,79124,11676,420,327,226,973,0.083333333
Twin Falls,83320,1116,39,31,23,93,0.083333333
Spokane,83834,252,9,7,5,21,0.083333333
Salt Lake City,84304,36,1,1,1,3,0.083333333
Albuquerque-Santa Fe,87083,468,15,12,12,39,0.083333333
Albuquerque-Santa Fe,88114,48,1,2,1,4,0.083333333
Albuquerque-Santa Fe,88136,60,2,2,1,5,0.083333333
Boise,97917,60,2,2,1,5,0.083333333
New Orleans,70447,18241,709,461,350,1520,0.083328765
Detroit,48383,13189,366,378,355,1099,0.083327015
Phoenix (Prescott),85901,27077,896,734,626,2256,0.083317945
Little Rock-Pine Bluff,72086,10730,326,289,279,894,0.083317801
St. Louis,62223,15735,418,450,443,1311,0.083317445
Shreveport,71857,5173,155,147,129,431,0.083317224
Milwaukee,53032,5005,159,124,134,417,0.083316683
Toledo,43506,14535,424,395,392,1211,0.083316133
"Columbus, OH",43821,4753,151,122,123,396,0.083315801
Panama City,32438,4609,158,123,103,384,0.083315253
Tampa-St. Pete (Sarasota),33594,31592,959,871,802,2632,0.083312231
Dallas-Ft. Worth,76023,7622,259,197,179,635,0.083311467
Lexington,40391,36946,1078,955,1045,3078,0.083310778
Huntsville-Decatur (Flor),35989,3529,116,96,82,294,0.083309719
Cincinnati,45069,55036,1671,1459,1455,4585,0.083309107
Sioux Falls(Mitchell),57032,10107,373,238,231,842,0.083308598
Indianapolis,47959,3097,112,85,61,258,0.083306426
Cleveland-Akron (Canton),44666,3085,102,74,81,257,0.083306321
"Springfield, MO",65663,2677,85,76,62,223,0.083302204
Dallas-Ft. Worth,75417,2437,85,61,57,203,0.083299138
Minneapolis-St. Paul,55420,23134,616,639,672,1927,0.083297311
Lexington,40437,4358,140,118,105,363,0.083295089
Dallas-Ft. Worth,75167,15127,530,394,336,1260,0.083294771
Chicago,60468,6087,178,159,170,507,0.083292262
San Francisco-Oak-San Jose,94587,69179,1712,1849,2201,5762,0.083291172
Seattle-Tacoma,98532,27134,825,756,679,2260,0.083290337
New York,11570,28564,893,812,674,2379,0.083286655
Denver,80615,10638,353,278,255,886,0.083286332
Knoxville,37871,8741,256,239,233,728,0.083285665
Tulsa,74454,3350,110,100,69,279,0.083283582
Richmond-Petersburg,23860,32192,917,851,913,2681,0.083281561
Boston (Manchester),1082,10807,305,309,286,900,0.083279356
Knoxville,37914,21387,599,589,593,1781,0.083274887
Madison,53924,1309,40,35,34,109,0.083269672
Providence-New Bedford,2914,22049,537,587,712,1836,0.083269082
Champaign&Sprngfld-Decatur,61842,2570,74,73,67,214,0.083268482
Meridian,39355,6341,185,182,161,528,0.083267623
Wilkes Barre-Scranton-Hztn,18216,1201,30,23,47,100,0.083263947
Wichita-Hutchinson Plus,67431,2366,104,56,37,197,0.083262891
New York,7417,11338,372,328,244,944,0.083259834
St. Joseph,64469,2210,66,64,54,184,0.083257919
Toledo,43545,14065,394,394,383,1171,0.08325631
Houston,77435,5393,169,147,133,449,0.083256073
Harrisburg-Lncstr-Leb-York,17302,3231,88,86,95,269,0.083255958
"Washington, DC (Hagrstwn)",25442,2150,67,63,49,179,0.083255814
Erie,16438,7483,228,205,190,623,0.083255379
New York,7624,8420,283,249,169,701,0.083254157
Charlotte,28658,25885,750,683,722,2155,0.083252849
Syracuse,13077,6186,209,160,146,515,0.083252506
Kansas City,64742,2054,65,50,56,171,0.083252191
"Columbia, SC",29178,3075,96,80,80,256,0.083252033
Peoria-Bloomington,61744,2006,72,51,44,167,0.083250249
"Columbus, OH",43107,2955,102,75,69,246,0.083248731
Green Bay-Appleton,54313,40242,1312,1160,878,3350,0.08324636
Nashville,38487,925,26,25,26,77,0.083243243
Oklahoma City,73025,16578,678,449,253,1380,0.083242852
Indianapolis,46182,1838,55,43,55,153,0.083242655
Boston (Manchester),2110,2727,27,95,105,227,0.083241657
Mobile-Pensacola (Ft Walt),36525,1814,53,53,45,151,0.083241455
Philadelphia,19001,18861,643,510,417,1570,0.083240549
Baton Rouge,70764,15113,455,445,358,1258,0.083239595
Seattle-Tacoma,98516,31800,812,788,1047,2647,0.083238994
Grand Rapids-Kalmzoo-B.Crk,49341,38240,1311,1064,808,3183,0.083237448
Buffalo,14223,22394,517,611,736,1864,0.083236581
Traverse City-Cadillac,49696,10200,325,284,240,849,0.083235294
Terre Haute,47465,841,31,25,14,70,0.083234245
"Rochester, NY",14559,17409,538,474,437,1449,0.083232811
Kansas City,64055,35996,892,986,1118,2996,0.08323147
La Crosse-Eau Claire,54660,16268,487,434,433,1354,0.083230883
"Tri-Cities, TN-VA",37660,40924,1117,1116,1173,3406,0.083227446
Chicago,60180,1574,49,46,36,131,0.083227446
Los Angeles,91311,39062,954,1124,1173,3251,0.083226665
Boston (Manchester),2190,20222,471,529,683,1683,0.083226189
Philadelphia,19473,15849,541,442,336,1319,0.083222916
St. Louis,62080,2223,71,63,51,185,0.083220873
Grand Rapids-Kalmzoo-B.Crk,49068,14011,385,367,414,1166,0.083220327
Minneapolis-St. Paul,55448,29225,849,780,803,2432,0.083216424
Charleston-Huntington,41141,2103,69,52,54,175,0.083214456
Dallas-Ft. Worth,75166,9097,298,241,218,757,0.083214246
Wausau-Rhinelander,54403,25104,700,711,678,2089,0.08321383
Los Angeles,90807,31990,773,889,1000,2662,0.083213504
Rochestr-Mason City-Austin,55917,3473,116,94,79,289,0.08321336
Chicago,60034,2079,58,61,54,173,0.083213083
Sioux City,51301,12438,393,326,316,1035,0.083212735
Grand Rapids-Kalmzoo-B.Crk,49441,36293,1007,932,1081,3020,0.083211639
Richmond-Petersburg,24522,10203,277,288,284,849,0.08321082
Denver,80723,6778,203,170,191,564,0.083210387
Los Angeles,90210,19722,565,559,517,1641,0.083206571
Ft. Smith-Fay-Sprngdl-Rgrs,72943,2572,87,70,57,214,0.083203733
Louisville,42732,1923,57,50,53,160,0.083203328
Charleston-Huntington,25311,9339,204,280,293,777,0.083199486
New York,7712,39640,921,1143,1234,3298,0.083198789
San Diego,92065,36469,1095,1020,919,3034,0.083193946
Baltimore,21160,2380,62,71,65,198,0.083193277
Salt Lake City,83111,589,23,14,12,49,0.083191851
New York,11372,68602,1625,1898,2184,5707,0.083189994
New York,7945,10194,332,323,193,848,0.083186188
Mobile-Pensacola (Ft Walt),36529,565,19,18,10,47,0.083185841
Cheyenne-Scottsbluff,69352,565,20,16,11,47,0.083185841
Panama City,32449,553,18,16,12,46,0.08318264
Evansville,42371,553,16,17,13,46,0.08318264
La Crosse-Eau Claire,54648,1659,56,40,42,138,0.08318264
Jonesboro,72412,553,17,15,14,46,0.08318264
Baltimore,21045,39744,1097,1040,1169,3306,0.083182367
Huntsville-Decatur (Flor),35974,1623,52,42,41,135,0.083179298
Little Rock-Pine Bluff,72156,541,18,13,14,45,0.083179298
"Albany, GA",31798,1070,32,30,27,89,0.08317757
Joplin-Pittsburg,64728,529,18,15,11,44,0.083175803
Dothan,36477,4689,140,143,107,390,0.083173385
Atlanta,30747,16099,454,443,442,1339,0.083172868
Louisville,47147,1034,35,27,24,86,0.083172147
Lincoln & Hastings-Krny,68815,505,19,13,10,42,0.083168317
Utica,13357,10052,297,271,268,836,0.083167529
Baltimore,21108,21511,635,592,562,1789,0.083166752
Cedar Rapids-Wtrlo-IWC&Dub,52778,3896,117,109,98,324,0.083162218
Los Angeles,93035,27597,717,802,776,2295,0.083161213
Topeka,66615,3367,83,111,86,280,0.083160083
Philadelphia,8097,3331,99,86,92,277,0.083158211
Wilkes Barre-Scranton-Hztn,17702,10234,295,248,308,851,0.083154192
Philadelphia,8562,5111,145,136,144,425,0.083153982
Chicago,60172,24473,672,706,657,2035,0.083152862
Omaha,68410,8695,270,232,221,723,0.083151236
Houston,77482,2273,71,64,54,189,0.083150022
Dayton,45318,5412,170,144,136,450,0.083148559
Baton Rouge,70514,1804,59,38,53,150,0.083148559
Traverse City-Cadillac,49659,6699,213,188,156,557,0.083146738
Little Rock-Pine Bluff,71933,1323,43,37,30,110,0.083144369
Macon,31058,1756,53,47,46,146,0.083143508
Terre Haute,62445,878,32,22,19,73,0.083143508
Boston (Manchester),1748,19292,688,548,368,1604,0.083143272
Baltimore,21158,21036,655,565,529,1749,0.083143183
Buffalo,14843,12256,338,333,348,1019,0.08314295
Charlotte,28088,3488,100,78,112,290,0.083142202
Quincy-Hannibal-Keokuk,62360,1744,58,46,41,145,0.083142202
St. Louis,63077,12112,345,334,328,1007,0.083140687
West Palm Beach-Ft. Pierce,33435,38056,892,1112,1160,3164,0.083140635
Indianapolis,46979,4980,164,138,112,414,0.08313253
Greenville-N.Bern-Washngtn,27892,13220,398,358,343,1099,0.083131619
Chicago,61038,1227,40,34,28,102,0.083129584
Sioux Falls(Mitchell),57262,5269,162,142,134,438,0.083127728
Ft. Smith-Fay-Sprngdl-Rgrs,72941,5245,187,135,114,436,0.083126787
Wichita Falls & Lawton,73569,397,13,10,10,33,0.083123426
Louisville,47167,15808,481,425,408,1314,0.08312247
Omaha,68136,22112,860,569,409,1838,0.083122287
Lexington,42539,10142,324,262,257,843,0.0831197
Peoria-Bloomington,61739,4668,157,132,99,388,0.083119109
Cincinnati,47032,3080,93,81,82,256,0.083116883
Louisville,42528,1516,52,35,39,126,0.083113456
Bangor,4937,6365,174,188,167,529,0.083110762
"Columbus, OH",45628,5583,162,146,156,464,0.083109439
Paducah-Cape Girard-Harsbg,62951,5186,139,157,135,431,0.083108369
Green Bay-Appleton,54126,4055,133,109,95,337,0.083107275
Minneapolis-St. Paul,55334,2936,94,65,85,244,0.083106267
Paducah-Cape Girard-Harsbg,62999,1456,46,31,44,121,0.083104396
Chattanooga,35772,4717,143,132,117,392,0.083103668
New York,6880,26798,986,778,463,2227,0.083103217
Pittsburgh,16326,361,12,9,9,30,0.083102493
Wheeling-Steubenville,43964,9025,253,233,264,750,0.083102493
"Lafayette, LA",70537,722,22,22,16,60,0.083102493
Chico-Redding,96001,34705,907,992,985,2884,0.083100418
Roanoke-Lynchburg,24134,5632,168,149,151,468,0.083096591
Denver,80108,39293,1481,1056,728,3265,0.083093681
"Rochester, NY",14489,7245,205,192,205,602,0.083091787
Boston (Manchester),2090,16187,537,481,327,1345,0.08309137
Minneapolis-St. Paul,54017,21338,704,564,505,1773,0.083091199
Dallas-Ft. Worth,75422,3069,94,80,81,255,0.083088954
Ft. Wayne,46794,1360,41,31,41,113,0.083088235
Ft. Wayne,45833,10796,327,288,282,897,0.083086328
Paducah-Cape Girard-Harsbg,38260,3707,102,102,104,308,0.083086053
Wichita Falls & Lawton,73570,1011,32,36,16,84,0.083086053
Hattiesburg-Laurel,39421,2684,77,75,71,223,0.083084948
Champaign&Sprngfld-Decatur,60938,2010,62,57,48,167,0.083084577
Duluth-Superior,55719,5669,166,165,140,471,0.083083436
New York,10986,1661,37,55,46,138,0.08308248
Rockford,61073,19632,627,547,457,1631,0.083078647
"Washington, DC (Hagrstwn)",20839,325,12,9,6,27,0.083076923
St. Joseph,64483,650,19,19,16,54,0.083076923
Waco-Temple-Bryan,76566,325,11,9,7,27,0.083076923
Medford-Klamath Falls,96058,650,16,24,14,54,0.083076923
New Orleans,70090,7042,211,189,185,585,0.083072991
Mobile-Pensacola (Ft Walt),36551,11364,343,311,290,944,0.083069342
Seattle-Tacoma,98178,27122,694,740,819,2253,0.083069095
"Jackson, TN",38330,3768,112,98,103,313,0.083067941
Paducah-Cape Girard-Harsbg,62931,626,18,21,13,52,0.083067093
San Francisco-Oak-San Jose,94592,939,23,22,33,78,0.083067093
Hattiesburg-Laurel,39360,2793,80,77,75,232,0.083064805
"Charleston, SC",29464,54211,1201,1290,2012,4503,0.083064323
Baton Rouge,70732,1228,32,33,37,102,0.083061889
Denver,80831,36527,1342,927,765,3034,0.083061845
"Rochester, NY",14472,7970,213,255,194,662,0.083061481
Greenvll-Spart-Ashevll-And,29684,5129,182,132,112,426,0.083057126
Dallas-Ft. Worth,76073,7236,239,200,162,601,0.083056938
Bluefield-Beckley-Oak Hill,25989,301,10,7,8,25,0.083056478
Lexington,41367,301,11,6,8,25,0.083056478
Kansas City,64647,301,9,9,7,25,0.083056478
Philadelphia,19043,3299,84,88,102,274,0.083055471
Dallas-Ft. Worth,76060,9897,321,277,224,822,0.083055471
St. Louis,62257,2697,85,79,60,224,0.083055247
"Washington, DC (Hagrstwn)",22003,57203,1644,1557,1550,4751,0.083055085
Ft. Wayne,45882,2974,106,61,80,247,0.083053127
Grand Rapids-Kalmzoo-B.Crk,48809,11595,328,289,346,963,0.08305304
Philadelphia,8086,8621,249,218,249,716,0.08305301
Harrisburg-Lncstr-Leb-York,17047,2661,95,62,64,221,0.083051484
Ft. Smith-Fay-Sprngdl-Rgrs,72940,2661,93,66,62,221,0.083051484
Champaign&Sprngfld-Decatur,61853,14738,548,373,303,1224,0.083050617
"Springfield, MO",65483,4708,146,131,114,391,0.083050127
Champaign&Sprngfld-Decatur,62462,1168,39,29,29,97,0.083047945
Cedar Rapids-Wtrlo-IWC&Dub,50604,1734,65,39,40,144,0.083044983
New York,7719,22169,545,582,714,1841,0.08304389
Champaign&Sprngfld-Decatur,61956,2878,95,84,60,239,0.08304378
Denver,80232,22446,551,577,736,1864,0.083043749
Chicago,46303,19207,608,503,484,1595,0.083042641
Nashville,37032,4865,155,130,119,404,0.083042138
"Jackson, TN",38372,18015,539,501,456,1496,0.08304191
Raleigh-Durham (Fayetvlle),27549,25421,815,700,596,2111,0.08304158
Myrtle Beach-Florence,29546,2264,73,68,47,188,0.083038869
"Portland, OR",97041,2782,80,79,72,231,0.083033789
Corpus Christi,78404,14705,367,402,452,1221,0.083032982
New York,12435,277,8,8,7,23,0.083032491
Des Moines-Ames,50234,554,24,13,9,46,0.083032491
Paducah-Cape Girard-Harsbg,63760,277,9,8,6,23,0.083032491
Wichita-Hutchinson Plus,67510,277,7,8,8,23,0.083032491
Lincoln & Hastings-Krny,68323,277,9,5,9,23,0.083032491
Charlotte,28092,38720,1119,1028,1068,3215,0.083032025
New Orleans,70448,26195,850,726,599,2175,0.083031113
Chicago,60556,1927,57,43,60,160,0.083030618
Dallas-Ft. Worth,75023,46731,1287,1231,1362,3880,0.083028397
"Tri-Cities, TN-VA",24311,1638,46,49,41,136,0.083028083
Watertown,13654,2722,94,65,67,226,0.083027186
Lincoln & Hastings-Krny,68632,4083,125,109,105,339,0.083027186
Memphis,72365,2722,75,84,67,226,0.083027186
Boston (Manchester),1886,26895,943,769,521,2233,0.083026585
Seattle-Tacoma,98512,33074,815,913,1018,2746,0.083025942
Detroit,48453,4878,141,128,136,405,0.08302583
Kansas City,64465,4854,160,130,113,403,0.08302431
Baltimore,21209,29064,769,723,921,2413,0.083023672
Ft. Smith-Fay-Sprngdl-Rgrs,74936,807,24,24,19,67,0.083023544
Augusta-Aiken,29810,3481,117,93,79,289,0.08302212
Mobile-Pensacola (Ft Walt),36444,530,16,16,12,44,0.083018868
Fargo,56556,1060,33,29,26,88,0.083018868
Salt Lake City,89823,265,10,6,6,22,0.083018868
Los Angeles,91011,19875,715,540,395,1650,0.083018868
New Orleans,70455,2096,67,52,55,174,0.083015267
Erie,16407,9950,292,265,269,826,0.083015075
Davenport-R.Island-Moline,61244,25068,732,668,681,2081,0.083014201
Yakima-Pasco-Rchlnd-Knnwck,99330,1301,37,41,30,108,0.083013067
Greenvll-Spart-Ashevll-And,29657,15770,465,416,428,1309,0.083005707
Philadelphia,19078,11445,310,290,350,950,0.083005679
New York,7758,5084,152,147,123,422,0.083005507
Cedar Rapids-Wtrlo-IWC&Dub,52355,253,8,7,6,21,0.083003953
Panama City,32409,10554,334,292,250,876,0.083001706
Jacksonville,31523,15578,527,417,349,1293,0.083001669
Boston (Manchester),1537,2000,53,45,68,166,0.083
Charleston-Huntington,25303,6735,167,190,202,559,0.082999258
Huntsville-Decatur (Flor),35757,20857,601,532,598,1731,0.082993719
"Columbus, OH",43778,1470,50,34,38,122,0.082993197
Biloxi-Gulfport,39562,16845,516,443,439,1398,0.082991986
Jonesboro,72415,1217,44,29,28,101,0.082990961
Louisville,42642,13122,422,322,345,1089,0.082990398
Lexington,40935,2422,79,53,69,201,0.082989265
Charlotte,28078,74564,2325,1984,1879,6188,0.08298911
Utica,13491,3145,86,96,79,261,0.082988871
Mobile-Pensacola (Ft Walt),36502,17376,478,499,465,1442,0.082988029
Binghamton,13751,241,7,7,6,20,0.082987552
Champaign&Sprngfld-Decatur,60949,482,17,11,12,40,0.082987552
Chattanooga,35776,3350,98,82,98,278,0.082985075
Chattanooga,35966,3820,113,104,100,317,0.082984293
New York,8873,55806,1285,1460,1886,4631,0.082983909
Chicago,60061,27656,958,738,599,2295,0.082983801
Louisville,42748,9448,287,266,231,784,0.082980525
Cleveland-Akron (Canton),44011,25356,949,718,437,2104,0.082978388
Charleston-Huntington,25670,3989,118,121,92,331,0.08297819
Green Bay-Appleton,53014,8183,256,224,199,679,0.082976903
Charleston-Huntington,25511,928,30,27,20,77,0.082974138
Buffalo,14048,14812,430,426,373,1229,0.082973265
New York,10528,13161,397,350,345,1092,0.082972419
"Tri-Cities, TN-VA",41537,5062,159,130,131,420,0.082971158
Memphis,38720,458,13,14,11,38,0.082969432
Ft. Wayne,46943,229,9,5,5,19,0.082969432
Columbia-Jefferson City,65080,916,27,24,25,76,0.082969432
Denver,81136,229,6,7,6,19,0.082969432
Omaha,51546,2953,106,79,60,245,0.082966475
San Diego,92010,19044,546,528,506,1580,0.082965763
Minneapolis-St. Paul,55438,16995,438,477,495,1410,0.082965578
Wilmington,28472,16718,504,475,408,1387,0.082964469
Baton Rouge,70760,6316,187,159,178,524,0.082963901
Augusta-Aiken,29146,1350,37,37,38,112,0.082962963
Louisville,40012,675,21,18,17,56,0.082962963
Watertown,13668,3363,110,81,88,279,0.082961641
La Crosse-Eau Claire,54656,18551,642,480,417,1539,0.082960487
St. Louis,63303,47953,1186,1241,1551,3978,0.082956228
Charleston-Huntington,45741,880,31,22,20,73,0.082954545
Cedar Rapids-Wtrlo-IWC&Dub,52330,880,33,23,17,73,0.082954545
Richmond-Petersburg,22535,651,13,19,22,54,0.082949309
Charleston-Huntington,41539,1519,46,44,36,126,0.082949309
Shreveport,75651,2158,77,61,41,179,0.082947173
Charleston-Huntington,25515,1941,60,51,50,161,0.082946935
Dallas-Ft. Worth,76266,17650,533,456,475,1464,0.082946176
New York,7505,2580,75,71,68,214,0.082945736
New York,7001,17831,406,473,600,1479,0.082945432
Elmira (Corning),14820,639,21,17,15,53,0.082942097
Wilkes Barre-Scranton-Hztn,17801,15927,458,463,400,1321,0.082940918
Wheeling-Steubenville,45745,1061,28,33,27,88,0.082940622
Augusta-Aiken,30805,2966,85,87,74,246,0.082939987
"Washington, DC (Hagrstwn)",22844,4871,172,119,113,404,0.082939848
Tampa-St. Pete (Sarasota),33713,32373,607,899,1179,2685,0.082939487
Atlanta,30517,19653,629,512,489,1630,0.082938992
Los Angeles,91384,24500,736,698,598,2032,0.082938776
Louisville,42726,5462,178,146,129,453,0.082936653
Tampa-St. Pete (Sarasota),34205,34002,874,940,1006,2820,0.082936298
Charleston-Huntington,45694,11479,351,301,300,952,0.082934053
Albuquerque-Santa Fe,88023,2086,62,62,49,173,0.082933845
Chicago,60015,28324,956,864,529,2349,0.082933202
San Diego,92127,53079,2141,1396,865,4402,0.082932987
St. Louis,62035,15338,426,466,380,1272,0.082931282
Knoxville,37862,24322,685,642,690,2017,0.082929035
Boston (Manchester),2333,14000,386,399,376,1161,0.082928571
Dayton,45320,15435,492,412,376,1280,0.082928409
Cleveland-Akron (Canton),44224,38443,969,1026,1193,3188,0.082927971
Philadelphia,8201,11492,298,294,361,953,0.082927254
Johnstown-Altoona-St Colge,16616,205,6,6,5,17,0.082926829
Traverse City-Cadillac,48850,4715,127,144,120,391,0.082926829
Rochestr-Mason City-Austin,55922,820,25,19,24,68,0.082926829
Sioux Falls(Mitchell),57329,205,7,5,5,17,0.082926829
Billings,59075,205,5,6,6,17,0.082926829
Davenport-R.Island-Moline,61572,1025,35,27,23,85,0.082926829
Tyler-Longview(Lfkn&Ncgd),75784,410,14,11,9,34,0.082926829
Abilene-Sweetwater,76388,205,8,6,3,17,0.082926829
"Portland, OR",97380,2665,93,69,59,221,0.082926829
Louisville,40108,12976,401,361,314,1076,0.082922318
Pittsburgh,15227,30029,705,804,981,2490,0.082919844
Meridian,36915,603,13,19,18,50,0.08291874
Lima,45830,6030,208,149,143,500,0.08291874
Indianapolis,46030,2991,97,92,59,248,0.082915413
Savannah,29943,398,15,10,8,33,0.082914573
Boston (Manchester),1436,3329,97,84,95,276,0.08290778
Philadelphia,19152,36416,912,971,1136,3019,0.08290312
Cedar Rapids-Wtrlo-IWC&Dub,52327,3486,109,95,85,289,0.082903041
Quincy-Hannibal-Keokuk,62346,193,6,5,5,16,0.082901554
Paducah-Cape Girard-Harsbg,63862,1158,33,33,30,96,0.082901554
Kansas City,64689,579,17,17,14,48,0.082901554
New York,8816,47129,1419,1289,1199,3907,0.082900125
New York,11415,19216,382,507,704,1593,0.082899667
Providence-New Bedford,2893,31472,740,863,1006,2609,0.082899085
Marquette,49841,7274,202,205,196,603,0.082897993
Philadelphia,19518,16117,497,457,382,1336,0.082893839
Nashville,37098,5658,163,155,151,469,0.082891481
St. Louis,63343,4524,143,124,108,375,0.082891247
Cleveland-Akron (Canton),44203,39160,1089,1103,1054,3246,0.082890705
Milwaukee,53029,21836,716,618,476,1810,0.082890639
Tampa-St. Pete (Sarasota),33823,38063,1122,1015,1018,3155,0.082888895
"Washington, DC (Hagrstwn)",26750,748,25,20,17,62,0.082887701
Terre Haute,47834,18881,560,525,480,1565,0.082887559
Philadelphia,19953,4657,151,132,103,386,0.082885978
Jacksonville,31503,21934,628,601,589,1818,0.082885019
Chicago,60090,38391,887,1073,1222,3182,0.082884009
Charleston-Huntington,25108,555,21,14,11,46,0.082882883
Tulsa,74501,30779,954,795,802,2551,0.082881185
Shreveport,71456,917,29,24,23,76,0.082878953
Nashville,37023,1822,58,48,45,151,0.08287596
Honolulu,96766,17484,528,471,450,1449,0.082875772
Davenport-R.Island-Moline,61410,3451,95,92,99,286,0.082874529
Los Angeles,90027,44308,572,1090,2010,3672,0.082874424
Paducah-Cape Girard-Harsbg,62954,362,11,9,10,30,0.082872928
Denver,81251,181,6,4,5,15,0.082872928
New Orleans,39571,15844,500,451,362,1313,0.082870487
New York,11361,29142,663,805,947,2415,0.082870084
Dallas-Ft. Worth,76454,1436,43,39,37,119,0.082869081
Harrisburg-Lncstr-Leb-York,17356,22795,688,614,587,1889,0.08286905
Indianapolis,46163,14469,478,397,324,1199,0.082866819
Macon,30454,712,21,22,16,59,0.082865169
Charlotte,29741,1774,53,45,49,147,0.082863585
Little Rock-Pine Bluff,71744,3355,111,87,80,278,0.082861401
Erie,16428,12358,416,326,282,1024,0.082861304
Providence-New Bedford,2831,3874,114,96,111,321,0.082860093
St. Louis,63016,8098,252,209,210,671,0.082859965
Charleston-Huntington,45760,3162,79,91,92,262,0.08285895
Peoria-Bloomington,61740,1400,49,33,34,116,0.082857143
"Columbus, OH",43067,1919,68,51,40,159,0.082855654
Cincinnati,45169,4490,116,130,126,372,0.08285078
Little Rock-Pine Bluff,71956,1895,47,60,50,157,0.082849604
Detroit,48191,3609,99,110,90,299,0.082848434
New York,10549,16621,515,447,415,1377,0.082847001
Dallas-Ft. Worth,75009,37479,1419,937,749,3105,0.082846394
Birmingham (Ann and Tusc),35004,11612,344,310,308,962,0.082845332
Toledo,43469,2885,93,75,71,239,0.082842288
"Washington, DC (Hagrstwn)",20851,12373,299,339,387,1025,0.082841671
Cincinnati,47012,10249,299,284,266,849,0.08283735
Baton Rouge,39652,7847,236,209,205,650,0.082834204
Des Moines-Ames,50044,833,29,20,20,69,0.082833133
Oklahoma City,73858,1497,53,42,29,124,0.082832331
Chicago,60012,11795,383,329,265,977,0.082831708
Joplin-Pittsburg,67356,2644,77,68,74,219,0.082829047
Little Rock-Pine Bluff,71901,29084,911,803,695,2409,0.082829047
Minneapolis-St. Paul,55350,18895,528,523,514,1565,0.082826144
Baton Rouge,70757,2789,79,66,86,231,0.082825385
Grand Rapids-Kalmzoo-B.Crk,49322,1147,34,30,31,95,0.08282476
Paducah-Cape Girard-Harsbg,63932,1147,36,31,28,95,0.08282476
Topeka,66516,326,14,8,5,27,0.082822086
Shreveport,71859,326,9,8,10,27,0.082822086
Buffalo,14094,50712,1386,1391,1423,4200,0.082820634
Ft. Smith-Fay-Sprngdl-Rgrs,74959,6158,187,164,159,510,0.082819097
New York,11764,12123,356,345,303,1004,0.082817784
Charleston-Huntington,25506,4842,150,124,127,401,0.082817018
Charleston-Huntington,25114,483,16,13,11,40,0.082815735
Nashville,37334,24211,729,628,648,2005,0.082813597
Raleigh-Durham (Fayetvlle),27822,8320,241,233,215,689,0.0828125
Ft. Wayne,46992,15819,465,413,432,1310,0.082811809
Tallahassee-Thomasville,31643,9105,286,233,235,754,0.082811642
Charlotte,28351,4311,145,100,112,357,0.082811413
Youngstown,44460,24648,668,681,692,2041,0.082805907
Sioux City,51003,1727,71,37,35,143,0.082802548
La Crosse-Eau Claire,54669,8164,276,226,174,676,0.082802548
Champaign&Sprngfld-Decatur,61865,1256,35,37,32,104,0.082802548
"Columbia, SC",29072,68718,2381,1807,1502,5690,0.082802177
Terre Haute,62420,4070,108,95,134,337,0.082800983
Chattanooga,30741,30918,824,819,917,2560,0.082799664
Dallas-Ft. Worth,75078,57320,2386,1416,944,4746,0.082798325
Seattle-Tacoma,98056,36693,837,985,1216,3038,0.082795084
Elmira (Corning),14872,616,17,15,19,51,0.082792208
Columbus-Tupelo-West Point,38860,5387,153,152,141,446,0.082791906
Ft. Smith-Fay-Sprngdl-Rgrs,72753,11523,343,311,300,954,0.08279094
Grand Rapids-Kalmzoo-B.Crk,49319,17780,598,451,423,1472,0.082789651
Champaign&Sprngfld-Decatur,61752,4131,147,94,101,342,0.082788671
"Springfield, MO",65793,5967,196,166,132,494,0.082788671
Charleston-Huntington,25213,6112,191,150,165,506,0.082787958
Las Vegas,89166,33761,1044,786,965,2795,0.082787832
New York,12522,5037,156,132,129,417,0.082787373
Ft. Wayne,45891,15715,470,416,415,1301,0.082787146
Syracuse,13037,8661,267,235,215,717,0.082784898
Tulsa,74027,1063,31,31,26,88,0.082784572
Ft. Wayne,45813,3636,118,96,87,301,0.082783278
Des Moines-Ames,51401,12261,414,314,287,1015,0.082782807
Grand Rapids-Kalmzoo-B.Crk,49036,24559,716,717,600,2033,0.082780243
Milwaukee,53027,23581,724,649,579,1952,0.082778508
Kansas City,64083,27411,939,720,610,2269,0.082776987
Los Angeles,91356,29598,744,836,870,2450,0.082775863
Montgomery-Selma,36736,1341,42,38,31,111,0.082774049
Greensboro-H.Point-W.Salem,27316,6838,191,179,196,566,0.082772741
Austin,78757,23909,452,621,906,1979,0.082772178
Lexington,40734,3697,120,101,85,306,0.082769813
New York,10537,2513,66,67,75,208,0.082769598
Mobile-Pensacola (Ft Walt),32565,6645,217,167,166,550,0.082768999
Sioux City,57049,7817,248,203,196,647,0.082768325
Albany-Schenectady-Troy,12095,11792,341,316,319,976,0.082767978
Charleston-Huntington,41183,1474,40,40,42,122,0.082767978
Topeka,66418,737,27,18,16,61,0.082767978
"Columbus, OH",45850,3975,119,115,95,329,0.082767296
Ft. Wayne,46773,3528,106,97,89,292,0.08276644
Birmingham (Ann and Tusc),35621,2936,93,75,75,243,0.082765668
Flint-Saginaw-Bay City,48754,1027,35,28,22,85,0.082765336
Philadelphia,19460,46360,1258,1290,1289,3837,0.082765315
Los Angeles,91020,8349,237,244,210,691,0.082764403
Erie,16511,11418,356,297,292,945,0.082764057
Dallas-Ft. Worth,75491,5848,195,157,132,484,0.082763338
Los Angeles,90712,31935,779,877,987,2643,0.08276186
St. Louis,63115,16010,466,421,438,1325,0.082760775
Peoria-Bloomington,61743,145,5,3,4,12,0.082758621
Little Rock-Pine Bluff,72522,290,8,8,8,24,0.082758621
Cincinnati,45224,20107,527,594,543,1664,0.082757249
Charleston-Huntington,25526,23140,722,636,557,1915,0.082757131
Memphis,38017,55947,1796,1568,1266,4630,0.082756895
Palm Springs,92203,33980,1047,908,857,2812,0.082754562
"Rochester, NY",13146,2296,65,69,56,190,0.082752613
Los Angeles,91377,13293,449,376,275,1100,0.08275032
New York,11779,38515,1024,1045,1118,3187,0.082746982
Indianapolis,46140,44038,1301,1179,1164,3644,0.082746719
Nashville,42274,2272,76,54,58,188,0.082746479
Omaha,51441,278,5,8,10,23,0.082733813
Minneapolis-St. Paul,55049,2635,110,67,41,218,0.082732448
New York,11741,26423,691,727,768,2186,0.082730954
Philadelphia,8323,689,16,20,21,57,0.082728592
Abilene-Sweetwater,79547,689,25,17,15,57,0.082728592
"Washington, DC (Hagrstwn)",22849,4811,131,133,134,398,0.082727084
Greenwood-Greenville,38940,2055,60,51,59,170,0.082725061
Orlando-Daytona Bch-Melbrn,32779,30366,946,813,753,2512,0.082724099
Pittsburgh,15146,28033,593,793,933,2319,0.082723933
Charlotte,29058,3965,121,101,106,328,0.082723834
Hartford & New Haven,6248,5331,182,146,113,441,0.082723692
Denver,80136,6274,198,182,139,519,0.082722346
Sioux Falls(Mitchell),57348,544,21,12,12,45,0.082720588
New York,11702,14398,410,386,395,1191,0.082719822
Philadelphia,8037,24166,678,693,628,1999,0.082719523
Nashville,38570,9490,259,259,267,785,0.082718651
New York,12515,1354,36,35,41,112,0.082717873
Philadelphia,19070,7036,212,183,187,582,0.082717453
"Columbus, OH",43314,2841,88,71,76,235,0.082717353
New York,8828,2430,54,66,81,201,0.082716049
Louisville,40207,28967,616,704,1076,2396,0.082714813
Augusta-Aiken,29856,3095,98,85,73,256,0.082714055
Fresno-Visalia,93730,16007,582,433,309,1324,0.082713813
South Bend-Elkhart,49101,3228,100,89,78,267,0.082713755
Knoxville,37769,5743,178,148,149,475,0.082709385
Terre Haute,47522,266,10,6,6,22,0.082706767
New York,11783,20603,566,589,549,1704,0.082706402
West Palm Beach-Ft. Pierce,33449,10217,357,290,198,845,0.082705295
Montgomery-Selma,36064,14292,520,362,300,1182,0.08270361
Detroit,48375,23554,701,648,599,1948,0.082703575
Cincinnati,45612,4752,154,117,122,393,0.08270202
Rochestr-Mason City-Austin,52132,1838,50,56,46,152,0.082698585
Elmira (Corning),14879,2092,65,58,50,173,0.082695985
Charlotte,28650,12915,400,344,324,1068,0.082694541
Lincoln & Hastings-Krny,69150,520,16,17,10,43,0.082692308
Wichita-Hutchinson Plus,67861,1947,57,45,59,161,0.08269132
New York,10504,8296,274,240,172,686,0.082690453
Waco-Temple-Bryan,76554,2322,86,59,47,192,0.082687339
Bluefield-Beckley-Oak Hill,24901,8877,216,274,244,734,0.082685592
St. Louis,62230,6289,186,173,161,520,0.082684052
Denver,81647,7438,229,210,176,615,0.082683517
Sherman-Ada,73430,1282,43,34,29,106,0.082683307
"Albany, GA",31781,1403,40,36,40,116,0.082679971
Bowling Green,42154,762,20,22,21,63,0.082677165
Evansville,47647,254,7,8,6,21,0.082677165
Charlotte,28103,10523,318,307,245,870,0.082676043
Charleston-Huntington,25541,9241,262,237,265,764,0.082675035
Savannah,30467,11999,378,323,291,992,0.082673556
Tampa-St. Pete (Sarasota),33525,20309,597,606,476,1679,0.082672707
Chicago,60559,23805,557,641,770,1968,0.082671708
Knoxville,37777,12810,290,339,430,1059,0.082669789
Birmingham (Ann and Tusc),35504,14250,434,372,372,1178,0.082666667
"Jackson, MS",39041,3242,97,84,87,268,0.082665022
Charlotte,29702,9847,288,263,263,814,0.082664771
Tulsa,67301,11819,414,304,259,977,0.082663508
Meridian,39328,4101,129,110,100,339,0.082662765
Wilmington,28436,1863,50,49,55,154,0.082662373
Philadelphia,8090,8287,256,219,210,685,0.082659587
Bangor,4419,2819,81,68,84,233,0.082653423
Cleveland-Akron (Canton),44708,25771,679,692,759,2130,0.082651042
Las Vegas,89145,28240,743,751,840,2334,0.082648725
Marquette,49905,2553,82,80,49,211,0.082647865
"Columbus, OH",43137,3642,111,92,98,301,0.082646897
Rapid City,57748,121,4,3,3,10,0.082644628
Ft. Smith-Fay-Sprngdl-Rgrs,72739,484,16,12,12,40,0.082644628
Salt Lake City,83238,121,4,3,3,10,0.082644628
Raleigh-Durham (Fayetvlle),27596,22615,722,602,545,1869,0.082644263
Oklahoma City,73049,7127,246,198,145,589,0.082643469
Seattle-Tacoma,98005,21478,494,451,830,1775,0.082642704
Dayton,45346,2166,65,68,46,179,0.082640813
Little Rock-Pine Bluff,72006,2166,66,65,48,179,0.082640813
Flint-Saginaw-Bay City,48847,5760,182,135,159,476,0.082638889
Omaha,68462,5276,209,139,88,436,0.082638362
Wilkes Barre-Scranton-Hztn,18370,1077,29,25,35,89,0.082636955
Greensboro-H.Point-W.Salem,28685,1791,54,47,47,148,0.082635399
Augusta-Aiken,30816,2142,67,61,49,177,0.082633053
Duluth-Superior,55798,714,24,18,17,59,0.082633053
Paducah-Cape Girard-Harsbg,42027,2021,65,56,46,167,0.08263236
Greenvll-Spart-Ashevll-And,29388,17052,526,437,446,1409,0.082629604
Louisville,40143,6039,197,151,151,499,0.082629574
New York,11980,5797,144,156,179,479,0.082628946
"Washington, DC (Hagrstwn)",20012,16677,398,473,507,1378,0.08262877
San Angelo,76943,2953,73,89,82,244,0.082627836
Charlotte,28278,38826,1123,965,1120,3208,0.082625045
Buffalo,14735,2820,99,76,58,233,0.082624113
Baltimore,21917,2820,88,74,71,233,0.082624113
Green Bay-Appleton,54130,28769,864,774,739,2377,0.082623657
Watertown,13605,4224,132,115,102,349,0.082623106
Honolulu,96771,7274,233,183,185,601,0.082623041
Cleveland-Akron (Canton),44612,5737,181,140,153,474,0.082621579
Terre Haute,47528,702,17,21,20,58,0.082621083
Bismarck-Mnt-Dcknsn(Wlstn),58735,351,10,9,10,29,0.082621083
Dallas-Ft. Worth,75424,4442,144,130,93,367,0.082620441
New York,11030,18555,618,534,381,1533,0.08261924
Sherman-Ada,73463,3377,90,92,97,279,0.082617708
Tyler-Longview(Lfkn&Ncgd),75755,5798,177,149,153,479,0.082614695
Missoula,59803,17600,503,443,508,1454,0.082613636
Peoria-Bloomington,61483,1961,54,57,51,162,0.082610913
"Lafayette, LA",70589,3922,121,113,90,324,0.082610913
Milwaukee,53549,10362,304,290,262,856,0.082609535
Bismarck-Mnt-Dcknsn(Wlstn),59270,8631,254,211,248,713,0.082609199
Dallas-Ft. Worth,75453,3910,138,113,72,323,0.082608696
Burlington-Plattsburgh,5765,1719,39,48,55,142,0.082606166
Minneapolis-St. Paul,56455,1719,58,47,37,142,0.082606166
Charleston-Huntington,41175,5266,161,144,130,435,0.082605393
Albany-Schenectady-Troy,5340,1029,35,28,22,85,0.08260447
Louisville,47231,1029,37,26,22,85,0.08260447
Cedar Rapids-Wtrlo-IWC&Dub,52353,9370,301,232,241,774,0.082604055
Denver,80542,6259,229,166,122,517,0.082601054
Greenvll-Spart-Ashevll-And,29642,37603,1158,1003,945,3106,0.082599793
Philadelphia,19390,14879,481,418,330,1229,0.082599637
Charleston-Huntington,45658,2724,78,84,63,225,0.082599119
Ft. Smith-Fay-Sprngdl-Rgrs,72949,9419,286,274,218,778,0.082599002
Wichita Falls & Lawton,73006,3063,89,91,73,253,0.082598759
Philadelphia,8080,40135,1165,1058,1092,3315,0.082596238
Quincy-Hannibal-Keokuk,62313,339,12,9,7,28,0.08259587
Atlanta,30257,5412,165,142,140,447,0.082594235
Louisville,40142,2252,70,58,58,186,0.08259325
Chicago,46307,72358,2197,1992,1787,5976,0.082589347
Baltimore,21623,2228,72,51,61,184,0.082585278
Mobile-Pensacola (Ft Walt),36445,4456,127,141,100,368,0.082585278
Salisbury,19933,9566,310,266,214,790,0.082584152
"Columbus, OH",43085,26677,776,726,701,2203,0.0825805
Chicago,60051,25345,706,652,735,2093,0.082580391
Spokane,83814,29329,695,831,896,2422,0.082580381
Detroit,48033,17317,360,440,630,1430,0.082577814
Raleigh-Durham (Fayetvlle),27882,7581,226,216,184,626,0.082574858
Huntsville-Decatur (Flor),35610,1865,49,51,54,154,0.082573727
Ottumwa-Kirksville,63556,3391,112,89,79,280,0.082571513
Richmond-Petersburg,23805,19329,447,498,651,1596,0.082570231
Richmond-Petersburg,23009,7969,259,194,205,658,0.082569959
Nashville,38457,872,26,26,20,72,0.082568807
Little Rock-Pine Bluff,71720,2071,72,59,40,171,0.082568807
Dallas-Ft. Worth,75470,218,7,6,5,18,0.082568807
Rapid City,57718,7497,268,188,163,619,0.08256636
Toledo,43570,3040,92,72,87,251,0.082565789
Joplin-Pittsburg,66725,4869,138,140,124,402,0.082563155
Buffalo,14569,6165,169,175,165,509,0.082562855
Evansville,42327,3985,131,105,93,329,0.082559598
Sherman-Ada,74538,3210,93,95,77,265,0.082554517
San Francisco-Oak-San Jose,94949,16959,487,493,420,1400,0.082552037
Terre Haute,47882,8843,253,243,234,730,0.08255117
Macon,31008,21090,620,550,571,1741,0.082550972
Phoenix (Prescott),85192,1381,40,40,34,114,0.082548878
Green Bay-Appleton,54956,47536,1406,1275,1243,3924,0.082547964
Birmingham (Ann and Tusc),35042,5706,162,151,158,471,0.08254469
New York,11709,6651,184,210,155,549,0.082543978
Bluefield-Beckley-Oak Hill,24818,1478,39,45,38,122,0.082543978
Philadelphia,19807,8941,265,264,209,738,0.082541103
Davenport-R.Island-Moline,52722,41095,1391,1113,888,3392,0.082540455
Shreveport,71052,9244,280,223,260,763,0.082540026
Jacksonville,32233,25116,573,667,833,2073,0.082537028
St. Louis,63390,13182,418,337,333,1088,0.082536793
Indianapolis,46166,2399,74,60,64,198,0.082534389
Birmingham (Ann and Tusc),35094,14988,440,393,404,1237,0.082532693
Shreveport,71449,9051,280,235,232,747,0.082532317
Biloxi-Gulfport,39574,14407,477,370,342,1189,0.082529326
Paducah-Cape Girard-Harsbg,62946,11608,345,302,311,958,0.08252929
Indianapolis,46074,54115,1950,1387,1129,4466,0.08252795
Wichita-Hutchinson Plus,67133,6931,239,191,142,572,0.082527774
Myrtle Beach-Florence,28352,24380,722,692,598,2012,0.082526661
Kansas City,66205,14202,295,317,560,1172,0.082523588
Honolulu,96816,51137,1244,1397,1579,4220,0.082523417
Toledo,43516,2981,90,73,83,246,0.082522643
Wilkes Barre-Scranton-Hztn,18848,8519,252,232,219,703,0.082521423
New York,7040,25377,853,671,570,2094,0.082515664
"Columbus, GA (Opelika, AL)",36863,11816,320,314,341,975,0.082515234
"Washington, DC (Hagrstwn)",21722,5805,186,154,139,479,0.082515073
Charleston-Huntington,25164,1018,34,29,21,84,0.082514735
"Washington, DC (Hagrstwn)",26818,1018,32,26,26,84,0.082514735
Pittsburgh,15101,24905,742,757,556,2055,0.082513551
Kansas City,64114,24481,413,626,981,2020,0.082512969
Cheyenne-Scottsbluff,82054,1115,34,29,29,92,0.082511211
Baton Rouge,70538,12459,355,333,340,1028,0.082510635
Flint-Saginaw-Bay City,48883,6884,220,185,163,568,0.082510169
Savannah,31323,1515,53,35,37,125,0.082508251
Wichita-Hutchinson Plus,67025,3939,145,104,76,325,0.082508251
Oklahoma City,74032,2218,80,56,47,183,0.082506763
Chicago,60555,15914,448,415,450,1313,0.08250597
St. Louis,63304,44058,1314,1203,1118,3635,0.08250488
Madison,53959,14654,445,378,386,1209,0.082503071
Greenville-N.Bern-Washngtn,27889,25152,738,695,642,2075,0.08249841
Buffalo,14739,2994,93,86,68,247,0.08249833
Wichita-Hutchinson Plus,67554,4182,122,113,110,345,0.082496413
Eugene,97417,2085,76,51,45,172,0.082494005
Cleveland-Akron (Canton),44266,33348,891,887,973,2751,0.082493703
Little Rock-Pine Bluff,72206,23905,699,657,616,1972,0.082493202
Philadelphia,19311,9419,349,244,184,777,0.082492834
Erie,16350,2776,89,70,70,229,0.082492795
Charleston-Huntington,25678,3261,102,95,72,269,0.082490034
Shreveport,71078,7407,248,204,159,611,0.082489537
Indianapolis,47975,691,21,20,16,57,0.082489146
"Lafayette, LA",71358,788,26,23,16,65,0.08248731
Chicago,60070,14851,403,434,388,1225,0.082486028
La Crosse-Eau Claire,55959,2655,83,68,68,219,0.082485876
San Francisco-Oak-San Jose,94546,45693,1253,1263,1253,3769,0.082485282
Louisville,40037,2849,86,71,78,235,0.082485082
Dallas-Ft. Worth,75839,5492,176,159,118,453,0.082483613
Rochestr-Mason City-Austin,55946,3334,96,97,82,275,0.082483503
Toledo,43543,7250,251,182,165,598,0.082482759
Champaign&Sprngfld-Decatur,62573,1370,40,36,37,113,0.082481752
Oklahoma City,73016,2049,80,53,36,169,0.082479258
Paducah-Cape Girard-Harsbg,42408,6123,179,161,165,505,0.082475911
Quincy-Hannibal-Keokuk,62356,485,18,9,13,40,0.082474227
Lincoln & Hastings-Krny,68954,97,3,2,3,8,0.082474227
Boise,83302,97,3,3,2,8,0.082474227
Idaho Fals-Pocatllo(Jcksn),83446,97,3,2,3,8,0.082474227
Myrtle Beach-Florence,29541,9785,301,265,241,807,0.082473173
Colorado Springs-Pueblo,80132,26057,968,748,433,2149,0.08247304
Mobile-Pensacola (Ft Walt),32526,47665,1369,1230,1332,3931,0.082471415
Kansas City,64054,3844,91,109,117,317,0.082466181
Atlanta,30108,8258,235,216,230,681,0.082465488
Jacksonville,32656,15595,505,419,362,1286,0.082462328
San Francisco-Oak-San Jose,94591,55371,1385,1512,1669,4566,0.082461939
Cincinnati,41091,25988,950,719,474,2143,0.082461136
Paducah-Cape Girard-Harsbg,38257,3917,114,103,106,323,0.082461067
Mobile-Pensacola (Ft Walt),36617,11266,326,291,312,929,0.082460501
St. Louis,63349,2195,72,60,49,181,0.082460137
New York,8533,8004,223,221,216,660,0.082458771
Baltimore,21668,1904,64,50,43,157,0.082457983
Little Rock-Pine Bluff,72045,1237,39,32,31,102,0.082457559
Louisville,40070,570,19,16,12,47,0.08245614
San Antonio,77984,4463,148,134,86,368,0.082455747
San Diego,92120,29969,661,913,897,2471,0.082451867
San Francisco-Oak-San Jose,95014,60751,2028,1752,1229,5009,0.082451318
Syracuse,13104,15961,532,437,347,1316,0.082450974
Chicago,60136,8405,284,232,177,693,0.082450922
"Lafayette, LA",70648,6986,219,188,169,576,0.082450616
Louisville,40045,3020,92,78,79,249,0.082450331
Norfolk-Portsmth-Newpt Nws,23062,2729,69,72,84,225,0.082447783
"Columbus, OH",43162,7338,214,204,187,605,0.082447533
Salt Lake City,83122,376,15,9,7,31,0.082446809
Houston,77479,95071,3611,2443,1784,7838,0.082443647
Peoria-Bloomington,61537,2899,92,77,70,239,0.082442221
Charleston-Huntington,25168,3081,99,85,70,254,0.082440766
Hattiesburg-Laurel,39338,2705,87,72,64,223,0.082439926
Atlanta,30630,2329,67,62,63,192,0.082438815
Roanoke-Lynchburg,24312,2232,67,62,55,184,0.082437276
"Washington, DC (Hagrstwn)",20613,18402,539,460,518,1517,0.082436692
Greensboro-H.Point-W.Salem,28659,20440,571,563,551,1685,0.082436399
Savannah,29936,16983,464,510,426,1400,0.082435377
La Crosse-Eau Claire,54636,17165,608,435,372,1415,0.082435188
Waco-Temple-Bryan,76657,11876,393,324,262,979,0.082435163
Boston (Manchester),1545,39049,1177,1045,997,3219,0.082434889
Louisville,40223,23837,642,613,710,1965,0.08243487
Mobile-Pensacola (Ft Walt),36475,1844,46,55,51,152,0.082429501
New York,7630,6903,203,188,178,569,0.08242793
Denver,80650,2014,74,47,45,166,0.082423039
Cincinnati,45133,24132,723,671,595,1989,0.082421681
Greenvll-Spart-Ashevll-And,29360,21257,617,531,604,1752,0.082419909
San Francisco-Oak-San Jose,95422,17399,540,434,460,1434,0.08241853
Denver,80134,87846,2937,2200,2103,7240,0.082416957
Detroit,48438,7341,223,208,174,605,0.08241384
Lexington,42503,24705,766,655,615,2036,0.082412467
Philadelphia,8070,12486,326,328,375,1029,0.082412302
Augusta-Aiken,29817,3980,120,121,87,328,0.08241206
"Washington, DC (Hagrstwn)",22181,14525,474,382,341,1197,0.082409639
Mobile-Pensacola (Ft Walt),36610,10011,290,235,300,825,0.08240935
Phoenix (Prescott),85333,449,12,10,15,37,0.082405345
Savannah,29910,51321,1554,1452,1223,4229,0.082402915
Lexington,41031,16723,516,424,438,1378,0.082401483
Los Angeles,91604,30097,554,726,1200,2480,0.082400239
Memphis,38865,4733,140,129,121,390,0.082400169
Cincinnati,45327,9260,300,239,224,763,0.082397408
Buffalo,14714,267,8,7,7,22,0.082397004
Cleveland-Akron (Canton),44255,8241,236,219,224,679,0.082392913
Wichita Falls & Lawton,76372,886,33,23,17,73,0.082392777
"Washington, DC (Hagrstwn)",22152,29578,935,819,683,2437,0.082392319
Peoria-Bloomington,60460,1505,41,43,40,124,0.082392027
Burlington-Plattsburgh,3743,13922,379,388,380,1147,0.082387588
Hartford & New Haven,6032,19639,562,523,533,1618,0.082387087
Hartford & New Haven,6282,1408,50,38,28,116,0.082386364
Joplin-Pittsburg,64847,352,10,10,9,29,0.082386364
Sioux City,68055,352,14,8,7,29,0.082386364
Fresno-Visalia,93721,7744,155,223,260,638,0.082386364
Charleston-Huntington,45680,11847,328,323,325,976,0.082383726
Los Angeles,90713,27361,703,773,778,2254,0.08238003
Burlington-Plattsburgh,5652,874,29,19,24,72,0.082379863
Richmond-Petersburg,23083,2185,71,60,49,180,0.082379863
Bluefield-Beckley-Oak Hill,25928,437,13,12,11,36,0.082379863
Davenport-R.Island-Moline,61368,1311,46,36,26,108,0.082379863
"Springfield, MO",65767,1918,63,52,43,158,0.082377477
Macon,31094,1044,32,27,27,86,0.082375479
Champaign&Sprngfld-Decatur,62463,1129,35,30,28,93,0.082373782
Bluefield-Beckley-Oak Hill,25865,1214,35,34,31,100,0.082372323
Cleveland-Akron (Canton),44047,9008,281,246,215,742,0.082371226
Denver,80104,41326,1380,1060,964,3404,0.082369453
Detroit,48836,14265,466,353,356,1175,0.082369436
Lexington,40311,7515,258,189,172,619,0.082368596
"Rochester, NY",14590,4747,144,131,116,391,0.082367811
Chattanooga,35958,3278,89,88,93,270,0.082367297
Hartford & New Haven,6779,8535,214,247,242,703,0.082366725
New York,7652,26637,752,755,687,2194,0.082366633
Wichita-Hutchinson Plus,67831,947,35,21,22,78,0.082365364
Binghamton,13734,2064,53,61,56,170,0.082364341
Indianapolis,47987,3861,116,93,109,318,0.082362082
Rockford,61060,1287,38,33,35,106,0.082362082
Marquette,49849,12263,360,325,325,1010,0.082361575
Grand Rapids-Kalmzoo-B.Crk,49010,18395,566,467,482,1515,0.082359337
Milwaukee,53044,2477,94,70,40,204,0.082357691
New Orleans,70462,5707,189,154,127,470,0.082355003
Fargo,56754,510,18,13,11,42,0.082352941
Davenport-R.Island-Moline,61447,765,24,15,24,63,0.082352941
Biloxi-Gulfport,39563,11876,327,330,321,978,0.08235096
Los Angeles,91344,50929,1349,1421,1424,4194,0.082349938
Orlando-Daytona Bch-Melbrn,32935,41943,968,1191,1295,3454,0.082349856
Cleveland-Akron (Canton),44615,10504,331,291,243,865,0.082349581
Wheeling-Steubenville,26003,39527,1114,1098,1043,3255,0.082348774
Lexington,40461,2538,89,62,58,209,0.082348306
Shreveport,71082,4056,119,118,97,334,0.08234714
San Diego,92075,12387,342,328,350,1020,0.082344393
Birmingham (Ann and Tusc),35023,25418,744,680,669,2093,0.082343221
Wheeling-Steubenville,26320,1178,37,31,29,97,0.082342954
"Alexandria, LA",71424,1591,52,41,38,131,0.082338152
Lexington,41701,16408,482,456,413,1351,0.082337884
Harrisonburg,24441,6607,203,162,179,544,0.082336915
Cincinnati,45160,668,22,17,16,55,0.082335329
Evansville,42352,1919,49,57,52,158,0.082334549
Champaign&Sprngfld-Decatur,62567,1081,37,29,23,89,0.082331175
"Lafayette, IN",47992,1579,59,45,26,130,0.082330589
Columbus-Tupelo-West Point,39339,14126,437,350,376,1163,0.082330454
Philadelphia,19348,23515,736,662,538,1936,0.082330427
"Charleston, SC",29432,2575,79,71,62,212,0.082330097
"Tri-Cities, TN-VA",40827,498,17,13,11,41,0.082329317
Oklahoma City,73859,1494,52,37,34,123,0.082329317
Charleston-Huntington,25314,14248,427,401,345,1173,0.082327344
Idaho Fals-Pocatllo(Jcksn),83276,4555,151,116,108,375,0.082327113
Huntsville-Decatur (Flor),35971,4373,123,118,119,360,0.082323348
Tulsa,74338,5114,149,137,135,421,0.082323035
Los Angeles,91307,24161,695,701,593,1989,0.082322752
Rockford,61081,20444,594,561,528,1683,0.082322442
Mobile-Pensacola (Ft Walt),36751,741,20,22,19,61,0.082321188
Joplin-Pittsburg,64790,741,25,20,16,61,0.082321188
Las Vegas,89178,47534,1392,1111,1410,3913,0.082320024
Eugene,97321,31159,877,901,787,2565,0.082319715
Fresno-Visalia,93711,37477,855,1033,1197,3085,0.082317155
Cleveland-Akron (Canton),44625,1312,44,33,31,108,0.082317073
Columbus-Tupelo-West Point,38873,2782,85,68,76,229,0.082314881
Lincoln & Hastings-Krny,68933,899,26,21,27,74,0.082313682
New York,6830,24298,695,678,627,2000,0.082311301
St. Louis,63080,13680,401,376,349,1126,0.082309942
Des Moines-Ames,50207,2442,92,58,51,201,0.082309582
Los Angeles,91354,35756,1154,1012,777,2943,0.082307864
Ft. Wayne,46714,15819,471,384,447,1302,0.082306088
New York,11507,7375,228,194,185,607,0.082305085
Chattanooga,37331,8104,230,232,205,667,0.082305035
Augusta-Aiken,30833,3888,108,115,97,320,0.082304527
Lexington,41773,1215,38,31,31,100,0.082304527
Des Moines-Ames,50116,243,8,6,6,20,0.082304527
Dayton,43357,4520,160,119,93,372,0.082300885
Harrisburg-Lncstr-Leb-York,17061,6938,198,186,187,571,0.082300375
Boston (Manchester),1757,31373,863,814,905,2582,0.082300067
Hartford & New Haven,6384,2661,86,64,69,219,0.082299887
Boston (Manchester),2421,18615,732,519,281,1532,0.082299221
Paducah-Cape Girard-Harsbg,62898,1932,64,55,40,159,0.082298137
Seattle-Tacoma,98106,26623,556,687,948,2191,0.082297262
"Columbus, OH",43056,17522,520,466,456,1442,0.082296541
Philadelphia,8053,47718,1306,1269,1352,3927,0.082295989
Abilene-Sweetwater,79525,3050,94,89,68,251,0.082295082
Binghamton,13136,401,13,12,8,33,0.082294264
Birmingham (Ann and Tusc),36271,5772,183,161,131,475,0.082293832
Orlando-Daytona Bch-Melbrn,32909,42312,1318,1107,1057,3482,0.082293439
Atlanta,30650,14497,449,379,365,1193,0.082292888
Minneapolis-St. Paul,56279,1361,51,34,27,112,0.082292432
Cedar Rapids-Wtrlo-IWC&Dub,52053,1118,42,28,22,92,0.082289803
Sioux Falls(Mitchell),57266,559,17,14,15,46,0.082289803
Cleveland-Akron (Canton),44281,34330,1014,942,869,2825,0.082289543
Kansas City,64683,7972,233,224,199,656,0.082288008
New York,8501,6453,206,190,135,531,0.082287308
Honolulu,96817,53656,1282,1523,1610,4415,0.082283435
Pittsburgh,15003,11327,295,317,320,932,0.082281275
Charlotte,28129,6247,199,158,157,514,0.082279494
Lexington,40759,2370,80,62,53,195,0.082278481
Cleveland-Akron (Canton),44677,2686,84,72,65,221,0.082278481
Bismarck-Mnt-Dcknsn(Wlstn),58769,316,11,8,7,26,0.082278481
Champaign&Sprngfld-Decatur,60912,474,15,13,11,39,0.082278481
Champaign&Sprngfld-Decatur,61831,158,5,4,4,13,0.082278481
Kansas City,65333,790,26,19,20,65,0.082278481
Salt Lake City,83243,158,6,4,3,13,0.082278481
Indianapolis,46929,3306,102,86,84,272,0.082274652
Milwaukee,53168,8885,267,239,225,731,0.082273495
Charlotte,28622,2358,74,73,47,194,0.082273113
Idaho Fals-Pocatllo(Jcksn),83250,1957,68,52,41,161,0.082268779
Raleigh-Durham (Fayetvlle),27870,24809,711,705,625,2041,0.082268532
Quincy-Hannibal-Keokuk,63461,5944,194,154,141,489,0.082267833
Houston,77510,15085,481,399,361,1241,0.082267153
Green Bay-Appleton,49847,1094,33,20,37,90,0.08226691
Nashville,37047,2577,68,67,77,212,0.082266201
"Columbia, SC",29180,12168,337,335,329,1001,0.082264957
Charleston-Huntington,25504,12934,359,351,354,1064,0.082263801
Dallas-Ft. Worth,75486,2881,91,74,72,237,0.082263103
Portland-Auburn,3908,7695,240,208,185,633,0.082261209
Spokane,99029,1787,60,50,37,147,0.082260772
Ft. Wayne,46777,6285,183,170,164,517,0.082259348
Dallas-Ft. Worth,76234,19925,635,521,483,1639,0.082258469
Albany-Schenectady-Troy,1256,620,11,14,26,51,0.082258065
Champaign&Sprngfld-Decatur,61846,4340,119,110,128,357,0.082258065
Knoxville,37801,31487,897,854,839,2590,0.082256169
Cedar Rapids-Wtrlo-IWC&Dub,52206,2553,97,69,44,210,0.082256169
Binghamton,13838,4085,112,106,118,336,0.082252142
Monroe-El Dorado,71375,924,21,37,18,76,0.082251082
San Antonio,78101,9933,311,274,232,817,0.082251082
"Columbus, OH",43130,63393,1784,1740,1690,5214,0.082248829
Indianapolis,47933,27806,838,735,714,2287,0.082248436
Indianapolis,47944,3599,109,90,97,296,0.082245068
New York,10312,61013,1643,1711,1664,5018,0.082244768
San Francisco-Oak-San Jose,94403,46959,1029,1238,1595,3862,0.082241956
Greenvll-Spart-Ashevll-And,29379,18216,538,494,466,1498,0.082235397
Madison,53546,31483,883,840,866,2589,0.082234857
Pittsburgh,16156,3186,101,77,84,262,0.082234777
Champaign&Sprngfld-Decatur,62621,985,33,24,24,81,0.082233503
Toledo,43557,3174,92,88,81,261,0.082230624
"Washington, DC (Hagrstwn)",20735,38271,1086,1016,1045,3147,0.082229364
Toledo,43466,2189,73,50,57,180,0.082229328
St. Louis,63353,4585,144,114,119,377,0.082224646
Pittsburgh,16229,5400,152,151,141,444,0.082222222
New York,10543,21442,645,583,535,1763,0.082221808
"Tri-Cities, TN-VA",37620,38506,1066,1040,1060,3166,0.082220953
San Francisco-Oak-San Jose,94086,49757,832,1175,2084,4091,0.082219587
Milwaukee,53002,2688,87,74,60,221,0.082217262
Knoxville,37820,8502,269,226,204,699,0.082215949
Binghamton,14817,2311,59,57,74,190,0.082215491
Dallas-Ft. Worth,76258,8125,237,232,199,668,0.082215385
Indianapolis,46013,17807,446,483,535,1464,0.082214859
Fargo,56514,4172,140,115,88,343,0.082214765
Birmingham (Ann and Tusc),35147,5802,185,149,143,477,0.08221303
Ft. Wayne,46798,1338,39,37,34,110,0.082212257
Paducah-Cape Girard-Harsbg,63936,669,23,19,13,55,0.082212257
Eugene,97446,5048,153,136,126,415,0.082210777
Norfolk-Portsmth-Newpt Nws,27979,1484,48,36,38,122,0.082210243
"Columbus, OH",43164,2226,79,54,50,183,0.082210243
Honolulu,96779,2956,78,80,85,243,0.082205683
Huntsville-Decatur (Flor),35673,8053,250,195,217,662,0.082205389
Portland-Auburn,4924,2287,66,64,58,188,0.08220376
Charleston-Huntington,25081,1180,36,32,29,97,0.08220339
Charlotte,28610,10170,276,268,292,836,0.082202557
Orlando-Daytona Bch-Melbrn,32806,26277,564,723,873,2160,0.082201165
Louisville,47145,1910,62,45,50,157,0.082198953
Buffalo,16731,2421,66,69,64,199,0.082197439
Providence-New Bedford,2842,17142,452,498,459,1409,0.082195776
Burlington-Plattsburgh,5351,365,9,12,9,30,0.082191781
Albany-Schenectady-Troy,13452,4380,149,120,91,360,0.082191781
Buffalo,14721,73,2,2,2,6,0.082191781
Charleston-Huntington,41643,73,3,2,1,6,0.082191781
Cedar Rapids-Wtrlo-IWC&Dub,50625,949,29,23,26,78,0.082191781
Rapid City,57780,146,4,3,5,12,0.082191781
"Springfield, MO",65666,73,3,2,1,6,0.082191781
Oklahoma City,74864,5317,174,150,113,437,0.082189204
"Tri-Cities, TN-VA",24354,13980,378,376,395,1149,0.082188841
South Bend-Elkhart,46554,4368,142,98,119,359,0.082188645
Denver,80459,2543,77,72,60,209,0.082186394
Pittsburgh,26582,4563,128,133,114,375,0.082182774
Honolulu,96749,22450,686,607,552,1845,0.082182628
New York,10964,1448,39,43,37,119,0.08218232
Greenville-N.Bern-Washngtn,27828,8603,258,203,246,707,0.082180635
Missoula,59901,64165,1850,1709,1714,5273,0.082178758
Chattanooga,30752,9516,274,265,243,782,0.082177385
Boston (Manchester),3063,15905,346,432,529,1307,0.082175417
Cleveland-Akron (Canton),44638,1655,51,47,38,136,0.082175227
Champaign&Sprngfld-Decatur,61944,11439,325,313,302,940,0.082175015
Traverse City-Cadillac,49454,4746,144,116,130,390,0.082174463
Detroit,48157,1363,40,35,37,112,0.08217168
Mobile-Pensacola (Ft Walt),32566,47401,1469,1269,1157,3895,0.082171262
St. Louis,63020,20567,579,569,542,1690,0.082170467
Waco-Temple-Bryan,76570,2288,66,66,56,188,0.082167832
Greensboro-H.Point-W.Salem,27007,2069,63,47,60,170,0.082165297
Seattle-Tacoma,98058,45446,1221,1231,1282,3734,0.082163447
"Washington, DC (Hagrstwn)",22728,3627,110,100,88,298,0.082161566
Lake Charles,70631,1351,45,32,34,111,0.082161362
Los Angeles,91367,47286,1017,1230,1638,3885,0.082159624
San Diego,92129,55222,1676,1496,1365,4537,0.082159284
New Orleans,70003,38937,1044,1032,1123,3199,0.082158358
Kansas City,64442,779,28,22,14,64,0.082156611
Lexington,40943,706,24,20,14,58,0.082152975
Reno,89406,25891,732,700,695,2127,0.082152099
Grand Rapids-Kalmzoo-B.Crk,49403,2751,80,75,71,226,0.082151945
Los Angeles,91754,31150,718,893,948,2559,0.082150883
Knoxville,37804,26671,807,677,707,2191,0.082149151
Pittsburgh,15357,1899,49,56,51,156,0.082148499
"Columbia, SC",29065,633,20,16,16,52,0.082148499
Knoxville,40863,633,20,17,15,52,0.082148499
Detroit,48454,1266,34,32,38,104,0.082148499
Cleveland-Akron (Canton),44142,17359,435,474,517,1426,0.082147589
Champaign&Sprngfld-Decatur,62634,913,18,25,32,75,0.082146769
Nashville,37153,5892,208,149,127,484,0.082145282
Reno,89511,30447,762,828,911,2501,0.08214274
Harrisburg-Lncstr-Leb-York,17517,15997,501,414,399,1314,0.082140401
New York,7930,8997,325,250,164,739,0.082138491
Abilene-Sweetwater,79563,1254,40,29,34,103,0.082137161
Roanoke-Lynchburg,24162,2228,72,55,56,183,0.082136445
Monroe-El Dorado,71342,7865,225,221,200,646,0.082136046
Chicago,60630,53643,1312,1495,1599,4406,0.0821356
Green Bay-Appleton,54136,7366,197,220,188,605,0.08213413
Joplin-Pittsburg,66781,1181,33,34,30,97,0.082133785
"Alexandria, LA",71331,694,21,19,17,57,0.082132565
Wichita Falls & Lawton,79252,2776,72,91,65,228,0.082132565
Medford-Klamath Falls,97535,4992,123,145,142,410,0.08213141
"Springfield, MO",65556,5820,190,159,129,478,0.082130584
Traverse City-Cadillac,49724,1522,53,40,32,125,0.082128778
Dallas-Ft. Worth,76450,12992,399,359,309,1067,0.082127463
Flint-Saginaw-Bay City,48519,7318,164,197,240,601,0.082126264
"Springfield, MO",65609,621,16,20,15,51,0.082125604
Minneapolis-St. Paul,55040,14880,456,381,385,1222,0.082123656
Minneapolis-St. Paul,55071,5809,187,151,139,477,0.082113961
Tallahassee-Thomasville,31626,3410,101,83,96,280,0.082111437
Indianapolis,46057,1023,32,27,25,84,0.082111437
Ft. Wayne,46562,4774,141,129,122,392,0.082111437
Wichita Falls & Lawton,73568,1023,26,33,25,84,0.082111437
Abilene-Sweetwater,79553,3130,84,94,79,257,0.082108626
Wilkes Barre-Scranton-Hztn,17881,1632,47,43,44,134,0.082107843
Ft. Wayne,46705,1632,52,41,41,134,0.082107843
Cincinnati,41006,4555,146,117,111,374,0.082107574
Charlotte,28097,7259,211,187,198,596,0.082104973
St. Louis,63344,1559,43,40,45,128,0.082103913
Minneapolis-St. Paul,55378,32363,1038,881,738,2657,0.082099929
Cincinnati,45176,8916,274,237,221,732,0.082099596
Flint-Saginaw-Bay City,48856,743,20,20,21,61,0.082099596
"Columbus, OH",45710,5335,168,145,125,438,0.082099344
Cleveland-Akron (Canton),44230,8429,245,237,210,692,0.08209752
Knoxville,37764,11730,369,291,303,963,0.082097187
Reno,89701,29064,745,805,836,2386,0.082094688
Albuquerque-Santa Fe,87544,13789,427,375,330,1132,0.082094423
Utica,13317,3764,120,107,82,309,0.082093518
Lansing,49271,2083,77,53,41,171,0.082093135
Detroit,48328,23985,614,620,735,1969,0.082092975
Wilkes Barre-Scranton-Hztn,18460,134,4,3,4,11,0.082089552
Davenport-R.Island-Moline,61258,134,4,4,3,11,0.082089552
Columbia-Jefferson City,65345,268,10,6,6,22,0.082089552
Shreveport,71045,670,23,20,12,55,0.082089552
Philadelphia,8065,7651,158,215,255,628,0.082080774
St. Louis,62281,2924,106,69,65,240,0.082079343
Milwaukee,53228,15120,341,407,493,1241,0.08207672
"Charleston, SC",29510,10076,301,279,247,827,0.082076221
Sacramnto-Stkton-Modesto,95688,38952,1130,1091,976,3197,0.082075375
Paducah-Cape Girard-Harsbg,62908,463,16,13,9,38,0.082073434
Kansas City,64150,4557,116,128,130,374,0.082071538
Kansas City,64440,792,28,19,18,65,0.082070707
Lexington,42602,8834,273,235,217,725,0.082069278
Peoria-Bloomington,61451,329,11,10,6,27,0.082066869
Bismarck-Mnt-Dcknsn(Wlstn),58503,38993,1222,1043,935,3200,0.082066012
South Bend-Elkhart,47946,1840,65,40,46,151,0.082065217
New York,11766,12600,400,340,294,1034,0.082063492
Wichita Falls & Lawton,73565,853,27,22,21,70,0.082063306
Portland-Auburn,4030,2230,69,63,51,183,0.08206278
Nashville,37073,14952,446,405,376,1227,0.0820626
Cedar Rapids-Wtrlo-IWC&Dub,52352,1901,64,54,38,156,0.082062073
"Washington, DC (Hagrstwn)",20816,16183,612,438,278,1328,0.082061422
Quincy-Hannibal-Keokuk,65258,524,17,13,13,43,0.082061069
"Springfield, MO",65742,14185,448,368,348,1164,0.082058513
Boston (Manchester),3301,33391,738,950,1052,2740,0.08205804
Madison,53576,2352,71,59,63,193,0.082057823
Denver,80602,48466,1756,1219,1002,3977,0.082057525
Youngstown,44402,2742,85,79,61,225,0.082056893
Sioux City,51235,1109,45,20,26,91,0.082055906
Columbia-Jefferson City,65486,3254,106,83,78,267,0.082052858
Buffalo,14043,25289,560,692,823,2075,0.082051485
Syracuse,13418,195,6,6,4,16,0.082051282
Little Rock-Pine Bluff,72555,195,6,5,5,16,0.082051282
New York,11703,16429,437,440,471,1348,0.082050033
Phoenix (Prescott),85209,45694,1175,1195,1379,3749,0.082045783
Chicago,60022,8142,298,254,116,668,0.082043724
Nashville,38469,4327,127,117,111,355,0.082042986
Dallas-Ft. Worth,75490,3352,105,97,73,275,0.082040573
Sioux Falls(Mitchell),57033,6058,214,164,119,497,0.082040277
Nashville,37061,5217,163,133,132,428,0.082039486
Buffalo,14719,3413,108,100,72,280,0.082039262
Providence-New Bedford,2858,707,20,19,19,58,0.082036775
Colorado Springs-Pueblo,81022,1414,39,43,34,116,0.082036775
Dallas-Ft. Worth,76665,2377,75,66,54,195,0.08203618
Cleveland-Akron (Canton),44312,29865,724,826,900,2450,0.082035828
Nashville,37050,1926,59,57,42,158,0.082035306
Salt Lake City,84121,41129,1116,1065,1193,3374,0.082034574
Davenport-R.Island-Moline,61250,2499,85,61,59,205,0.082032813
Bluefield-Beckley-Oak Hill,24970,3523,93,93,103,289,0.082032359
"Rochester, NY",14467,10033,253,259,311,823,0.082029303
Austin,78650,1914,64,51,42,157,0.082027168
Sacramnto-Stkton-Modesto,95237,3060,96,85,70,251,0.082026144
Oklahoma City,73626,1207,46,28,25,99,0.082021541
Chattanooga,35768,11241,298,292,332,922,0.082021172
Lexington,40402,3036,86,86,77,249,0.08201581
Davenport-R.Island-Moline,61251,378,12,11,8,31,0.082010582
"Columbus, GA (Opelika, AL)",31827,1573,43,49,37,129,0.0820089
Phoenix (Prescott),85938,2390,76,68,52,196,0.082008368
"Portland, OR",98663,15072,356,361,519,1236,0.082006369
Wichita-Hutchinson Plus,67640,439,17,11,8,36,0.082004556
New York,11780,15158,460,403,380,1243,0.082002903
Lexington,41746,500,15,10,16,41,0.082
Joplin-Pittsburg,66740,500,17,13,11,41,0.082
Grand Rapids-Kalmzoo-B.Crk,49435,3683,103,91,108,302,0.081998371
Denver,80530,6488,186,153,193,532,0.081997534
Birmingham (Ann and Tusc),35901,18891,539,501,509,1549,0.081996718
Boston (Manchester),1756,6476,205,193,133,531,0.081995059
Knoxville,37865,23331,662,601,650,1913,0.081993914
Boston (Manchester),1031,1244,43,28,31,102,0.081993569
Seattle-Tacoma,98248,28466,863,730,741,2334,0.081992553
"Jackson, TN",38344,8818,260,230,233,723,0.081991381
Davenport-R.Island-Moline,52732,25564,714,711,671,2096,0.081990299
Indianapolis,47950,744,25,18,18,61,0.081989247
Pittsburgh,15301,48288,1298,1415,1246,3959,0.081987243
Montgomery-Selma,36035,2476,74,67,62,203,0.081987076
St. Louis,63090,23870,698,602,657,1957,0.081985756
Burlington-Plattsburgh,5464,3025,76,89,83,248,0.081983471
Tulsa,74021,23262,716,589,602,1907,0.081979194
Albany-Schenectady-Troy,12078,22580,640,629,582,1851,0.081975199
Paducah-Cape Girard-Harsbg,63775,16627,475,441,447,1363,0.081975101
Baton Rouge,70739,12760,420,318,308,1046,0.081974922
Chicago,60002,24911,800,688,554,2042,0.08197182
Chicago,60097,11748,356,303,304,963,0.081971399
Orlando-Daytona Bch-Melbrn,32725,50837,1448,1329,1390,4167,0.081967858
Johnstown-Altoona-St Colge,15558,2074,66,52,52,170,0.081967213
Minneapolis-St. Paul,55027,2989,108,70,67,245,0.081967213
Minneapolis-St. Paul,55957,671,21,17,17,55,0.081967213
Little Rock-Pine Bluff,72572,122,3,3,4,10,0.081967213
Denver,82227,183,2,6,7,15,0.081967213
Detroit,48043,15482,385,399,485,1269,0.081966154
Orlando-Daytona Bch-Melbrn,34715,28512,908,739,690,2337,0.081965488
Phoenix (Prescott),85382,44483,1189,1243,1214,3646,0.081963896
New York,11754,18557,478,527,516,1521,0.081963679
Raleigh-Durham (Fayetvlle),28318,4441,131,117,116,364,0.081963522
New Orleans,70446,7357,237,187,179,603,0.081962757
Fargo,56547,2550,91,71,47,209,0.081960784
Raleigh-Durham (Fayetvlle),28395,2489,87,59,58,204,0.081960627
Joplin-Pittsburg,66748,2599,93,67,53,213,0.081954598
Youngstown,43968,6406,191,181,153,525,0.081954418
Birmingham (Ann and Tusc),35116,5076,154,139,123,416,0.081954295
Birmingham (Ann and Tusc),35173,30993,1071,823,646,2540,0.08195399
Topeka,66086,11409,383,294,258,935,0.081952844
"Washington, DC (Hagrstwn)",22182,28480,873,758,703,2334,0.081952247
Minneapolis-St. Paul,55329,2172,62,64,52,178,0.081952118
Traverse City-Cadillac,49663,6272,225,160,129,514,0.081951531
Albany-Schenectady-Troy,12863,1025,35,23,26,84,0.08195122
Sioux Falls(Mitchell),57257,964,31,23,25,79,0.081950207
Greenwood-Greenville,38744,659,21,18,15,54,0.081942337
New York,8753,65839,1803,1755,1837,5395,0.081942314
Harrisburg-Lncstr-Leb-York,17402,37698,1107,970,1012,3089,0.081940687
"Jackson, MS",39661,2685,89,72,59,220,0.081936685
Indianapolis,46180,1074,30,28,30,88,0.081936685
Atlanta,30184,7811,227,209,204,640,0.081935732
New Orleans,70420,8812,296,240,186,722,0.081933727
Huntsville-Decatur (Flor),35773,13926,411,359,371,1141,0.081933075
Bluefield-Beckley-Oak Hill,25820,476,14,14,11,39,0.081932773
Evansville,47523,3332,114,81,78,273,0.081932773
Chicago,60941,1904,58,54,44,156,0.081932773
Monroe-El Dorado,71422,1904,48,56,52,156,0.081932773
Birmingham (Ann and Tusc),35180,14207,430,390,344,1164,0.081931442
San Francisco-Oak-San Jose,94539,55559,1924,1478,1150,4552,0.08193092
Youngstown,44511,18174,473,504,512,1489,0.08193023
Cedar Rapids-Wtrlo-IWC&Dub,50629,2551,81,63,65,209,0.081928655
Madison,53505,415,13,13,8,34,0.081927711
New York,10960,14843,376,390,450,1216,0.081924139
Roanoke-Lynchburg,24059,1123,35,30,27,92,0.081923419
Savannah,29945,4077,107,118,109,334,0.081922983
Cleveland-Akron (Canton),44613,1831,52,50,48,150,0.081922447
Yakima-Pasco-Rchlnd-Knnwck,99320,10742,347,282,251,880,0.08192143
"Tri-Cities, TN-VA",40874,354,12,10,7,29,0.081920904
Dallas-Ft. Worth,75448,708,18,20,20,58,0.081920904
New York,7014,5420,122,131,191,444,0.081918819
Los Angeles,91301,23731,722,675,547,1944,0.081918166
Minneapolis-St. Paul,55330,46852,1500,1297,1041,3838,0.081917528
Cleveland-Akron (Canton),44611,2295,62,69,57,188,0.081917211
New York,10518,1294,47,39,20,106,0.081916538
Los Angeles,91701,37514,1055,1010,1008,3073,0.081916085
Watertown,13691,2881,81,76,79,236,0.081916001
Norfolk-Portsmth-Newpt Nws,23420,3223,94,92,78,264,0.081911263
"Tri-Cities, TN-VA",37680,586,19,15,14,48,0.081911263
Baltimore,21162,5323,189,131,116,436,0.081908698
Alpena,49766,2515,69,72,65,206,0.081908549
"Lafayette, LA",70552,818,27,22,18,67,0.08190709
Denver,81151,2161,77,55,45,177,0.081906525
Davenport-R.Island-Moline,52653,3443,98,87,97,282,0.081905315
Denver,80537,42515,1024,1194,1264,3482,0.081900506
Atlanta,30276,21111,708,548,473,1729,0.081900431
Utica,13807,1221,30,41,29,100,0.081900082
Seattle-Tacoma,98051,3773,129,105,75,309,0.081897694
Boston (Manchester),2543,696,15,21,21,57,0.081896552
Clarksburg-Weston,26325,232,6,7,6,19,0.081896552
Colorado Springs-Pueblo,81005,31553,908,879,797,2584,0.081893956
Louisville,40177,1563,46,44,38,128,0.081893794
Grand Rapids-Kalmzoo-B.Crk,49014,21345,593,534,621,1748,0.081892715
Omaha,51525,1099,35,30,25,90,0.08189263
Los Angeles,90803,33679,487,821,1450,2758,0.081890792
Harrisburg-Lncstr-Leb-York,17370,6411,196,160,169,525,0.081890501
Little Rock-Pine Bluff,71640,2479,80,69,54,203,0.081887858
Birmingham (Ann and Tusc),35563,3688,96,109,97,302,0.081887202
Los Angeles,92808,19759,563,535,520,1618,0.081886735
Lansing,48813,21604,629,599,541,1769,0.081882985
Boston (Manchester),1864,15669,482,443,358,1283,0.081881422
Phoenix (Prescott),85207,51465,1555,1393,1266,4214,0.08188089
Columbus-Tupelo-West Point,38856,1490,51,41,30,122,0.081879195
"Springfield, MO",65605,12006,357,314,312,983,0.081875729
La Crosse-Eau Claire,55952,2284,85,62,40,187,0.081873905
Birmingham (Ann and Tusc),35097,1881,49,55,50,154,0.081871345
Peoria-Bloomington,61755,4275,144,115,91,350,0.081871345
Atlanta,30548,28936,974,757,638,2369,0.081870335
Los Angeles,90266,34360,1148,911,754,2813,0.081868452
San Diego,92103,33310,311,797,1619,2727,0.081867307
Detroit,48451,16173,513,435,376,1324,0.081864836
New York,8844,44403,1413,1182,1040,3635,0.081863838
Elmira (Corning),14821,2944,81,80,80,241,0.081861413
Cincinnati,40379,3677,132,86,83,301,0.081860212
Minneapolis-St. Paul,54004,2480,84,58,61,203,0.081854839
Birmingham (Ann and Tusc),35072,4618,124,129,125,378,0.081853616
Chattanooga,37327,13854,396,395,343,1134,0.081853616
Monterey-Salinas,95045,4618,129,133,116,378,0.081853616
"Washington, DC (Hagrstwn)",20119,4447,131,129,104,364,0.081852935
Toledo,43502,7025,216,199,160,575,0.081850534
Tampa-St. Pete (Sarasota),34655,49554,1504,1433,1119,4056,0.081850103
Houston,77008,41467,534,941,1919,3394,0.081848217
Champaign&Sprngfld-Decatur,62638,1234,38,32,31,101,0.08184765
New York,10998,3641,107,99,92,298,0.081845647
Ft. Wayne,45831,2908,95,74,69,238,0.081843191
Minneapolis-St. Paul,54023,4753,170,112,107,389,0.081843046
Oklahoma City,73012,45734,1606,1113,1024,3743,0.08184283
Charleston-Huntington,41144,9616,295,265,227,787,0.081842762
Austin,78642,22556,804,573,469,1846,0.081840752
Evansville,42367,892,25,22,26,73,0.081838565
San Antonio,78009,9531,307,267,206,780,0.081838212
Detroit,48855,16997,484,496,411,1391,0.081837971
St. Louis,63010,34532,1003,916,907,2826,0.081837137
Milwaukee,53120,10289,304,284,254,842,0.081834969
Hartford & New Haven,6787,7674,194,217,217,628,0.081834767
"Portland, OR",97055,21434,636,563,555,1754,0.081832602
San Diego,91906,3886,127,97,94,318,0.081832218
"Springfield, MO",65711,9324,305,242,216,763,0.081831832
Birmingham (Ann and Tusc),35565,12465,381,320,319,1020,0.081829122
Cleveland-Akron (Canton),44822,3373,110,91,75,276,0.081826267
Charleston-Huntington,25530,5903,174,152,157,483,0.081822802
Baltimore,21660,4082,127,116,91,334,0.081822636
Oklahoma City,73082,2701,97,71,53,221,0.081821548
Charlottesville,22911,20851,628,534,544,1706,0.081818618
Raleigh-Durham (Fayetvlle),27511,32951,906,903,887,2696,0.081818458
Mobile-Pensacola (Ft Walt),36538,330,9,10,8,27,0.081818182
Quincy-Hannibal-Keokuk,63471,550,12,18,15,45,0.081818182
Waco-Temple-Bryan,76624,2750,82,80,63,225,0.081818182
Minneapolis-St. Paul,55021,30569,925,825,751,2501,0.081814911
Kansas City,64671,2078,65,57,48,170,0.081809432
Honolulu,96734,47551,1127,1368,1395,3890,0.081806902
"Columbus, GA (Opelika, AL)",31829,1528,53,38,34,125,0.081806283
Bangor,4976,9926,269,261,282,812,0.08180536
Nashville,42164,17224,542,433,434,1409,0.081804459
Cincinnati,41040,7457,229,207,174,610,0.081802333
Columbia-Jefferson City,64628,5428,168,142,134,444,0.081798084
Kansas City,66053,8570,286,239,176,701,0.081796966
Birmingham (Ann and Tusc),35469,379,13,10,8,31,0.081794195
Baton Rouge,70778,3081,95,70,87,252,0.081791626
New York,7440,4536,152,124,95,371,0.081790123
Orlando-Daytona Bch-Melbrn,34756,5184,149,146,129,424,0.081790123
Toledo,43534,1565,44,47,37,128,0.081789137
Johnstown-Altoona-St Colge,17255,917,28,27,20,75,0.081788441
Flint-Saginaw-Bay City,48871,2103,60,54,58,172,0.081787922
"Columbus, OH",43760,2262,69,62,54,185,0.08178603
Peoria-Bloomington,61531,3069,85,88,78,251,0.081785598
Chattanooga,30725,4683,139,119,125,383,0.08178518
Memphis,38023,5759,179,151,141,471,0.081785032
Birmingham (Ann and Tusc),36790,269,7,8,7,22,0.081784387
"Springfield, MO",65783,269,9,7,6,22,0.081784387
Charleston-Huntington,41544,697,27,18,12,57,0.081779053
Dallas-Ft. Worth,75214,36073,732,936,1282,2950,0.081778616
"Columbus, OH",43843,1125,36,31,25,92,0.081777778
New York,6878,8193,316,229,125,670,0.081777127
Cleveland-Akron (Canton),44133,30999,748,815,972,2535,0.081776832
Champaign&Sprngfld-Decatur,61914,1712,52,52,36,140,0.081775701
Boston (Manchester),2464,3204,77,100,85,262,0.081772784
Amarillo,73848,1810,73,44,31,148,0.081767956
Wilkes Barre-Scranton-Hztn,17740,12022,360,319,304,983,0.081766761
Grand Rapids-Kalmzoo-B.Crk,49028,5993,195,159,136,490,0.081762056
St. Louis,63039,795,28,19,18,65,0.081761006
Myrtle Beach-Florence,29527,29428,864,759,783,2406,0.081758869
Syracuse,13167,2434,73,64,62,199,0.081758422
Tyler-Longview(Lfkn&Ncgd),75750,4232,138,110,98,346,0.081758034
Denver,80123,47066,1214,1219,1415,3848,0.081757532
Traverse City-Cadillac,49688,2642,77,80,59,216,0.081756245
Wilkes Barre-Scranton-Hztn,17844,9773,287,246,266,799,0.081755858
Kansas City,64163,1162,18,25,52,95,0.081755594
Nashville,37015,19791,575,522,521,1618,0.081754333
Davenport-R.Island-Moline,52773,2373,81,62,51,194,0.081753055
Columbia-Jefferson City,65032,1529,44,37,44,125,0.08175278
Victoria,77905,15657,489,391,400,1280,0.081752571
Atlanta,30677,21663,813,568,390,1771,0.081752297
Roanoke-Lynchburg,24301,13896,366,379,391,1136,0.081750144
Lexington,42566,526,16,14,13,43,0.081749049
Bowling Green,42261,10202,299,275,260,834,0.081748677
Wichita Falls & Lawton,76367,9884,321,261,226,808,0.08174828
Syracuse,13032,12245,342,332,327,1001,0.081747652
Champaign&Sprngfld-Decatur,60936,4306,130,117,105,352,0.0817464
Myrtle Beach-Florence,28340,8453,255,226,210,691,0.081746126
Charleston-Huntington,25130,3988,115,112,99,326,0.081745236
Tyler-Longview(Lfkn&Ncgd),75757,14007,461,377,307,1145,0.081744842
Baton Rouge,70767,15475,444,414,407,1265,0.08174475
"Portland, OR",97377,1101,34,27,29,90,0.081743869
Augusta-Aiken,30673,7181,193,194,200,587,0.08174349
Detroit,48168,24052,868,679,419,1966,0.081739564
Utica,13492,11500,327,300,313,940,0.08173913
New Orleans,70452,13482,400,371,331,1102,0.081738614
South Bend-Elkhart,46614,30133,778,804,881,2463,0.08173763
Bluefield-Beckley-Oak Hill,25839,783,26,18,20,64,0.081736909
Louisville,40140,783,25,20,19,64,0.081736909
"Portland, OR",97867,783,30,19,15,64,0.081736909
Memphis,38626,991,30,25,26,81,0.081735621
Mobile-Pensacola (Ft Walt),36581,208,5,6,6,17,0.081730769
Kansas City,64427,624,19,18,14,51,0.081730769
Peoria-Bloomington,61550,18659,612,473,440,1525,0.081729996
Atlanta,30506,47082,1366,1283,1199,3848,0.081729748
Kansas City,64730,6852,208,179,173,560,0.081727963
Sioux Falls(Mitchell),57013,4931,166,143,94,403,0.081727844
Chicago,60077,27751,739,763,766,2268,0.081726785
Cincinnati,45122,10670,324,287,261,872,0.081724461
Bluefield-Beckley-Oak Hill,25984,1346,49,28,33,110,0.081723626
Paducah-Cape Girard-Harsbg,38233,2692,77,76,67,220,0.081723626
Paducah-Cape Girard-Harsbg,62822,2692,68,83,69,220,0.081723626
Spokane,99403,20570,556,585,540,1681,0.081720953
La Crosse-Eau Claire,54651,1395,52,34,28,114,0.08172043
Albuquerque-Santa Fe,87006,465,16,13,9,38,0.08172043
Erie,16433,4907,151,118,132,401,0.081719992
Pittsburgh,15728,3561,92,104,95,291,0.081718618
Little Rock-Pine Bluff,72175,257,7,6,8,21,0.081712062
Seattle-Tacoma,98537,2056,57,62,49,168,0.081712062
Sacramnto-Stkton-Modesto,95608,64153,1617,1739,1886,5242,0.08171091
Columbia-Jefferson City,65254,1848,66,42,43,151,0.081709957
Little Rock-Pine Bluff,72020,3696,115,97,90,302,0.081709957
Salisbury,21613,18272,525,451,517,1493,0.08170972
Albany-Schenectady-Troy,12092,1334,35,36,38,109,0.081709145
Greenvll-Spart-Ashevll-And,28160,3892,112,108,98,318,0.081706064
Cleveland-Akron (Canton),44807,2252,60,69,55,184,0.081705151
Oklahoma City,74827,563,19,14,13,46,0.081705151
Minneapolis-St. Paul,54002,6805,209,170,177,556,0.081704629
Charlotte,28638,11811,336,309,320,965,0.081703497
Indianapolis,47338,2607,82,68,63,213,0.081703107
Milwaukee,53042,7001,207,205,160,572,0.081702614
La Crosse-Eau Claire,53826,1175,37,31,28,96,0.081702128
Columbia-Jefferson City,65257,1481,43,39,39,121,0.081701553
Buffalo,14060,306,10,8,7,25,0.081699346
Idaho Fals-Pocatllo(Jcksn),83214,612,23,18,9,50,0.081699346
Louisville,40111,1628,55,44,34,133,0.081695332
Pittsburgh,15035,1983,54,48,60,162,0.081694402
Nashville,42215,1371,47,31,34,112,0.081692195
"Columbus, OH",44820,16429,461,448,433,1342,0.081684826
Flint-Saginaw-Bay City,48415,8790,238,240,240,718,0.081683732
Nashville,42153,404,13,11,9,33,0.081683168
San Francisco-Oak-San Jose,94619,24240,636,667,677,1980,0.081683168
Raleigh-Durham (Fayetvlle),27844,2571,75,72,63,210,0.08168028
Greenwood-Greenville,38736,453,13,11,13,37,0.081677704
Cedar Rapids-Wtrlo-IWC&Dub,52356,2767,91,71,64,226,0.081676906
West Palm Beach-Ft. Pierce,34982,27107,770,713,731,2214,0.08167632
Denver,80549,15072,527,354,350,1231,0.081674628
Bangor,4939,1004,35,25,22,82,0.081673307
Joplin-Pittsburg,64769,502,15,13,13,41,0.081673307
"Washington, DC (Hagrstwn)",20906,73564,1996,2033,1979,6008,0.081670382
Jonesboro,72447,1751,42,52,49,143,0.081667619
Norfolk-Portsmth-Newpt Nws,23827,1200,38,32,28,98,0.081666667
Cedar Rapids-Wtrlo-IWC&Dub,52335,600,22,15,12,49,0.081666667
Raleigh-Durham (Fayetvlle),27207,3490,99,98,88,285,0.081661891
Peoria-Bloomington,61732,2094,72,59,40,171,0.081661891
San Francisco-Oak-San Jose,94306,27920,814,763,703,2280,0.081661891
Wichita Falls & Lawton,73573,2290,77,49,61,187,0.081659389
Dayton,45429,26133,653,671,810,2134,0.081659205
Birmingham (Ann and Tusc),35058,11916,350,305,318,973,0.081654918
Madison,53554,1090,39,25,25,89,0.081651376
Raleigh-Durham (Fayetvlle),27565,25903,747,703,665,2115,0.081650774
Atlanta,30641,2523,70,74,62,206,0.081648831
Bakersfield,93243,1286,36,35,34,105,0.081648523
Roanoke-Lynchburg,24579,1384,33,52,28,113,0.081647399
Nashville,38462,10901,317,301,272,890,0.081643886
Harrisburg-Lncstr-Leb-York,17111,37137,890,998,1144,3032,0.081643644
Rockford,61032,28368,795,765,756,2316,0.081641286
New York,10576,4912,168,138,95,401,0.081636808
Greenvll-Spart-Ashevll-And,29651,54914,1704,1420,1359,4483,0.081636741
Philadelphia,18041,5794,163,138,172,473,0.081636175
Lexington,41465,9959,293,264,256,813,0.081634702
Tyler-Longview(Lfkn&Ncgd),75645,10792,346,283,252,881,0.081634544
Harrisburg-Lncstr-Leb-York,17225,20151,659,513,473,1645,0.081633666
Watertown,13672,441,14,12,10,36,0.081632653
Bluefield-Beckley-Oak Hill,25845,539,15,17,12,44,0.081632653
Nashville,37028,637,22,18,12,52,0.081632653
Lexington,40440,2107,54,60,58,172,0.081632653
Charleston-Huntington,41274,539,13,16,15,44,0.081632653
Lima,45875,11564,351,302,291,944,0.081632653
Fargo,58343,49,1,1,2,4,0.081632653
Chicago,60539,294,10,8,6,24,0.081632653
Peoria-Bloomington,61415,1617,51,41,40,132,0.081632653
Little Rock-Pine Bluff,71937,1911,62,57,37,156,0.081632653
Little Rock-Pine Bluff,72679,98,3,3,2,8,0.081632653
Beaumont-Port Arthur,77655,294,9,7,8,24,0.081632653
Salt Lake City,89834,49,2,1,1,4,0.081632653
Green Bay-Appleton,54220,41064,1092,1131,1129,3352,0.081628677
Greenvll-Spart-Ashevll-And,29681,65922,2312,1701,1368,5381,0.081626771
Los Angeles,91108,12239,381,367,251,999,0.081624316
Watertown,13662,15976,490,425,389,1304,0.081622434
Los Angeles,90064,27370,592,629,1013,2234,0.081622214
Minneapolis-St. Paul,54739,5599,211,146,100,457,0.081621718
Jacksonville,32043,36965,1185,971,861,3017,0.081617747
New York,6812,13502,412,381,309,1102,0.081617538
Flint-Saginaw-Bay City,48706,38229,1011,995,1114,3120,0.081613435
Philadelphia,8056,5661,250,128,84,462,0.081611023
Charlotte,28001,29163,798,785,797,2380,0.08161026
Lexington,40336,12523,356,352,314,1022,0.081609838
Los Angeles,91403,22522,394,548,896,1838,0.081609093
Albany-Schenectady-Troy,12188,10967,259,298,338,895,0.081608462
Pittsburgh,16232,4154,129,114,96,339,0.081608089
Green Bay-Appleton,54217,7757,251,201,181,633,0.081603713
Birmingham (Ann and Tusc),35226,36175,1005,911,1036,2952,0.081603317
"Portland, OR",97137,1299,41,33,32,106,0.081601232
Grand Rapids-Kalmzoo-B.Crk,49058,20392,579,559,526,1664,0.081600628
Quincy-Hannibal-Keokuk,63555,3174,100,86,73,259,0.081600504
Louisville,40075,1201,37,35,26,98,0.081598668
Erie,16435,1728,52,44,45,141,0.081597222
Knoxville,38574,9547,268,259,252,779,0.081596313
Bangor,4930,4461,117,131,116,364,0.081596055
Detroit,48064,3787,122,83,104,309,0.08159493
"Portland, OR",97068,30701,1011,903,591,2505,0.081593433
Dallas-Ft. Worth,76693,1532,50,41,34,125,0.081592689
Roanoke-Lynchburg,23963,478,13,14,12,39,0.081589958
Bluefield-Beckley-Oak Hill,25915,478,14,12,13,39,0.081589958
Monroe-El Dorado,71646,5822,184,153,138,475,0.081587083
Omaha,51534,9254,307,235,213,755,0.081586341
Columbus-Tupelo-West Point,38848,809,26,22,18,66,0.0815822
Champaign&Sprngfld-Decatur,62469,380,11,10,10,31,0.081578947
Chicago,60450,21342,596,562,583,1741,0.081576235
Spokane,99012,1042,39,25,21,85,0.081573896
Parkersburg,26184,2415,74,65,58,197,0.081573499
Anchorage,99623,32315,1047,803,786,2636,0.081572025
New Orleans,70006,15974,407,414,482,1303,0.081570051
Cincinnati,45034,1275,48,33,23,104,0.081568627
Grand Rapids-Kalmzoo-B.Crk,49071,11316,380,305,238,923,0.081565924
New York,10506,5750,190,175,104,469,0.081565217
Chicago,61321,282,9,7,7,23,0.081560284
Greensboro-H.Point-W.Salem,27358,15976,592,437,274,1303,0.08155984
"Rochester, NY",14424,28814,832,757,761,2350,0.081557576
Green Bay-Appleton,54135,2955,88,87,66,241,0.081556684
Little Rock-Pine Bluff,71751,797,32,18,15,65,0.081555834
Abilene-Sweetwater,76430,2391,73,57,65,195,0.081555834
Ft. Wayne,46764,1312,43,37,27,107,0.081554878
Wichita-Hutchinson Plus,67428,1312,37,36,34,107,0.081554878
Kansas City,64017,515,15,14,13,42,0.081553398
Oklahoma City,74867,515,15,16,11,42,0.081553398
Syracuse,13493,2011,68,52,44,164,0.081551467
"Tri-Cities, TN-VA",37615,24034,628,604,728,1960,0.081551136
"Washington, DC (Hagrstwn)",25430,8412,275,227,184,686,0.081550166
Louisville,42129,7149,200,210,173,583,0.081549867
Greenwood-Greenville,38726,233,5,8,6,19,0.081545064
Cedar Rapids-Wtrlo-IWC&Dub,50622,3495,134,82,69,285,0.081545064
Joplin-Pittsburg,67341,466,18,10,10,38,0.081545064
Greensboro-H.Point-W.Salem,27377,12484,379,325,314,1018,0.081544377
Birmingham (Ann and Tusc),35178,3716,109,102,92,303,0.08153929
Corpus Christi,78384,5666,163,137,162,462,0.081539005
San Francisco-Oak-San Jose,94960,15318,526,451,272,1249,0.08153806
Birmingham (Ann and Tusc),35462,4869,158,129,110,397,0.08153625
New York,11721,6304,204,198,112,514,0.081535533
Knoxville,37870,4403,126,116,117,359,0.081535317
Philadelphia,19979,417,13,9,12,34,0.081534772
Utica,13329,3655,124,91,83,298,0.081532148
St. Louis,62414,1754,52,48,43,143,0.081527936
Cleveland-Akron (Canton),44235,1975,55,54,52,161,0.081518987
Chicago,60093,20155,798,544,301,1643,0.081518234
Albany-Schenectady-Troy,12118,19002,470,503,576,1549,0.081517735
Charleston-Huntington,25571,2110,68,56,48,172,0.081516588
"Charleston, SC",29056,2012,54,60,50,164,0.081510934
Monterey-Salinas,93450,503,16,12,13,41,0.081510934
Memphis,38618,11201,320,279,314,913,0.081510579
Charlottesville,22932,11790,447,301,213,961,0.081509754
Grand Rapids-Kalmzoo-B.Crk,49056,3975,139,94,91,324,0.081509434
Cedar Rapids-Wtrlo-IWC&Dub,52160,822,25,18,24,67,0.081508516
Erie,16441,10183,340,260,230,830,0.081508396
Philadelphia,8010,12183,301,318,374,993,0.081507018
Birmingham (Ann and Tusc),35071,16735,484,405,475,1364,0.081505826
Harlingen-Wslco-Brnsvl-Mca,78591,319,8,12,6,26,0.081504702
Wausau-Rhinelander,54449,26650,747,670,755,2172,0.081500938
Nashville,38463,2773,83,70,73,226,0.08150018
New York,7803,4000,91,114,121,326,0.0815
Knoxville,42634,1362,41,35,35,111,0.081497797
New York,7746,18430,601,503,398,1502,0.081497558
Reno,89820,5129,172,124,122,418,0.081497368
Charlotte,29584,2405,73,62,61,196,0.081496881
Minneapolis-St. Paul,56011,9473,311,246,215,772,0.081494775
"Washington, DC (Hagrstwn)",22546,18934,582,469,492,1543,0.081493609
Columbia-Jefferson City,65233,11044,347,292,261,900,0.081492213
San Francisco-Oak-San Jose,94538,69111,1682,1752,2198,5632,0.081492092
Mobile-Pensacola (Ft Walt),32502,4344,94,120,140,354,0.081491713
New York,7626,9228,350,242,160,752,0.081491114
Philadelphia,19344,13155,422,360,290,1072,0.081489928
Memphis,38611,16763,469,454,443,1366,0.081488994
Sioux Falls(Mitchell),57579,1399,50,37,27,114,0.081486776
Traverse City-Cadillac,49770,17549,432,521,477,1430,0.081486125
Boston (Manchester),3452,5314,159,123,151,433,0.081482875
Burlington-Plattsburgh,5649,270,8,7,7,22,0.081481481
Birmingham (Ann and Tusc),35186,5805,171,155,147,473,0.081481481
Toledo,43554,2430,80,60,58,198,0.081481481
Denver,80612,810,28,21,17,66,0.081481481
Birmingham (Ann and Tusc),35111,19551,591,494,508,1593,0.081479208
Traverse City-Cadillac,49338,1706,50,45,44,139,0.08147714
Harrisburg-Lncstr-Leb-York,17066,4848,138,123,134,395,0.081476898
Oklahoma City,73663,1436,41,40,36,117,0.081476323
Baltimore,21794,2602,88,79,45,212,0.081475788
Nashville,37097,2332,64,63,63,190,0.081475129
"Columbus, OH",45369,3498,110,90,85,285,0.081475129
Memphis,38658,2197,74,60,45,179,0.081474738
"Washington, DC (Hagrstwn)",22714,1031,30,28,26,84,0.081474297
Oklahoma City,74028,2062,72,49,47,168,0.081474297
Birmingham (Ann and Tusc),35073,2553,66,66,76,208,0.081472777
Wilkes Barre-Scranton-Hztn,17972,11599,342,311,292,945,0.081472541
Davenport-R.Island-Moline,61260,626,22,17,12,51,0.081469649
Johnstown-Altoona-St Colge,16668,3486,99,93,92,284,0.081468732
Philadelphia,8084,6739,156,200,193,549,0.081466093
Montgomery-Selma,36049,4996,148,127,132,407,0.081465172
"Washington, DC (Hagrstwn)",20148,69220,2829,1560,1250,5639,0.081464895
Terre Haute,47848,1338,43,37,29,109,0.081464873
"Springfield, MO",65713,2676,99,71,48,218,0.081464873
Portland-Auburn,4910,2050,63,50,54,167,0.081463415
Albany-Schenectady-Troy,12871,4186,120,114,107,341,0.081462016
Erie,16440,712,17,17,24,58,0.081460674
Macon,31076,2492,72,67,64,203,0.081460674
Paducah-Cape Girard-Harsbg,42003,28518,838,770,715,2323,0.081457325
Monroe-El Dorado,71366,1510,49,38,36,123,0.081456954
Fargo,56748,577,22,14,11,47,0.081455806
Sacramnto-Stkton-Modesto,95230,798,26,22,17,65,0.081453634
Cleveland-Akron (Canton),44718,12891,313,401,336,1050,0.081452176
"Springfield, MO",72635,3720,131,87,85,303,0.081451613
Youngstown,44417,1461,40,38,41,119,0.081451061
San Francisco-Oak-San Jose,95120,37274,1347,1053,636,3036,0.081450877
Pittsburgh,15458,2124,62,56,55,173,0.081450094
"Columbus, OH",43811,663,19,19,16,54,0.081447964
Kansas City,64471,442,10,13,13,36,0.081447964
Joplin-Pittsburg,66746,221,7,5,6,18,0.081447964
Denver,80645,4064,130,99,102,331,0.08144685
Sacramnto-Stkton-Modesto,95242,29369,854,803,735,2392,0.081446423
Hartford & New Haven,6790,35373,879,1029,973,2881,0.081446301
Knoxville,37354,18061,518,481,472,1471,0.08144621
Albany-Schenectady-Troy,12110,19989,563,547,518,1628,0.081444795
Los Angeles,91506,18749,401,508,618,1527,0.081444344
Mobile-Pensacola (Ft Walt),36548,970,25,28,26,79,0.081443299
Lexington,42633,18111,543,452,480,1475,0.081442217
Wichita Falls & Lawton,73529,4580,150,119,104,373,0.081441048
"Washington, DC (Hagrstwn)",22042,33816,785,859,1110,2754,0.081440738
Joplin-Pittsburg,64865,5894,189,162,129,480,0.081438751
Little Rock-Pine Bluff,72160,9099,268,229,244,741,0.081437521
Des Moines-Ames,51430,835,24,18,26,68,0.081437126
Greenwood-Greenville,38759,1142,32,36,25,93,0.081436077
St. Louis,62808,1449,46,39,33,118,0.081435473
Clarksburg-Weston,26338,614,14,20,16,50,0.081433225
Terre Haute,62424,2456,87,59,54,200,0.081433225
Champaign&Sprngfld-Decatur,62631,307,10,7,8,25,0.081433225
Boston (Manchester),1772,10414,353,284,211,848,0.081428846
Mobile-Pensacola (Ft Walt),36426,15744,471,401,410,1282,0.081427846
Idaho Fals-Pocatllo(Jcksn),83245,2272,84,64,37,185,0.081426056
Birmingham (Ann and Tusc),35130,3144,79,81,96,256,0.081424936
Chattanooga,37339,1965,57,55,48,160,0.081424936
Champaign&Sprngfld-Decatur,61953,6239,171,163,174,508,0.081423305
Houston,75939,4188,125,110,106,341,0.081423114
Seattle-Tacoma,98366,37755,1007,923,1144,3074,0.08141968
Charleston-Huntington,25093,479,14,13,12,39,0.081419624
Shreveport,71468,479,13,14,12,39,0.081419624
San Francisco-Oak-San Jose,95415,1523,50,45,29,124,0.081418253
New York,11749,3611,87,115,92,294,0.08141789
Birmingham (Ann and Tusc),35208,12528,348,350,322,1020,0.081417625
Omaha,68041,1044,37,27,21,85,0.081417625
Tulsa,74048,5220,149,146,130,425,0.081417625
Bluefield-Beckley-Oak Hill,25901,10367,307,265,272,844,0.081412173
"Washington, DC (Hagrstwn)",20155,38472,1344,997,791,3132,0.081409857
Wilkes Barre-Scranton-Hztn,17846,3464,99,103,80,282,0.081408776
Tulsa,74451,3808,123,88,99,310,0.081407563
Columbia-Jefferson City,65582,2076,69,56,44,169,0.081406551
Chico-Redding,96007,23954,739,650,561,1950,0.081406028
Little Rock-Pine Bluff,71742,4410,126,117,116,359,0.081405896
Albuquerque-Santa Fe,87537,2334,66,68,56,190,0.081405313
Des Moines-Ames,50543,1339,38,42,29,109,0.081404033
Boise,83714,30171,833,757,866,2456,0.081402671
"Columbus, OH",43334,6683,208,181,155,544,0.081400569
Erie,16404,2715,86,69,66,221,0.081399632
Minneapolis-St. Paul,54868,16438,490,421,427,1338,0.081396764
Memphis,38964,86,2,2,3,7,0.081395349
Columbus-Tupelo-West Point,39751,1204,38,30,30,98,0.081395349
Des Moines-Ames,50064,86,3,2,2,7,0.081395349
Cedar Rapids-Wtrlo-IWC&Dub,52048,344,13,10,5,28,0.081395349
Paducah-Cape Girard-Harsbg,63833,172,5,5,4,14,0.081395349
New York,10308,28270,704,778,819,2301,0.081393704
New York,10956,33198,953,952,797,2702,0.081390445
Minneapolis-St. Paul,55074,2273,75,52,58,185,0.081390233
Lansing,48897,1499,46,38,38,122,0.081387592
Wichita-Hutchinson Plus,67748,2482,71,54,77,202,0.081385979
Reno,89436,50552,1455,1307,1352,4114,0.081381548
Greenville-N.Bern-Washngtn,28586,7766,218,216,198,632,0.081380376
Albuquerque-Santa Fe,87552,3453,116,94,71,281,0.081378511
Orlando-Daytona Bch-Melbrn,33585,1364,42,36,33,111,0.081378299
Buffalo,14737,4006,123,97,106,326,0.081377933
La Crosse-Eau Claire,54616,2642,98,60,57,215,0.081377744
Seattle-Tacoma,98360,15361,503,405,342,1250,0.08137491
Dayton,45381,5616,177,150,130,457,0.081374644
Champaign&Sprngfld-Decatur,62467,3613,114,90,90,294,0.08137282
Detroit,48217,6366,174,176,168,518,0.081369777
St. Louis,65453,7804,250,203,182,635,0.081368529
Green Bay-Appleton,53923,2200,74,56,49,179,0.081363636
Harrisburg-Lncstr-Leb-York,17331,56967,1601,1486,1548,4635,0.081362894
Norfolk-Portsmth-Newpt Nws,23322,69160,2373,1853,1401,5627,0.081362059
Lexington,40409,3466,110,81,91,282,0.0813618
Albany-Schenectady-Troy,5201,14270,415,408,338,1161,0.081359495
Des Moines-Ames,50162,1180,42,30,24,96,0.081355932
Evansville,62815,295,11,6,7,24,0.081355932
Indianapolis,46070,2274,68,57,60,185,0.081354442
"Portland, OR",97229,76235,2681,1889,1632,6202,0.081353709
New York,7641,3282,123,77,67,267,0.081352834
"Rochester, NY",14522,8408,225,215,244,684,0.081351094
Madison,53581,9711,334,246,210,790,0.081351045
Montgomery-Selma,36749,1008,27,28,27,82,0.081349206
Seattle-Tacoma,98012,80469,2296,1899,2351,6546,0.081348097
Shreveport,71038,3147,91,81,84,256,0.081347315
"Columbus, OH",43154,3221,97,97,68,262,0.081341198
Myrtle Beach-Florence,28369,2090,63,56,51,170,0.081339713
Hattiesburg-Laurel,39422,4807,135,122,134,391,0.081339713
Cleveland-Akron (Canton),44669,1672,45,47,44,136,0.081339713
Peoria-Bloomington,61516,627,19,19,13,51,0.081339713
Odessa-Midland,79739,836,26,20,22,68,0.081339713
West Palm Beach-Ft. Pierce,33411,79261,2252,2022,2173,6447,0.081338868
San Francisco-Oak-San Jose,94545,33465,807,850,1065,2722,0.081338712
Casper-Riverton,82523,959,31,24,23,78,0.081334724
Rockford,61367,750,23,13,25,61,0.081333333
Duluth-Superior,55807,9369,253,238,271,762,0.081332053
Traverse City-Cadillac,49623,1082,39,28,21,88,0.081330869
Pittsburgh,16040,873,27,23,21,71,0.081328751
Little Rock-Pine Bluff,72568,1746,53,49,40,142,0.081328751
Bluefield-Beckley-Oak Hill,25811,332,11,8,8,27,0.081325301
Colorado Springs-Pueblo,80864,1660,58,42,35,135,0.081325301
New York,7863,4021,115,108,104,327,0.081323054
"Washington, DC (Hagrstwn)",22827,10612,306,310,247,863,0.081323031
Des Moines-Ames,50859,455,15,13,9,37,0.081318681
Monroe-El Dorado,71340,910,29,27,18,74,0.081318681
"Washington, DC (Hagrstwn)",21774,17930,672,455,331,1458,0.08131623
"Portland, OR",97756,47211,1324,1224,1291,3839,0.081315795
Flint-Saginaw-Bay City,48891,2767,83,75,67,225,0.081315504
Greensboro-H.Point-W.Salem,27047,1156,33,32,29,94,0.081314879
Quincy-Hannibal-Keokuk,52632,11671,363,284,302,949,0.081312655
Sioux Falls(Mitchell),57375,701,23,17,17,57,0.081312411
Springfield-Holyoke,1020,29455,704,787,904,2395,0.081310474
"Jackson, MS",39153,3911,112,112,94,318,0.081309128
Louisville,47513,2140,71,46,57,174,0.081308411
Little Rock-Pine Bluff,72853,1931,65,49,43,157,0.081305023
Medford-Klamath Falls,97540,7675,172,224,228,624,0.081302932
Detroit,48042,34378,1099,924,772,2795,0.081301995
Dallas-Ft. Worth,76082,23173,725,616,543,1884,0.081301515
"Jackson, MS",39152,1230,36,30,34,100,0.081300813
Bowling Green,42131,123,4,3,3,10,0.081300813
Wheeling-Steubenville,45727,492,14,13,13,40,0.081300813
Cedar Rapids-Wtrlo-IWC&Dub,52054,738,22,20,18,60,0.081300813
Bismarck-Mnt-Dcknsn(Wlstn),58655,615,27,12,11,50,0.081300813
Minneapolis-St. Paul,55089,2005,69,55,39,163,0.081296758
Paducah-Cape Girard-Harsbg,62935,2005,56,50,57,163,0.081296758
Little Rock-Pine Bluff,71743,3518,113,88,85,286,0.081296191
Mobile-Pensacola (Ft Walt),36480,1636,44,46,43,133,0.081295844
Spokane,83852,1390,36,35,42,113,0.081294964
Cincinnati,45030,23372,743,575,582,1900,0.081293856
Johnstown-Altoona-St Colge,16611,2362,69,67,56,192,0.081287045
Cedar Rapids-Wtrlo-IWC&Dub,52218,1710,58,41,40,139,0.08128655
Wichita-Hutchinson Plus,67108,1710,59,42,38,139,0.08128655
Charleston-Huntington,25661,5536,165,158,127,450,0.081286127
Wichita-Hutchinson Plus,67230,12573,444,318,260,1022,0.081285294
"Columbus, GA (Opelika, AL)",31803,4675,154,116,110,380,0.081283422
Jonesboro,72454,4675,127,131,122,380,0.081283422
Columbus-Tupelo-West Point,39744,5561,149,145,158,452,0.081280345
Quincy-Hannibal-Keokuk,62312,1907,65,46,44,155,0.081279497
Charlotte,28146,32247,914,885,822,2621,0.081278879
Paducah-Cape Girard-Harsbg,38240,2067,59,53,56,168,0.081277213
Peoria-Bloomington,61607,10126,267,270,286,823,0.081275923
Birmingham (Ann and Tusc),35550,4737,130,116,139,385,0.081275069
Charleston-Huntington,45614,4774,138,123,127,388,0.081273565
Kansas City,64034,9302,307,243,206,756,0.081272845
Little Rock-Pine Bluff,72521,5168,144,136,140,420,0.08126935
Augusta-Aiken,30456,2018,55,62,47,164,0.081268583
Roanoke-Lynchburg,24592,13314,402,340,340,1082,0.081267838
Birmingham (Ann and Tusc),35579,2904,83,71,82,236,0.081267218
Lincoln & Hastings-Krny,69138,4307,143,91,116,350,0.08126306
Grand Rapids-Kalmzoo-B.Crk,49445,21560,677,563,512,1752,0.081261596
Johnstown-Altoona-St Colge,16602,27430,728,725,776,2229,0.081261393
Greenville-N.Bern-Washngtn,27884,1206,32,35,31,98,0.081260365
Louisville,40342,24342,733,608,637,1978,0.08125873
Odessa-Midland,79752,2166,74,59,43,176,0.081255771
Pittsburgh,15338,1723,45,50,45,140,0.081253627
Birmingham (Ann and Tusc),35554,960,28,25,25,78,0.08125
Lake Charles,70632,160,7,1,5,13,0.08125
Salt Lake City,84728,160,5,5,3,13,0.08125
Nashville,38544,8357,283,203,193,679,0.081249252
Sherman-Ada,74525,9194,267,250,230,747,0.08124864
Baltimore,21054,14167,451,381,319,1151,0.081245147
New Orleans,39520,15078,478,382,365,1225,0.081244197
Champaign&Sprngfld-Decatur,61727,9195,242,249,256,747,0.081239804
Cedar Rapids-Wtrlo-IWC&Dub,50660,1194,36,33,28,97,0.081239531
"Jackson, MS",39213,18304,502,483,502,1487,0.081239073
St. Louis,62232,7558,219,207,188,614,0.081238423
Beaumont-Port Arthur,75977,517,13,16,13,42,0.081237911
Philadelphia,19057,16692,472,439,445,1356,0.08123652
Los Angeles,92347,874,30,24,17,71,0.081235698
"Columbus, OH",45715,2462,71,62,67,200,0.081234768
Pittsburgh,15468,2819,65,65,99,229,0.08123448
Des Moines-Ames,50542,911,34,22,18,74,0.081229418
Sherman-Ada,74731,1662,43,48,44,135,0.081227437
Champaign&Sprngfld-Decatur,61883,4075,117,120,94,331,0.081226994
Charleston-Huntington,25271,8741,263,211,236,710,0.081226404
Portland-Auburn,4048,3361,91,88,94,273,0.081225826
Boston (Manchester),3278,3201,90,111,59,260,0.081224617
Ft. Wayne,46919,2093,75,54,41,170,0.081223125
Rochestr-Mason City-Austin,55906,19699,589,502,509,1600,0.081222397
Augusta-Aiken,29853,6193,176,177,150,503,0.081220733
Philadelphia,8344,5639,160,128,170,458,0.081220074
Los Angeles,91104,32628,826,854,970,2650,0.081218585
Harrisburg-Lncstr-Leb-York,17220,197,7,4,5,16,0.081218274
"Washington, DC (Hagrstwn)",26767,591,14,17,17,48,0.081218274
Augusta-Aiken,30818,394,11,11,10,32,0.081218274
"Tri-Cities, TN-VA",40840,394,13,9,10,32,0.081218274
Louisville,42712,1970,59,52,49,160,0.081218274
Sioux City,68717,197,6,5,5,16,0.081218274
Philadelphia,8361,18777,560,484,481,1525,0.081216382
Chicago,60513,18790,587,513,426,1526,0.081213411
Seattle-Tacoma,98006,41077,1363,1112,861,3336,0.081213331
Columbus-Tupelo-West Point,39735,3891,132,98,86,316,0.081213056
Huntsville-Decatur (Flor),35634,10922,272,302,313,887,0.081212232
Idaho Fals-Pocatllo(Jcksn),83422,4125,139,98,98,335,0.081212121
New York,7041,7487,265,210,133,608,0.081207426
Tulsa,74429,17991,581,456,424,1461,0.08120727
"Portland, OR",98674,15319,447,423,374,1244,0.081206345
Hartford & New Haven,6280,3251,68,81,115,264,0.081205783
Knoxville,40806,2623,72,69,72,213,0.081204727
Green Bay-Appleton,54961,14088,443,372,329,1144,0.081203861
Quincy-Hannibal-Keokuk,63537,1761,53,47,43,143,0.081203861
Boston (Manchester),1890,23115,846,625,406,1877,0.081202682
Champaign&Sprngfld-Decatur,61818,1564,52,37,38,127,0.081202046
Memphis,38061,899,24,24,25,73,0.081201335
Boston (Manchester),3867,23054,538,639,695,1872,0.081200659
Los Angeles,92807,36885,1012,1054,929,2995,0.081198319
Salisbury,21835,468,17,12,9,38,0.081196581
Billings,82434,234,8,6,5,19,0.081196581
Fresno-Visalia,95369,936,27,29,20,76,0.081196581
Cincinnati,47037,4249,137,105,103,345,0.081195575
Cincinnati,41059,2611,79,63,70,212,0.081194944
Mobile-Pensacola (Ft Walt),36569,739,20,22,18,60,0.081190798
St. Louis,62249,16024,467,437,397,1301,0.081190714
Sacramnto-Stkton-Modesto,94534,43158,1252,1180,1072,3504,0.081190046
San Antonio,78160,5050,173,122,115,410,0.081188119
Denver,81092,776,35,19,9,63,0.081185567
Des Moines-Ames,50540,1047,35,27,23,85,0.081184336
Baltimore,21152,5506,172,147,128,447,0.081184163
Sioux Falls(Mitchell),57022,5654,202,133,124,459,0.081181464
Lincoln & Hastings-Krny,68822,4607,137,106,131,374,0.081180812
Eugene,97499,1934,67,45,45,157,0.081178904
Lexington,40374,2279,78,49,58,185,0.081175954
Chicago,60025,40604,1354,1113,829,3296,0.081174269
Boston (Manchester),2053,13354,414,356,314,1084,0.08117418
Detroit,48059,15239,450,408,379,1237,0.081173305
Champaign&Sprngfld-Decatur,61951,7675,239,199,185,623,0.081172638
Bluefield-Beckley-Oak Hill,24869,887,29,27,16,72,0.081172492
Mobile-Pensacola (Ft Walt),36558,2969,70,80,91,241,0.081172112
Boston (Manchester),1770,4472,153,137,73,363,0.081171735
San Antonio,78121,15954,513,432,350,1295,0.081170866
Terre Haute,47866,308,10,7,8,25,0.081168831
Memphis,72374,616,21,16,13,50,0.081168831
Indianapolis,46036,11347,356,290,275,921,0.081166828
Ft. Myers-Naples,34117,19171,541,513,502,1556,0.081164259
Santabarbra-Sanmar-Sanluob,93446,45562,1374,1225,1099,3698,0.081164128
Wichita-Hutchinson Plus,67514,653,16,18,19,53,0.081163859
Salt Lake City,83254,4263,142,102,102,346,0.0811635
"Tri-Cities, TN-VA",24368,4682,143,136,101,380,0.081161897
New York,11596,10929,310,297,280,887,0.081160216
Evansville,47580,345,11,8,9,28,0.08115942
Kansas City,64024,16289,495,408,419,1322,0.081159064
South Bend-Elkhart,49112,10461,347,274,228,849,0.081158589
Los Angeles,91423,31396,578,711,1259,2548,0.081156835
Indianapolis,47955,1072,28,28,31,87,0.081156716
Davenport-R.Island-Moline,61257,1072,32,28,27,87,0.081156716
Madison,53530,4658,136,135,107,378,0.081150708
"Washington, DC (Hagrstwn)",22815,9008,245,221,265,731,0.081150089
Harrisonburg,24486,3968,119,107,96,322,0.081149194
Bismarck-Mnt-Dcknsn(Wlstn),59263,1220,37,33,29,99,0.081147541
Dallas-Ft. Worth,76016,30303,929,853,677,2459,0.081147081
Omaha,51654,419,15,9,10,34,0.081145585
Waco-Temple-Bryan,76550,13445,390,346,355,1091,0.081145407
Greenville-N.Bern-Washngtn,27886,18005,497,497,467,1461,0.081144127
Minneapolis-St. Paul,55442,12484,282,325,406,1013,0.081143864
New York,10567,18449,565,521,411,1497,0.081142609
Indianapolis,47431,1331,40,36,32,108,0.081141998
Greenvll-Spart-Ashevll-And,28715,28643,826,723,775,2324,0.081136752
Cleveland-Akron (Canton),44082,1479,43,43,34,120,0.081135903
Paducah-Cape Girard-Harsbg,62812,10501,303,286,263,852,0.08113513
"Columbus, OH",43060,2502,85,66,52,203,0.081135092
Milwaukee,53012,19819,608,555,445,1608,0.081134265
"Washington, DC (Hagrstwn)",22534,3180,102,84,72,258,0.081132075
Shreveport,71847,530,18,14,11,43,0.081132075
Philadelphia,18932,567,20,15,11,46,0.081128748
New York,10541,25466,689,701,676,2066,0.081127778
"Springfield, MO",65622,8690,263,235,207,705,0.081127733
Greensboro-H.Point-W.Salem,27325,6496,209,189,129,527,0.081126847
Buffalo,14150,40135,862,1053,1341,3256,0.081126199
Louisville,40040,641,22,17,13,52,0.081123245
Los Angeles,92869,35502,930,1017,933,2880,0.08112219
Phoenix (Prescott),85378,9751,273,258,260,791,0.081119885
Oklahoma City,74647,3686,98,109,92,299,0.081117743
St. Louis,63129,52431,1389,1403,1461,4253,0.081116134
Minneapolis-St. Paul,56243,1578,50,40,38,128,0.081115336
San Francisco-Oak-San Jose,94401,34335,784,916,1085,2785,0.081112567
Omaha,68028,18949,768,471,298,1537,0.08111246
Dayton,45322,20429,532,591,534,1657,0.081110186
Tulsa,74011,33857,1091,798,857,2746,0.081105827
Tyler-Longview(Lfkn&Ncgd),75771,24092,745,654,555,1954,0.081105761
San Diego,92117,50391,937,1247,1903,4087,0.081105753
Indianapolis,47954,2355,69,63,59,191,0.081104034
Buffalo,14066,1196,39,28,30,97,0.081103679
Wheeling-Steubenville,43901,1603,48,38,44,130,0.081097941
Milwaukee,53086,9310,304,258,193,755,0.081095596
Odessa-Midland,79720,32863,1007,835,823,2665,0.08109424
Toledo,43542,4501,167,116,82,365,0.08109309
Binghamton,13744,740,24,18,18,60,0.081081081
Johnstown-Altoona-St Colge,16638,37,1,1,1,3,0.081081081
Harrisburg-Lncstr-Leb-York,17246,37,1,1,1,3,0.081081081
Bluefield-Beckley-Oak Hill,24943,37,1,1,1,3,0.081081081
Charlotte,28672,37,1,1,1,3,0.081081081
Mobile-Pensacola (Ft Walt),36451,4144,106,119,111,336,0.081081081
"Jackson, TN",38387,333,9,10,8,27,0.081081081
"Jackson, MS",39668,592,18,13,17,48,0.081081081
Toledo,44802,888,31,22,19,72,0.081081081
Louisville,47454,7548,221,197,194,612,0.081081081
Minneapolis-St. Paul,56263,481,18,8,13,39,0.081081081
Sioux Falls(Mitchell),57271,222,8,6,4,18,0.081081081
Sioux Falls(Mitchell),57630,37,1,1,1,3,0.081081081
Billings,59076,37,1,1,1,3,0.081081081
Paducah-Cape Girard-Harsbg,62836,740,27,18,15,60,0.081081081
Joplin-Pittsburg,64783,740,25,20,15,60,0.081081081
Joplin-Pittsburg,66769,444,17,11,8,36,0.081081081
Wichita-Hutchinson Plus,67743,148,6,3,3,12,0.081081081
Lincoln & Hastings-Krny,68881,37,1,1,1,3,0.081081081
Boise,83677,74,3,1,2,6,0.081081081
Mobile-Pensacola (Ft Walt),36421,9596,288,270,220,778,0.081075448
Panama City,32404,43688,1225,1149,1168,3542,0.081074895
Cedar Rapids-Wtrlo-IWC&Dub,52411,8671,319,243,141,703,0.081074847
Cincinnati,47041,6414,199,162,159,520,0.081072654
New York,7401,6772,225,193,131,549,0.081069108
Chattanooga,37322,8906,275,230,217,722,0.081068942
Buffalo,14105,4305,130,109,110,349,0.081068525
Greenwood-Greenville,38774,1986,61,49,51,161,0.081067472
New York,11762,22537,633,629,565,1827,0.08106669
Omaha,51575,1801,65,47,34,146,0.081066074
Philadelphia,19040,22932,574,600,685,1859,0.08106576
Topeka,66434,4774,166,122,99,387,0.081064097
Atlanta,30656,18566,552,467,486,1505,0.081062157
Roanoke-Lynchburg,24072,1394,41,34,38,113,0.081061693
Flint-Saginaw-Bay City,48417,2751,87,67,69,223,0.081061432
Philadelphia,18106,7513,238,205,166,609,0.081059497
Chattanooga,35752,2048,58,56,52,166,0.081054688
Erie,16131,950,32,19,26,77,0.081052632
Des Moines-Ames,50226,7119,282,173,122,577,0.081050709
Lake Charles,70630,1752,54,49,39,142,0.081050228
Chicago,60008,22147,599,578,618,1795,0.081049352
Sioux City,51019,765,32,20,10,62,0.081045752
New Orleans,70032,5170,136,136,147,419,0.081044487
Savannah,29918,3850,121,99,92,312,0.081038961
Birmingham (Ann and Tusc),35907,9329,265,237,254,756,0.081037625
Minneapolis-St. Paul,54725,2937,96,69,73,238,0.08103507
Wilkes Barre-Scranton-Hztn,18634,13994,349,380,405,1134,0.081034729
Spokane,83832,1740,60,42,39,141,0.081034483
Salt Lake City,84098,21966,746,636,398,1780,0.081034326
Philadelphia,19335,55915,1829,1488,1214,4531,0.081033712
Nashville,37171,1123,35,30,26,91,0.081032947
"Tri-Cities, TN-VA",24614,6985,191,194,181,566,0.08103078
Hartford & New Haven,6095,29816,774,847,795,2416,0.081030319
Norfolk-Portsmth-Newpt Nws,23359,1049,36,23,26,85,0.081029552
Grand Rapids-Kalmzoo-B.Crk,49325,2061,60,58,49,167,0.081028627
Davenport-R.Island-Moline,52060,8565,251,216,227,694,0.081027437
Shreveport,75559,5529,166,153,129,448,0.081027311
Dallas-Ft. Worth,75495,12096,415,306,259,980,0.081018519
Tampa-St. Pete (Sarasota),33813,38732,1242,1042,854,3138,0.081018279
San Antonio,78005,827,25,23,19,67,0.081015719
Charleston-Huntington,26610,1185,37,32,27,96,0.081012658
Los Angeles,90717,22182,540,584,673,1797,0.081011631
"Tri-Cities, TN-VA",24243,1938,56,57,44,157,0.081011352
Cleveland-Akron (Canton),44826,1469,46,36,37,119,0.081007488
Boston (Manchester),3465,2185,58,57,62,177,0.081006865
Nashville,37187,7629,229,194,195,618,0.081006685
Flint-Saginaw-Bay City,48857,2543,69,66,71,206,0.081006685
New York,7871,21184,676,581,459,1716,0.081004532
Monroe-El Dorado,71266,1395,46,37,30,113,0.081003584
Jacksonville,32091,17061,494,448,440,1382,0.081003458
Orlando-Daytona Bch-Melbrn,32905,26394,570,778,790,2138,0.081003258
Chicago,46322,23456,596,598,706,1900,0.081002729
Columbia-Jefferson City,65259,2642,77,63,74,214,0.080999243
Austin,78602,40865,1204,1058,1048,3310,0.080998409
Ft. Wayne,46783,7494,247,191,169,607,0.080998132
Nashville,38451,5494,180,135,130,445,0.080997452
Paducah-Cape Girard-Harsbg,63943,1605,46,48,36,130,0.080996885
Flint-Saginaw-Bay City,48637,3494,109,93,81,283,0.080995993
Kansas City,64081,26730,838,735,592,2165,0.080995137
Burlington-Plattsburgh,12966,3099,103,79,69,251,0.080993869
Wheeling-Steubenville,26033,2457,72,70,57,199,0.080993081
Minneapolis-St. Paul,55123,26336,779,664,690,2133,0.080991798
Miami-Ft. Lauderdale,33441,28151,598,756,926,2280,0.080991794
Minneapolis-St. Paul,55372,37251,1277,1013,727,3017,0.080991114
Columbus-Tupelo-West Point,38870,2630,79,69,65,213,0.080988593
New York,7005,16089,439,421,443,1303,0.08098701
Richmond-Petersburg,23879,568,15,15,16,46,0.080985915
Kansas City,65344,284,9,8,6,23,0.080985915
Baltimore,21651,2766,89,69,66,224,0.080983369
Charleston-Huntington,25387,5248,168,144,113,425,0.080983232
Fresno-Visalia,93204,13892,458,360,307,1125,0.08098186
Buffalo,14103,10595,287,277,294,858,0.080981595
Jacksonville,32055,17103,513,435,437,1385,0.080979945
Dothan,36344,5841,173,158,142,473,0.080979284
St. Louis,63034,18116,526,477,464,1467,0.080978141
Kansas City,66083,12843,437,314,289,1040,0.080977965
Philadelphia,8059,5730,140,148,176,464,0.080977312
"Rochester, NY",14548,4137,105,110,120,335,0.080976553
Birmingham (Ann and Tusc),35063,3359,85,90,97,272,0.080976481
New York,7701,24254,680,687,597,1964,0.080976334
Abilene-Sweetwater,79508,1519,60,37,26,123,0.080974325
Augusta-Aiken,29842,9077,271,224,240,735,0.08097389
Philadelphia,8054,46373,1226,1252,1277,3755,0.080973843
Sherman-Ada,75414,3952,134,99,87,320,0.08097166
"Portland, OR",98601,3458,117,95,68,280,0.08097166
Pittsburgh,15226,13548,281,344,472,1097,0.080971361
Ft. Smith-Fay-Sprngdl-Rgrs,72958,6867,214,160,182,556,0.080966943
Knoxville,37754,4928,148,134,117,399,0.080965909
Wichita Falls & Lawton,76374,3940,118,100,101,319,0.080964467
Des Moines-Ames,50532,914,30,21,23,74,0.080962801
Chicago,60565,39500,1276,1074,848,3198,0.080962025
Grand Rapids-Kalmzoo-B.Crk,48881,5299,162,138,129,429,0.080958671
Paducah-Cape Girard-Harsbg,38080,2421,79,60,57,196,0.080958282
Baltimore,21617,10759,318,312,241,871,0.080955479
Cleveland-Akron (Canton),44122,35810,1069,965,865,2899,0.08095504
"Tri-Cities, TN-VA",37809,1927,51,57,48,156,0.080954852
Reno,96150,28584,668,783,863,2314,0.08095438
Evansville,42369,420,12,12,10,34,0.080952381
South Bend-Elkhart,46530,33600,1126,869,725,2720,0.080952381
New Orleans,70352,210,7,5,5,17,0.080952381
Oklahoma City,73048,1890,63,49,41,153,0.080952381
Kansas City,64644,2903,88,68,79,235,0.080950741
Rochestr-Mason City-Austin,50468,1433,47,38,31,116,0.080949058
"Tri-Cities, TN-VA",37664,29723,804,798,804,2406,0.080947414
Phoenix (Prescott),86314,41385,1138,1097,1115,3350,0.080947203
Odessa-Midland,79772,12292,382,328,285,995,0.080946957
"Jackson, TN",38379,1396,44,34,35,113,0.080945559
Kansas City,64060,16320,539,418,364,1321,0.080943627
New Orleans,70373,6375,199,145,172,516,0.080941176
Los Angeles,92630,67605,1723,1772,1977,5472,0.080940759
Evansville,62878,383,10,9,12,31,0.080939948
Dayton,45311,6474,210,172,142,524,0.080939141
Nashville,37190,9328,253,245,257,755,0.080939108
Eureka,95503,24253,699,625,639,1963,0.080938441
St. Louis,62241,939,22,31,23,76,0.080937167
Paducah-Cape Girard-Harsbg,63870,939,29,25,22,76,0.080937167
Knoxville,38583,26317,774,685,671,2130,0.080936277
New York,11758,52203,1362,1471,1392,4225,0.080934046
Flint-Saginaw-Bay City,48429,8822,233,255,226,714,0.080934029
Philadelphia,8098,9131,273,242,224,739,0.080933085
Montgomery-Selma,36783,729,19,17,23,59,0.080932785
Charleston-Huntington,25045,4683,149,124,106,379,0.080931027
"Columbus, OH",43783,4856,139,138,116,393,0.080930807
Mobile-Pensacola (Ft Walt),36505,1421,40,40,35,115,0.080928923
Davenport-R.Island-Moline,61418,519,10,17,15,42,0.080924855
Atlanta,30068,35540,1218,979,679,2876,0.080922904
Waco-Temple-Bryan,76577,3485,103,108,71,282,0.080918221
Greensboro-H.Point-W.Salem,27298,10591,302,314,241,857,0.08091776
Harrisburg-Lncstr-Leb-York,17086,2311,64,61,62,187,0.080917352
Greenvll-Spart-Ashevll-And,29645,10789,306,280,287,873,0.080915748
Green Bay-Appleton,54416,1619,52,43,36,131,0.080914145
Buffalo,14733,3547,112,79,96,287,0.080913448
Charlottesville,22943,482,14,11,14,39,0.080912863
Minneapolis-St. Paul,55388,6093,193,150,150,493,0.080912523
Lexington,40383,24953,766,671,582,2019,0.080912115
Dayton,45345,6056,167,151,172,490,0.080911493
Boston (Manchester),3281,9208,279,237,229,745,0.080907906
Minneapolis-St. Paul,55373,6217,208,165,130,503,0.08090719
New York,12725,309,5,11,9,25,0.080906149
Tucson (Sierra Vista),85641,31889,1177,821,582,2580,0.080905641
Chicago,60134,28911,1001,790,548,2339,0.080903462
Indianapolis,47995,1644,50,42,41,133,0.080900243
Nashville,38569,445,15,11,10,36,0.080898876
Dallas-Ft. Worth,75433,3115,96,84,72,252,0.080898876
Minneapolis-St. Paul,56367,6947,237,178,147,562,0.080898229
Toledo,43316,5748,172,149,144,465,0.080897704
Orlando-Daytona Bch-Melbrn,32145,6564,202,172,157,531,0.080895795
Tulsa,74833,581,18,14,15,47,0.080895009
Monroe-El Dorado,71263,7244,220,200,166,586,0.080894533
Augusta-Aiken,29137,2596,76,69,65,210,0.080893683
Macon,30457,5971,171,168,144,483,0.080890973
Denver,80103,2831,96,68,65,229,0.080890145
South Bend-Elkhart,46552,6602,221,165,148,534,0.08088458
"Bend, OR",97702,55339,1582,1479,1415,4476,0.080883283
Cedar Rapids-Wtrlo-IWC&Dub,52345,1496,56,40,25,121,0.080882353
Tampa-St. Pete (Sarasota),33815,15566,455,409,395,1259,0.080881408
Philadelphia,8322,10089,293,269,254,816,0.080880167
"Portland, OR",97348,1595,50,41,38,129,0.080877743
Seattle-Tacoma,98075,26361,1067,662,403,2132,0.080877053
Dallas-Ft. Worth,75436,2102,62,51,57,170,0.080875357
Seattle-Tacoma,98199,22875,458,576,816,1850,0.080874317
Wilkes Barre-Scranton-Hztn,18250,3116,94,83,75,252,0.080872914
Monroe-El Dorado,71227,4130,133,103,98,334,0.080871671
"Springfield, MO",65674,2708,104,69,46,219,0.080871492
Waco-Temple-Bryan,76712,30382,829,841,787,2457,0.080870252
Binghamton,13040,2671,87,61,68,216,0.080868589
Charleston-Huntington,45631,13924,386,371,369,1126,0.080867567
Philadelphia,8318,11995,351,306,313,970,0.080867028
Paducah-Cape Girard-Harsbg,42450,3846,111,108,92,311,0.080863235
Des Moines-Ames,50262,371,13,9,8,30,0.080862534
Peoria-Bloomington,61501,1484,35,42,43,120,0.080862534
"Columbus, GA (Opelika, AL)",31825,2090,60,55,54,169,0.080861244
Utica,13367,8966,266,246,213,725,0.080861031
Hartford & New Haven,6084,14346,432,397,331,1160,0.080858776
Norfolk-Portsmth-Newpt Nws,23664,9968,260,266,280,806,0.080858748
Chicago,60712,14074,389,414,335,1138,0.08085832
Dayton,45326,1212,38,34,26,98,0.080858086
Burlington-Plattsburgh,5641,17043,408,509,461,1378,0.08085431
Houston,77363,4403,125,118,113,356,0.080853963
Birmingham (Ann and Tusc),35224,5207,142,141,138,421,0.080852698
Terre Haute,47974,1175,37,30,28,95,0.080851064
Fargo,56710,470,16,10,12,38,0.080851064
"Washington, DC (Hagrstwn)",20186,15436,447,423,378,1248,0.080849961
Denver,69162,7248,210,206,170,586,0.08084989
Wichita-Hutchinson Plus,67502,23551,725,629,550,1904,0.080845824
Huntsville-Decatur (Flor),35652,8609,224,224,248,696,0.080845627
Cleveland-Akron (Canton),44813,8337,263,209,202,674,0.080844428
Watertown,13667,2845,89,68,73,230,0.080843585
Richmond-Petersburg,23960,1806,54,42,50,146,0.080841639
Paducah-Cape Girard-Harsbg,42087,2239,64,58,59,181,0.080839661
Philadelphia,18062,25928,826,666,604,2096,0.080839247
Sherman-Ada,74759,1002,29,28,24,81,0.080838323
Albany-Schenectady-Troy,12148,4973,160,137,105,402,0.080836517
Flint-Saginaw-Bay City,48889,1435,45,38,33,116,0.080836237
Burlington-Plattsburgh,12914,767,26,19,17,62,0.08083442
"Tri-Cities, TN-VA",37642,15056,416,428,373,1217,0.080831562
"Tri-Cities, TN-VA",24272,433,13,12,10,35,0.080831409
Oklahoma City,73628,1299,52,33,20,105,0.080831409
Cleveland-Akron (Canton),44124,40060,987,1056,1195,3238,0.080828757
Milwaukee,53089,20228,666,547,422,1635,0.080828554
New York,7847,1497,40,42,39,121,0.080828323
Lansing,48854,18991,573,503,459,1535,0.080827761
Little Rock-Pine Bluff,71913,48264,1331,1254,1316,3901,0.080826289
Louisville,47163,1794,56,46,43,145,0.080824972
Buffalo,14072,21689,611,558,584,1753,0.080824381
Evansville,47546,22469,607,579,630,1816,0.080822467
"Columbia, SC",29138,9899,316,252,232,800,0.080816244
Peoria-Bloomington,62664,2549,79,65,62,206,0.080816006
Portland-Auburn,4281,5395,160,151,125,436,0.08081557
Dallas-Ft. Worth,76667,10654,327,260,274,861,0.080814717
Denver,80648,1522,53,38,32,123,0.080814717
Austin,78611,16334,471,409,440,1320,0.080813028
Indianapolis,47355,2611,76,63,72,211,0.080811949
Columbus-Tupelo-West Point,39746,2908,103,67,65,235,0.080811554
San Francisco-Oak-San Jose,94558,63494,1771,1737,1623,5131,0.080810785
Little Rock-Pine Bluff,72212,12486,368,331,310,1009,0.080810508
Boston (Manchester),2465,12783,413,346,274,1033,0.080810451
"Tri-Cities, TN-VA",24271,2376,75,65,52,192,0.080808081
Charleston-Huntington,25231,99,3,3,2,8,0.080808081
Rochestr-Mason City-Austin,55933,297,10,7,7,24,0.080808081
Dayton,45383,6757,209,166,171,546,0.080805091
Harrisburg-Lncstr-Leb-York,17368,7970,212,198,234,644,0.080803011
Monroe-El Dorado,71277,1547,47,44,34,125,0.080801551
Knoxville,37329,5495,158,151,135,444,0.080800728
New York,7677,5953,202,167,112,481,0.080799597
Boston (Manchester),1516,9468,264,251,250,765,0.080798479
Wichita-Hutchinson Plus,67525,953,25,28,24,77,0.080797482
Grand Rapids-Kalmzoo-B.Crk,49315,27625,937,693,602,2232,0.08079638
Boston (Manchester),2131,28999,663,719,961,2343,0.08079589
"Springfield, MO",65640,755,25,20,16,61,0.080794702
Atlanta,30259,3738,109,97,96,302,0.080791867
"Columbia, SC",29069,4555,122,140,106,368,0.08079034
Philadelphia,8029,4815,125,120,144,389,0.0807892
Wausau-Rhinelander,54474,4258,127,111,106,344,0.080789103
"Rochester, NY",14544,2030,60,56,48,164,0.080788177
Boston (Manchester),3110,24311,912,652,400,1964,0.080786475
Bluefield-Beckley-Oak Hill,24981,458,13,10,14,37,0.080786026
Bismarck-Mnt-Dcknsn(Wlstn),58845,458,15,9,13,37,0.080786026
Tallahassee-Thomasville,32053,3924,150,99,68,317,0.080784913
Charleston-Huntington,25537,1275,32,32,39,103,0.080784314
Buffalo,14770,2513,73,67,63,203,0.080779944
Pittsburgh,15122,18792,451,497,570,1518,0.080779055
Detroit,48133,5546,164,156,128,448,0.08077894
New York,8551,5410,167,145,125,437,0.08077634
Boston (Manchester),1719,5472,144,124,174,442,0.080774854
New York,10282,8728,149,207,349,705,0.080774519
Kansas City,64444,1498,51,34,36,121,0.080774366
Evansville,42348,4754,144,132,108,384,0.080774085
Philadelphia,19507,3677,124,95,78,297,0.080772369
Minneapolis-St. Paul,56531,2179,72,61,43,176,0.080770996
Charleston-Huntington,41559,260,7,6,8,21,0.080769231
Bismarck-Mnt-Dcknsn(Wlstn),58771,520,18,13,11,42,0.080769231
Spokane,99032,780,23,24,16,63,0.080769231
New York,7090,30841,1052,853,586,2491,0.080769106
Hattiesburg-Laurel,39474,6104,176,167,150,493,0.08076671
Detroit,48313,33852,862,879,993,2734,0.080763323
New Orleans,70353,1102,36,30,23,89,0.08076225
Charlotte,28645,45579,1269,1265,1147,3681,0.080760877
Cedar Rapids-Wtrlo-IWC&Dub,52772,5052,172,142,94,408,0.080760095
New York,11901,30375,817,799,837,2453,0.080757202
Nashville,37025,7108,204,177,193,574,0.08075408
Raleigh-Durham (Fayetvlle),27864,4198,125,114,100,339,0.080752739
Bismarck-Mnt-Dcknsn(Wlstn),58718,1065,41,23,22,86,0.080751174
Detroit,49270,5808,168,151,150,469,0.080750689
Wichita-Hutchinson Plus,67013,2774,86,73,65,224,0.08074982
New York,8872,20125,552,509,564,1625,0.080745342
Roanoke-Lynchburg,24534,1449,43,41,33,117,0.080745342
Detroit,48727,1127,38,30,23,91,0.080745342
Houston,78943,322,10,8,8,26,0.080745342
"Albany, GA",39837,5536,166,143,138,447,0.08074422
Wausau-Rhinelander,54455,19024,548,508,480,1536,0.080740118
Omaha,68048,13463,420,347,320,1087,0.080739805
South Bend-Elkhart,46510,3629,112,88,93,293,0.080738495
Minneapolis-St. Paul,55304,50410,1704,1389,977,4070,0.080737949
Charlotte,28636,4992,137,140,126,403,0.080729167
Minneapolis-St. Paul,56231,384,13,11,7,31,0.080729167
Shreveport,71860,1920,45,52,58,155,0.080729167
New York,11518,10975,322,283,281,886,0.080728929
Tyler-Longview(Lfkn&Ncgd),75969,4286,120,117,109,346,0.080727951
New York,7059,16723,486,499,365,1350,0.080727142
Grand Rapids-Kalmzoo-B.Crk,49098,5723,179,150,133,462,0.080726891
Hartford & New Haven,6107,19251,559,488,507,1554,0.080723079
Boston (Manchester),1569,14717,407,396,385,1188,0.080722973
Minneapolis-St. Paul,55305,21444,399,504,828,1731,0.08072188
New York,7830,6541,201,175,152,528,0.080721602
"Albany, GA",31789,1561,44,41,41,126,0.080717489
Champaign&Sprngfld-Decatur,62682,669,21,19,14,54,0.080717489
Shreveport,71429,3023,99,86,59,244,0.080714522
Greensboro-H.Point-W.Salem,28621,10048,281,264,266,811,0.08071258
"Tri-Cities, TN-VA",41838,508,14,12,15,41,0.080708661
Louisville,47115,2540,76,67,62,205,0.080708661
Buffalo,14075,43962,1169,1172,1207,3548,0.080706064
South Bend-Elkhart,46975,14336,427,359,371,1157,0.080705915
Harrisonburg,22843,2441,71,64,62,197,0.080704629
Flint-Saginaw-Bay City,48701,1425,39,36,40,115,0.080701754
Lansing,49274,3990,122,109,91,322,0.080701754
Charlotte,28120,26406,749,711,671,2131,0.080701356
Kansas City,64078,10000,302,271,234,807,0.0807
Chicago,61350,23668,660,616,634,1910,0.080699679
Memphis,38685,1202,39,29,29,97,0.080698835
Tulsa,74428,1202,43,29,25,97,0.080698835
Mobile-Pensacola (Ft Walt),36524,979,31,25,23,79,0.080694586
Quincy-Hannibal-Keokuk,63460,347,11,10,7,28,0.080691643
Seattle-Tacoma,98294,8911,258,229,232,719,0.080686792
Ottumwa-Kirksville,52542,409,11,11,11,33,0.080684597
San Antonio,78124,6792,194,190,164,548,0.080683157
Seattle-Tacoma,98272,31085,865,796,847,2508,0.080682001
Huntsville-Decatur (Flor),35754,5020,170,126,109,405,0.080677291
Baltimore,21128,13610,440,359,299,1098,0.080675974
Los Angeles,90248,11181,262,291,349,902,0.08067257
Nashville,38579,1190,38,25,33,96,0.080672269
Lansing,49269,6074,189,164,137,490,0.080671716
Miami-Ft. Lauderdale,33141,35316,656,948,1245,2849,0.08067165
Norfolk-Portsmth-Newpt Nws,27965,657,20,20,13,53,0.080669711
Des Moines-Ames,50164,657,23,18,12,53,0.080669711
Dallas-Ft. Worth,76043,7475,264,189,150,603,0.080668896
Binghamton,13736,2343,76,59,54,189,0.080665813
Quincy-Hannibal-Keokuk,62339,781,27,19,17,63,0.080665813
New York,10597,905,33,26,14,73,0.080662983
Des Moines-Ames,50107,905,27,24,22,73,0.080662983
Norfolk-Portsmth-Newpt Nws,23306,1029,29,25,29,83,0.080660836
Minneapolis-St. Paul,55019,2244,79,58,44,181,0.080659537
Madison,53536,9100,305,233,196,734,0.080659341
Charleston-Huntington,25159,5381,162,141,131,434,0.080654154
Evansville,42464,1897,63,45,45,153,0.080653664
Johnstown-Altoona-St Colge,15906,9857,291,236,268,795,0.080653343
Philadelphia,18944,27440,829,749,635,2213,0.080648688
Cleveland-Akron (Canton),44139,25171,850,722,458,2030,0.080648365
Evansville,42347,6051,164,161,163,488,0.080647827
New York,11251,62,1,2,2,5,0.080645161
Syracuse,13164,2418,75,64,56,195,0.080645161
Tampa-St. Pete (Sarasota),34237,17360,350,511,539,1400,0.080645161
"Tri-Cities, TN-VA",40979,124,4,4,2,10,0.080645161
Louisville,42742,62,2,1,2,5,0.080645161
Davenport-R.Island-Moline,52737,372,12,11,7,30,0.080645161
Terre Haute,62481,372,9,10,11,30,0.080645161
Topeka,66857,806,24,24,17,65,0.080645161
Wichita-Hutchinson Plus,66862,124,4,3,3,10,0.080645161
Monroe-El Dorado,71316,62,2,2,1,5,0.080645161
Houston,77468,124,4,3,3,10,0.080645161
Medford-Klamath Falls,97625,248,9,6,5,20,0.080645161
Boston (Manchester),2478,26549,868,703,570,2141,0.080643339
Milwaukee,53559,6275,190,176,140,506,0.08063745
New York,7095,22025,524,564,688,1776,0.080635641
Macon,31057,1575,34,41,52,127,0.080634921
Chicago,60552,4316,133,105,110,348,0.080630213
Binghamton,13812,2096,60,51,58,169,0.080629771
Dayton,45347,4192,118,121,99,338,0.080629771
Salisbury,21850,2989,81,75,85,241,0.080628973
Pittsburgh,16066,33462,940,888,870,2698,0.080628773
Ft. Myers-Naples,33936,24868,707,664,634,2005,0.080625704
Charleston-Huntington,25177,22065,596,588,595,1779,0.080625425
Baltimore,21076,24521,550,603,824,1977,0.080624771
Wichita-Hutchinson Plus,67017,2245,79,58,44,181,0.080623608
Richmond-Petersburg,23970,8149,216,208,233,657,0.080623389
Denver,80487,18444,521,487,479,1487,0.080622425
Birmingham (Ann and Tusc),35480,2121,63,58,50,171,0.080622348
Atlanta,36269,1352,47,33,29,109,0.080621302
New York,7647,5036,150,147,109,406,0.080619539
Minneapolis-St. Paul,56630,2394,86,63,44,193,0.080618212
Orlando-Daytona Bch-Melbrn,32804,21137,445,549,710,1704,0.080616928
Huntsville-Decatur (Flor),35645,13707,436,325,344,1105,0.080615744
Pittsburgh,15223,7021,146,198,222,566,0.080615297
Chicago,60462,38517,1052,1037,1016,3105,0.080613755
Wilkes Barre-Scranton-Hztn,18355,1439,37,33,46,116,0.080611536
Dallas-Ft. Worth,76444,3734,115,100,86,301,0.080610605
Monroe-El Dorado,71373,7282,235,164,188,587,0.080609723
"Washington, DC (Hagrstwn)",20620,1712,48,43,47,138,0.080607477
Paducah-Cape Girard-Harsbg,62987,856,23,25,21,69,0.080607477
Mobile-Pensacola (Ft Walt),36518,2444,72,67,58,197,0.080605565
Charleston-Huntington,25019,397,16,10,6,32,0.080604534
Kansas City,65321,397,15,9,8,32,0.080604534
Greensboro-H.Point-W.Salem,27248,4181,112,113,112,337,0.080602727
Charlotte,27054,2531,66,65,73,204,0.080600553
Pittsburgh,15423,1799,48,50,47,145,0.080600334
Boston (Manchester),2779,6737,215,170,158,543,0.080599673
Evansville,42406,2742,94,71,56,221,0.080598104
Idaho Fals-Pocatllo(Jcksn),83244,335,12,9,6,27,0.080597015
Richmond-Petersburg,23150,12420,331,327,343,1001,0.080595813
South Bend-Elkhart,46507,9132,278,230,228,736,0.080595707
"Tri-Cities, TN-VA",40823,4169,125,101,110,336,0.080594867
New York,11714,23091,623,650,588,1861,0.080594171
Philadelphia,19333,7879,297,187,151,635,0.080593984
Johnstown-Altoona-St Colge,15827,273,8,7,7,22,0.080586081
Amarillo,79080,546,15,14,15,44,0.080586081
La Crosse-Eau Claire,54650,25005,727,619,669,2015,0.080583883
Paducah-Cape Girard-Harsbg,42445,10722,304,298,262,864,0.080581981
Tulsa,74080,2544,81,65,59,205,0.080581761
Dothan,36314,484,14,15,10,39,0.080578512
Rockford,61031,1452,41,40,36,117,0.080578512
Philadelphia,8055,29338,945,767,652,2364,0.08057809
Cincinnati,45458,36599,1138,964,847,2949,0.080575972
Albany-Schenectady-Troy,12205,26534,678,721,739,2138,0.080575865
Atlanta,30064,52573,1598,1392,1246,4236,0.080573679
Watertown,13368,1117,30,26,34,90,0.080572963
Detroit,48022,2656,72,75,67,214,0.080572289
Knoxville,37840,9532,260,254,254,768,0.080570709
Davenport-R.Island-Moline,52660,211,8,4,5,17,0.08056872
Wilkes Barre-Scranton-Hztn,18623,2470,69,62,68,199,0.080566802
Greensboro-H.Point-W.Salem,28676,3463,107,84,88,279,0.080565983
Paducah-Cape Girard-Harsbg,42086,4034,131,110,84,325,0.080565196
Des Moines-Ames,50069,1204,46,29,22,97,0.080564784
Pittsburgh,16020,1142,34,31,27,92,0.08056042
Sioux City,51433,571,13,14,19,46,0.08056042
Sioux Falls(Mitchell),57342,571,19,11,16,46,0.08056042
"Jackson, MS",39120,28662,766,793,750,2309,0.080559626
Columbia-Jefferson City,65013,3153,95,85,74,254,0.080558199
"Washington, DC (Hagrstwn)",20901,36657,1043,986,924,2953,0.080557602
Pittsburgh,26542,2942,88,70,79,237,0.080557444
Toledo,43571,7833,241,205,185,631,0.080556619
Baton Rouge,70393,360,11,11,7,29,0.080555556
Burlington-Plattsburgh,12959,1229,47,25,27,99,0.080553295
Des Moines-Ames,50273,8839,275,224,213,712,0.080552099
"Alexandria, LA",71409,5959,162,179,139,480,0.080550428
La Crosse-Eau Claire,54630,4072,124,106,98,328,0.080550098
St. Louis,62012,6766,199,167,179,545,0.080549808
Knoxville,37879,10118,261,253,301,815,0.080549516
Charleston-Huntington,25669,658,24,19,10,53,0.080547112
Monroe-El Dorado,71762,2123,71,51,49,171,0.080546397
Richmond-Petersburg,23040,4544,127,121,118,366,0.080545775
Grand Rapids-Kalmzoo-B.Crk,49042,4544,145,117,104,366,0.080545775
Indianapolis,46172,2297,75,54,56,185,0.080539835
Johnstown-Altoona-St Colge,16837,298,8,8,8,24,0.080536913
Traverse City-Cadillac,49657,3427,106,92,78,276,0.080536913
Cedar Rapids-Wtrlo-IWC&Dub,52354,298,9,7,8,24,0.080536913
Oklahoma City,74531,1043,33,26,25,84,0.080536913
Casper-Riverton,82512,298,9,9,6,24,0.080536913
Cedar Rapids-Wtrlo-IWC&Dub,52361,5004,168,127,108,403,0.080535572
Shreveport,71486,3750,119,86,97,302,0.080533333
Ft. Wayne,46745,1813,57,45,44,146,0.080529509
San Francisco-Oak-San Jose,95439,832,22,19,26,67,0.080528846
Johnstown-Altoona-St Colge,16646,2347,76,50,63,189,0.080528334
San Francisco-Oak-San Jose,95131,30139,613,772,1042,2427,0.080526892
Indianapolis,46236,27668,820,769,639,2228,0.08052624
New York,7311,3204,24,41,193,258,0.080524345
Des Moines-Ames,51440,385,11,9,11,31,0.080519481
Harrisonburg,22980,34079,921,895,928,2744,0.080518795
Oklahoma City,73020,25063,848,655,515,2018,0.080517097
"Washington, DC (Hagrstwn)",20622,4844,165,122,103,390,0.080511974
Sioux Falls(Mitchell),57058,2037,72,46,46,164,0.080510555
Denver,80538,52043,1376,1383,1431,4190,0.080510347
Charleston-Huntington,25033,2273,73,62,48,183,0.080510339
Chicago,60520,2745,83,74,64,221,0.080510018
Louisville,40150,4397,136,112,106,354,0.080509438
Burlington-Plattsburgh,5653,472,15,10,13,38,0.080508475
"Columbus, GA (Opelika, AL)",39877,472,12,14,12,38,0.080508475
"Columbus, OH",43983,472,13,13,12,38,0.080508475
Davenport-R.Island-Moline,61430,708,20,17,20,57,0.080508475
Little Rock-Pine Bluff,71972,236,8,7,4,19,0.080508475
Indianapolis,47232,2683,82,71,63,216,0.080506895
Cleveland-Akron (Canton),44842,5540,165,141,140,446,0.080505415
Flint-Saginaw-Bay City,48613,1031,30,28,25,83,0.080504365
Seattle-Tacoma,98258,56072,1839,1391,1284,4514,0.080503638
South Bend-Elkhart,46570,1118,38,27,25,90,0.080500894
Columbia-Jefferson City,65237,882,23,28,20,71,0.080498866
Chicago,60477,35628,821,948,1099,2868,0.080498484
Detroit,48032,2174,80,52,43,175,0.08049678
Evansville,47665,3789,130,88,87,305,0.080496173
"Washington, DC (Hagrstwn)",21795,9603,295,232,246,773,0.080495678
Rochestr-Mason City-Austin,50457,323,8,9,9,26,0.080495356
Boston (Manchester),3109,11119,282,289,324,895,0.08049285
Philadelphia,19047,38165,1042,1069,961,3072,0.080492598
Billings,82426,2522,89,49,65,203,0.080491673
Syracuse,13476,3019,74,83,86,243,0.080490229
Miami-Ft. Lauderdale,33063,55162,1323,1498,1619,4440,0.080490193
Greensboro-H.Point-W.Salem,27011,5305,143,134,150,427,0.080490104
"Rochester, NY",14510,4920,136,125,135,396,0.080487805
Roanoke-Lynchburg,24151,18786,551,477,484,1512,0.080485468
San Antonio,78039,1578,48,42,37,127,0.080481622
Pittsburgh,15137,9928,265,266,268,799,0.080479452
Ft. Wayne,46770,2920,90,71,74,235,0.080479452
Topeka,66093,584,16,16,15,47,0.080479452
"Springfield, MO",65633,4113,129,109,93,331,0.080476538
Detroit,48363,7717,272,202,147,621,0.080471686
"Washington, DC (Hagrstwn)",22847,1019,34,28,20,82,0.08047105
Shreveport,75560,1106,32,35,22,89,0.080470163
Boston (Manchester),2346,23985,657,640,633,1930,0.080466959
Dayton,45368,4934,151,125,121,397,0.0804621
Wilmington,28411,40467,1129,1050,1077,3256,0.080460622
Wilkes Barre-Scranton-Hztn,18845,348,10,8,10,28,0.08045977
Philadelphia,18925,6699,248,172,119,539,0.08045977
Norfolk-Portsmth-Newpt Nws,23418,1218,35,32,31,98,0.08045977
Roanoke-Lynchburg,23976,174,5,3,6,14,0.08045977
Roanoke-Lynchburg,24086,174,4,5,5,14,0.08045977
Knoxville,37848,261,8,6,7,21,0.08045977
Lexington,41859,261,10,6,5,21,0.08045977
Toledo,43518,2610,90,70,50,210,0.08045977
Louisville,47125,1740,51,38,51,140,0.08045977
Des Moines-Ames,50854,2175,67,48,60,175,0.08045977
Omaha,51648,174,6,4,4,14,0.08045977
Sioux Falls(Mitchell),56147,174,5,5,4,14,0.08045977
Terre Haute,62434,348,11,10,7,28,0.08045977
Shreveport,71069,522,20,14,8,42,0.08045977
Amarillo,73933,1479,46,38,35,119,0.08045977
San Antonio,78614,435,14,12,9,35,0.08045977
Lubbock,79373,3045,101,85,59,245,0.08045977
Minneapolis-St. Paul,56143,4375,127,114,111,352,0.080457143
Dallas-Ft. Worth,76233,4400,134,114,106,354,0.080454545
Cleveland-Akron (Canton),44622,18632,529,484,486,1499,0.080452984
New York,8857,40359,1006,1055,1186,3247,0.080452935
Sacramnto-Stkton-Modesto,95630,89618,2862,2376,1972,7210,0.080452588
Birmingham (Ann and Tusc),35151,7222,223,177,181,581,0.080448629
Dayton,45334,1877,58,50,43,151,0.080447523
Charleston-Huntington,45772,1877,49,59,43,151,0.080447523
Lubbock,79312,895,35,21,16,72,0.080446927
Memphis,38641,2511,76,62,64,202,0.080446037
Jacksonville,31550,808,20,19,26,65,0.080445545
Tulsa,74020,7757,236,206,182,624,0.08044347
Albany-Schenectady-Troy,12054,17329,523,471,400,1394,0.080443188
Chicago,60175,25571,884,718,455,2057,0.080442689
Phoenix (Prescott),85344,9970,310,255,237,802,0.080441324
New York,11558,9336,222,273,256,751,0.080441302
Chicago,60935,1181,38,32,25,95,0.080440305
Lexington,40486,2275,73,56,54,183,0.08043956
Charleston-Huntington,25268,547,18,14,12,44,0.080438757
Cleveland-Akron (Canton),44090,11450,322,297,302,921,0.080436681
Chicago,60958,1467,43,39,36,118,0.080436264
Champaign&Sprngfld-Decatur,61816,460,12,14,11,37,0.080434783
Sioux City,57025,3245,119,73,69,261,0.080431433
Louisville,40299,43665,1174,1144,1194,3512,0.080430551
Kansas City,64679,746,18,18,24,60,0.080428954
Nashville,42202,2151,68,54,51,173,0.080427708
Charlotte,29720,56697,1685,1438,1437,4560,0.080427536
Rockford,61064,3556,102,93,91,286,0.080427447
"Rochester, NY",14517,2437,62,64,70,196,0.080426754
St. Louis,62881,10519,312,270,264,846,0.080425896
Joplin-Pittsburg,65772,1977,62,54,43,159,0.080424886
Toledo,43533,1517,48,39,35,122,0.080421885
Oklahoma City,73089,13591,458,376,259,1093,0.080420867
Flint-Saginaw-Bay City,48433,26859,789,710,661,2160,0.080419971
"Albany, GA",31778,2574,80,58,69,207,0.08041958
Chattanooga,37387,4290,125,111,109,345,0.08041958
Miami-Ft. Lauderdale,33158,6205,196,177,126,499,0.080419017
Grand Rapids-Kalmzoo-B.Crk,49460,9550,297,243,228,768,0.080418848
Atlanta,30663,3370,103,95,73,271,0.08041543
Mankato,56055,3880,136,98,78,312,0.080412371
Spokane,99212,22908,596,586,660,1842,0.080408591
Cincinnati,41033,1567,44,38,44,126,0.080408424
New York,11756,41863,1110,1111,1145,3366,0.080405131
Birmingham (Ann and Tusc),35549,3669,98,97,100,295,0.08040338
Atlanta,30285,597,17,13,18,48,0.08040201
Lexington,41836,796,27,23,14,64,0.08040201
Little Rock-Pine Bluff,71929,4888,148,127,118,393,0.080400982
Buffalo,14111,2898,72,85,76,233,0.080400276
Kansas City,66071,13010,426,333,287,1046,0.080399693
Cleveland-Akron (Canton),44859,1704,59,45,33,137,0.080399061
Louisville,40241,31756,846,823,884,2553,0.080394256
"Rochester, NY",14546,4677,120,117,139,376,0.080393415
Denver,80127,46571,1458,1246,1040,3744,0.080393378
"Portland, OR",97222,37180,800,943,1246,2989,0.080392684
Lexington,41352,510,15,14,12,41,0.080392157
Boston (Manchester),2032,4926,139,120,137,396,0.080389769
"Washington, DC (Hagrstwn)",22551,24519,715,660,596,1971,0.080386639
New York,7646,16682,387,466,488,1341,0.080386045
Des Moines-Ames,50027,311,12,6,7,25,0.080385852
Denver,81416,14207,440,374,328,1142,0.08038291
"Washington, DC (Hagrstwn)",25403,17877,555,434,448,1437,0.080382615
Terre Haute,47874,3073,89,80,78,247,0.080377481
San Francisco-Oak-San Jose,94501,66338,1598,1794,1940,5332,0.080376255
Denver,80026,34414,931,901,934,2766,0.080374266
Louisville,40056,3745,131,101,69,301,0.080373832
Wichita Falls & Lawton,73543,1717,49,52,37,138,0.080372743
Chicago,60467,25370,730,682,627,2039,0.080370516
Indianapolis,46062,44022,1422,1100,1016,3538,0.080368906
New York,11572,30858,846,825,809,2480,0.080368138
Baton Rouge,70818,10987,335,294,254,883,0.080367707
Philadelphia,19809,14496,352,389,424,1165,0.080366998
Wilkes Barre-Scranton-Hztn,17751,7416,210,202,184,596,0.080366775
Burlington-Plattsburgh,12983,6794,161,173,212,546,0.080365028
Lansing,48819,2638,82,71,59,212,0.080363912
Oklahoma City,73645,1319,39,40,27,106,0.080363912
"Charleston, SC",29466,42420,1522,1140,747,3409,0.080363036
Philadelphia,19512,17533,520,427,462,1409,0.080362745
St. Louis,63147,8163,218,226,212,656,0.080362612
Des Moines-Ames,50070,1655,59,44,30,133,0.080362538
Philadelphia,19319,112,4,3,2,9,0.080357143
Lexington,40995,112,4,3,2,9,0.080357143
St. Louis,62824,1680,57,41,37,135,0.080357143
Lincoln & Hastings-Krny,68861,112,4,3,2,9,0.080357143
Oklahoma City,73444,112,3,3,3,9,0.080357143
Sherman-Ada,73453,784,22,22,19,63,0.080357143
Lexington,41039,2937,85,78,73,236,0.080354103
Dallas-Ft. Worth,76679,1705,48,47,42,137,0.080351906
Harrisburg-Lncstr-Leb-York,17350,13553,430,325,334,1089,0.080351214
San Francisco-Oak-San Jose,95051,63795,1276,1574,2276,5126,0.080351125
"Columbus, OH",45786,2962,90,80,68,238,0.080351114
"Jackson, MS",39067,1145,38,28,26,92,0.080349345
Sherman-Ada,74871,2178,63,60,52,175,0.080348944
Lexington,40516,2875,77,69,85,231,0.080347826
Baltimore,21629,9957,321,249,230,800,0.080345486
Tallahassee-Thomasville,39897,3485,105,94,81,280,0.080344333
Harrisburg-Lncstr-Leb-York,17023,3373,104,83,84,271,0.080343908
La Crosse-Eau Claire,54729,34863,1019,920,862,2801,0.080343057
New York,11768,20637,588,601,469,1658,0.080341135
Evansville,42462,1531,47,39,37,123,0.080339647
Minneapolis-St. Paul,56245,473,15,10,13,38,0.080338266
Tulsa,67352,473,16,14,8,38,0.080338266
Dallas-Ft. Worth,75416,2975,104,73,62,239,0.080336134
Knoxville,37825,9585,261,249,260,770,0.080333855
Sioux Falls(Mitchell),56155,361,10,11,8,29,0.08033241
Minneapolis-St. Paul,56357,1083,37,26,24,87,0.08033241
Lexington,42567,5913,184,157,134,475,0.080331473
Nashville,37144,3386,98,90,84,272,0.080330774
Utica,13416,2191,72,50,54,176,0.080328617
Charleston-Huntington,45696,1220,44,31,23,98,0.080327869
Charleston-Huntington,45645,2465,80,59,59,198,0.080324544
Wichita-Hutchinson Plus,67665,4930,142,138,116,396,0.080324544
Houston,75845,2963,90,80,68,238,0.080323996
"Washington, DC (Hagrstwn)",20882,14952,455,415,331,1201,0.080323703
Atlanta,30002,5814,152,149,166,467,0.080323357
Wilkes Barre-Scranton-Hztn,18331,498,14,13,13,40,0.080321285
Louisville,42724,5117,160,127,124,411,0.0803205
Cleveland-Akron (Canton),44143,24615,606,655,716,1977,0.08031688
Nashville,37048,7234,241,186,154,581,0.080315178
Macon,31025,1905,59,48,46,153,0.080314961
New York,10803,13771,433,384,289,1106,0.080313703
"Washington, DC (Hagrstwn)",22124,17706,556,504,362,1422,0.080311759
Grand Rapids-Kalmzoo-B.Crk,49072,2951,91,74,72,237,0.080311759
San Francisco-Oak-San Jose,94111,4109,41,85,204,330,0.080311511
Chicago,60510,27842,864,792,580,2236,0.080310323
Hartford & New Haven,6377,2204,55,64,58,177,0.08030853
Des Moines-Ames,50237,2864,97,70,63,230,0.080307263
"Tri-Cities, TN-VA",40826,523,18,15,9,42,0.080305927
"Springfield, MO",65625,8393,230,235,209,674,0.080305016
Minneapolis-St. Paul,55363,5255,182,130,110,422,0.080304472
Paducah-Cape Girard-Harsbg,42079,1320,36,35,35,106,0.08030303
Des Moines-Ames,50028,1594,46,48,34,128,0.080301129
Paducah-Cape Girard-Harsbg,63730,2690,69,70,77,216,0.080297398
Seattle-Tacoma,98251,5791,165,142,158,465,0.080297013
Los Angeles,90010,1619,30,41,59,130,0.080296479
Parkersburg,45724,1756,50,49,42,141,0.080296128
Richmond-Petersburg,23038,2030,66,50,47,163,0.080295567
Chicago,60546,16228,516,423,364,1303,0.08029332
Wheeling-Steubenville,26040,1644,49,42,41,132,0.080291971
Knoxville,40865,274,9,8,5,22,0.080291971
Charleston-Huntington,41645,1096,35,29,24,88,0.080291971
Madison,53937,1096,34,31,23,88,0.080291971
Kansas City,63557,274,8,7,7,22,0.080291971
Dallas-Ft. Worth,76263,137,4,4,3,11,0.080291971
Spokane,83868,959,22,25,30,77,0.080291971
Burlington-Plattsburgh,5602,12156,329,363,284,976,0.080289569
Boston (Manchester),1515,2217,61,58,59,178,0.080288678
Orlando-Daytona Bch-Melbrn,32726,24786,625,648,717,1990,0.080287259
Kansas City,66085,11571,414,327,188,929,0.080286924
San Francisco-Oak-San Jose,95132,38762,978,1066,1068,3112,0.080284815
Tyler-Longview(Lfkn&Ncgd),75760,2678,93,68,54,215,0.080283794
Nashville,37018,2541,75,64,65,204,0.080283353
Spokane,99341,847,27,24,17,68,0.080283353
Medford-Klamath Falls,96097,10052,303,258,246,807,0.080282531
Pittsburgh,15120,17426,378,472,549,1399,0.080282337
Chicago,46375,23194,618,623,621,1862,0.080279383
Mobile-Pensacola (Ft Walt),32563,30270,958,843,629,2430,0.080277502
Topeka,66402,3189,108,87,61,256,0.080275949
Minneapolis-St. Paul,56252,1308,46,31,28,105,0.080275229
"Springfield, MO",72742,436,13,12,10,35,0.080275229
Wichita Falls & Lawton,73542,3924,114,116,85,315,0.080275229
La Crosse-Eau Claire,54611,1171,42,27,25,94,0.080273271
Atlanta,30624,2641,77,59,76,212,0.080272624
Louisville,47140,2504,79,59,63,201,0.080271565
Charleston-Huntington,41168,2965,101,70,67,238,0.080269815
Charleston-Huntington,25028,299,10,7,7,24,0.080267559
Wheeling-Steubenville,26159,2392,63,53,76,192,0.080267559
"Tri-Cities, TN-VA",37645,5681,161,145,150,456,0.080267559
Des Moines-Ames,50591,299,12,6,6,24,0.080267559
Des Moines-Ames,50210,1819,64,43,39,146,0.080263881
New York,11732,4099,107,122,100,329,0.080263479
New York,10306,57599,1404,1590,1629,4623,0.08026181
Bluefield-Beckley-Oak Hill,24747,3389,97,90,85,272,0.080259664
Grand Rapids-Kalmzoo-B.Crk,49444,30788,838,808,825,2471,0.080258542
Harrisonburg,22840,4797,161,125,99,385,0.080258495
Johnstown-Altoona-St Colge,15545,2791,69,79,76,224,0.080257972
Seattle-Tacoma,98126,25519,514,598,936,2048,0.080253928
Ft. Smith-Fay-Sprngdl-Rgrs,72840,1894,60,45,47,152,0.080253432
San Francisco-Oak-San Jose,95119,14878,393,379,422,1194,0.080252722
Colorado Springs-Pueblo,81007,35987,1189,921,778,2888,0.080251202
Myrtle Beach-Florence,29161,10193,292,274,252,818,0.080251153
St. Louis,63376,77547,2141,2065,2017,6223,0.080248108
Bluefield-Beckley-Oak Hill,25938,1296,38,36,30,104,0.080246914
Chattanooga,37305,648,16,20,16,52,0.080246914
Traverse City-Cadillac,49625,1458,42,39,36,117,0.080246914
Salt Lake City,83283,162,5,4,4,13,0.080246914
Minneapolis-St. Paul,56437,1483,49,39,31,119,0.080242751
New York,7675,27679,815,808,598,2221,0.080241338
Las Vegas,89130,32179,879,812,891,2582,0.080238665
Toledo,43351,10008,284,265,254,803,0.080235811
San Francisco-Oak-San Jose,94080,68249,1604,1763,2109,5476,0.080235608
Wichita Falls & Lawton,73532,511,18,13,10,41,0.080234834
New York,8836,3926,128,124,63,315,0.080234335
Atlanta,30056,2904,92,79,62,233,0.08023416
New York,7832,3789,122,99,83,304,0.080232251
Chicago,46356,18970,543,495,484,1522,0.080231945
New Orleans,39576,6394,166,171,176,513,0.080231467
New York,8527,60253,1649,1554,1631,4834,0.08022837
Miami-Ft. Lauderdale,33126,49711,1098,1362,1528,3988,0.080223693
Roanoke-Lynchburg,24333,17227,483,479,420,1382,0.080222906
Albuquerque-Santa Fe,81321,14934,412,407,379,1198,0.080219633
Las Vegas,89019,2917,64,68,102,234,0.080219403
Harrisburg-Lncstr-Leb-York,17037,1097,34,29,25,88,0.080218778
"Washington, DC (Hagrstwn)",20833,8128,275,211,166,652,0.080216535
Toledo,43532,3902,126,103,84,313,0.080215274
Birmingham (Ann and Tusc),35223,12317,358,339,291,988,0.080214338
Norfolk-Portsmth-Newpt Nws,23416,187,6,4,5,15,0.080213904
Charleston-Huntington,41612,187,6,5,4,15,0.080213904
Shreveport,71068,3179,92,82,81,255,0.080213904
Shreveport,71403,4114,117,116,97,330,0.080213904
Oklahoma City,74881,4862,149,123,118,390,0.080213904
Denver,80754,187,5,5,5,15,0.080213904
Tulsa,74131,4139,119,100,113,332,0.080212612
Milwaukee,53110,17379,435,472,487,1394,0.08021175
Syracuse,13033,3603,105,93,91,289,0.080210935
"Rochester, NY",14504,1521,31,36,55,122,0.080210388
Cleveland-Akron (Canton),44126,16756,410,422,512,1344,0.080210074
Knoxville,37922,43150,1465,1116,880,3461,0.080208575
Charleston-Huntington,41230,12742,392,314,316,1022,0.080207189
Charlotte,28056,36032,1059,931,900,2890,0.080206483
"Washington, DC (Hagrstwn)",20693,1172,34,33,27,94,0.080204778
"Springfield, MO",65604,3753,94,106,101,301,0.080202505
Des Moines-Ames,50007,399,10,10,12,32,0.080200501
San Francisco-Oak-San Jose,94024,22444,829,617,354,1800,0.080199608
Des Moines-Ames,50201,8429,256,222,198,676,0.080199312
"Springfield, MO",65757,8267,258,207,198,663,0.080198379
Salt Lake City,84060,9277,255,240,249,744,0.08019834
Roanoke-Lynchburg,24018,39153,1095,1031,1014,3140,0.080198197
Chattanooga,30739,6484,183,182,155,520,0.080197409
Greenville-N.Bern-Washngtn,28526,2045,57,63,44,164,0.080195599
Sioux City,51028,2045,69,51,44,164,0.080195599
"Washington, DC (Hagrstwn)",21788,11073,284,286,318,888,0.080195069
Montgomery-Selma,36075,1646,52,39,41,132,0.080194411
"Springfield, MO",65552,1646,50,43,39,132,0.080194411
Jacksonville,32097,29042,898,723,708,2329,0.080194202
New Orleans,39455,9128,285,229,218,732,0.080192813
Columbus-Tupelo-West Point,35586,4165,122,106,106,334,0.080192077
Augusta-Aiken,29620,12308,347,325,315,987,0.080191745
Tulsa,74346,7582,216,205,187,608,0.080189924
Bluefield-Beckley-Oak Hill,25870,212,7,5,5,17,0.080188679
Kansas City,64467,212,6,6,5,17,0.080188679
Wichita-Hutchinson Plus,67837,424,16,9,9,34,0.080188679
Sherman-Ada,74723,1696,60,46,30,136,0.080188679
Myrtle Beach-Florence,29545,1933,60,51,44,155,0.080186239
Des Moines-Ames,50105,1509,56,35,30,121,0.080185553
Tampa-St. Pete (Sarasota),33548,8281,224,237,203,664,0.080183553
Des Moines-Ames,50323,17660,663,434,319,1416,0.0801812
Boston (Manchester),3833,23210,661,663,537,1861,0.080180956
Rockford,61052,1110,34,31,24,89,0.08018018
"Washington, DC (Hagrstwn)",22851,5600,163,139,147,449,0.080178571
Los Angeles,91208,16015,426,422,436,1284,0.080174836
Omaha,68118,10340,344,283,202,829,0.080174081
Dallas-Ft. Worth,75148,5987,176,163,141,480,0.08017371
Charlottesville,22709,923,25,23,26,74,0.080173348
Knoxville,37852,2844,87,82,59,228,0.080168776
Louisville,42764,474,15,10,13,38,0.080168776
Kansas City,64473,1422,37,36,41,114,0.080168776
New York,12566,11875,321,292,339,952,0.080168421
"Washington, DC (Hagrstwn)",21716,8021,252,195,196,643,0.080164568
Birmingham (Ann and Tusc),35010,19897,519,532,544,1595,0.080162839
"Albany, GA",31749,2707,78,76,63,217,0.080162542
Cincinnati,45064,2707,89,68,60,217,0.080162542
Rockford,61062,1784,61,45,37,143,0.080156951
Johnstown-Altoona-St Colge,16667,1310,32,37,36,105,0.080152672
Lubbock,79082,262,9,7,5,21,0.080152672
"Jackson, MS",39170,9195,249,247,241,737,0.080152257
Portland-Auburn,4037,3793,110,106,88,304,0.08014764
Pittsburgh,21536,3843,91,122,95,308,0.080145719
Tulsa,74060,549,18,12,14,44,0.080145719
New York,10583,37320,1331,993,667,2991,0.080144695
Indianapolis,47967,836,23,20,24,67,0.080143541
Lexington,40914,574,17,17,12,46,0.080139373
Peoria-Bloomington,61747,1435,43,38,34,115,0.080139373
Greenville-N.Bern-Washngtn,27962,6364,199,149,162,510,0.080138278
Atlanta,31097,1460,45,37,35,117,0.080136986
Salisbury,21631,2633,82,64,65,211,0.080136726
Shreveport,71075,5578,171,153,123,447,0.08013625
Pittsburgh,15410,886,27,22,22,71,0.08013544
Fargo,56644,886,30,22,19,71,0.08013544
Harrisburg-Lncstr-Leb-York,17042,41842,1200,1087,1066,3353,0.080134793
Providence-New Bedford,2921,12579,383,329,296,1008,0.080133556
Joplin-Pittsburg,64848,599,19,17,12,48,0.080133556
"Portland, OR",97338,24260,717,618,609,1944,0.080131904
Paducah-Cape Girard-Harsbg,63953,911,29,24,20,73,0.080131723
Omaha,68059,3432,118,94,63,275,0.080128205
Utica,13808,1585,41,42,44,127,0.080126183
Minneapolis-St. Paul,56180,1273,33,30,39,102,0.080125687
"Washington, DC (Hagrstwn)",20646,22465,668,581,551,1800,0.080124638
"Alexandria, LA",71346,2571,80,60,66,206,0.080124465
Madison,53930,1298,40,39,25,104,0.080123267
Minneapolis-St. Paul,56446,1685,46,51,38,135,0.080118694
Monroe-El Dorado,71241,9249,245,266,230,741,0.080116769
Dallas-Ft. Worth,75831,4818,137,129,120,386,0.080116231
Cleveland-Akron (Canton),44095,32266,799,850,936,2585,0.080115292
Phoenix (Prescott),85206,38208,785,1009,1267,3061,0.080114112
Indianapolis,46151,32254,938,831,815,2584,0.080114094
Harrisburg-Lncstr-Leb-York,17070,18162,505,493,457,1455,0.080112322
Pittsburgh,16001,40281,1006,1099,1122,3227,0.080112212
Boston (Manchester),1776,19174,722,513,301,1536,0.08010848
Boston (Manchester),2359,18363,504,509,458,1471,0.080106736
Norfolk-Portsmth-Newpt Nws,27910,9812,262,281,243,786,0.080105993
Charlotte,28630,19624,541,530,501,1572,0.080105993
Charlotte,28170,10786,308,279,277,864,0.080103838
Champaign&Sprngfld-Decatur,62543,387,14,11,6,31,0.080103359
San Antonio,78248,14107,373,374,383,1130,0.080102077
Sacramnto-Stkton-Modesto,95864,24057,708,617,602,1927,0.080101426
San Francisco-Oak-San Jose,95391,28614,1114,632,546,2292,0.08010065
Indianapolis,46161,2397,81,63,48,192,0.080100125
Boston (Manchester),1826,32460,853,843,904,2600,0.080098583
San Francisco-Oak-San Jose,94560,49539,1099,1291,1578,3968,0.080098508
Des Moines-Ames,50235,412,12,11,10,33,0.080097087
Phoenix (Prescott),85383,74361,2701,1882,1373,5956,0.080095749
Chattanooga,37374,2110,54,57,58,169,0.080094787
Detroit,48176,22561,721,610,476,1807,0.080093967
Philadelphia,18964,14583,405,381,382,1168,0.080093259
Medford-Klamath Falls,97504,51640,1402,1373,1361,4136,0.080092951
Augusta-Aiken,29003,5681,172,148,135,455,0.080091533
Jonesboro,72413,899,21,28,23,72,0.080088988
Dallas-Ft. Worth,75141,7729,234,209,176,619,0.08008798
Meridian,39326,462,12,13,12,37,0.08008658
Minneapolis-St. Paul,56215,4620,135,117,118,370,0.08008658
Chicago,61370,1386,43,33,35,111,0.08008658
"Rochester, NY",14502,11463,335,324,259,918,0.080083748
Providence-New Bedford,2839,1436,43,35,37,115,0.080083565
Mobile-Pensacola (Ft Walt),36603,8179,170,177,308,655,0.08008314
San Francisco-Oak-San Jose,94568,74125,2145,1882,1909,5936,0.080080944
Cleveland-Akron (Canton),44632,10402,327,250,256,833,0.080080754
Raleigh-Durham (Fayetvlle),27890,1998,56,50,54,160,0.08008008
Evansville,42452,1998,65,42,53,160,0.08008008
"Alexandria, LA",71423,4995,157,125,118,400,0.08008008
Pittsburgh,16354,10215,323,250,245,818,0.080078316
Burlington-Plattsburgh,5457,1536,46,39,38,123,0.080078125
Toledo,44853,1561,49,43,33,125,0.080076874
Wilkes Barre-Scranton-Hztn,18644,7293,188,199,197,584,0.080076786
Cincinnati,45036,43947,1332,1184,1003,3519,0.080073725
Louisville,42721,3834,119,99,89,307,0.080073031
Greensboro-H.Point-W.Salem,28697,12601,351,331,327,1009,0.08007301
Pittsburgh,15320,4958,141,129,127,397,0.08007261
"Washington, DC (Hagrstwn)",22213,3422,103,86,85,274,0.080070134
New York,10984,2885,91,67,73,231,0.080069324
Tallahassee-Thomasville,39827,4084,123,107,97,327,0.08006856
Columbia-Jefferson City,65354,587,18,17,12,47,0.080068143
Des Moines-Ames,50325,18397,591,497,385,1473,0.080067402
Syracuse,13039,17423,486,450,459,1395,0.080066579
Charleston-Huntington,25557,1249,38,31,31,100,0.080064051
Cedar Rapids-Wtrlo-IWC&Dub,52201,1249,34,32,34,100,0.080064051
Mobile-Pensacola (Ft Walt),36580,7007,215,164,182,561,0.080062794
Hartford & New Haven,6090,1299,48,36,20,104,0.080061586
New York,7082,5958,175,158,144,477,0.080060423
Topeka,66507,1349,53,27,28,108,0.080059303
Ft. Wayne,45894,687,23,16,16,55,0.080058224
San Francisco-Oak-San Jose,95118,31540,905,865,755,2525,0.08005707
Raleigh-Durham (Fayetvlle),27615,43719,1066,1173,1261,3500,0.080056726
St. Joseph,64436,712,30,12,15,57,0.08005618
New York,7718,6171,176,158,160,494,0.080051855
Shreveport,74734,812,18,22,25,65,0.080049261
Birmingham (Ann and Tusc),35552,862,24,25,20,69,0.080046404
Birmingham (Ann and Tusc),35176,887,26,23,22,71,0.080045096
"Lafayette, IN",47981,887,30,24,17,71,0.080045096
West Palm Beach-Ft. Pierce,33470,31595,958,784,787,2529,0.080044311
Flint-Saginaw-Bay City,48845,987,31,25,23,79,0.080040527
Philadelphia,18036,14568,432,383,351,1166,0.08003844
"Charleston, SC",29081,1112,31,30,28,89,0.080035971
Hartford & New Haven,6062,17405,414,459,520,1393,0.080034473
New York,10916,4673,143,128,103,374,0.080034239
Charleston-Huntington,25617,1237,36,34,29,99,0.080032336
Dallas-Ft. Worth,76050,7447,233,195,168,596,0.080032228
Wichita-Hutchinson Plus,67526,2524,80,62,60,202,0.080031696
Ft. Smith-Fay-Sprngdl-Rgrs,72944,2599,85,57,66,208,0.080030781
Charleston-Huntington,25550,8172,226,221,207,654,0.080029369
Las Vegas,89141,45372,1355,1105,1171,3631,0.08002733
Phoenix (Prescott),85260,41086,956,1079,1253,3288,0.08002726
Greenvll-Spart-Ashevll-And,30635,15520,443,393,406,1242,0.080025773
Ft. Myers-Naples,34120,49236,1463,1271,1206,3940,0.080022748
New York,10538,17933,643,460,332,1435,0.080020075
Pittsburgh,15474,2012,51,55,55,161,0.080019881
Charlottesville,22923,6286,186,152,165,503,0.08001909
Los Angeles,90293,10485,110,218,511,839,0.080019075
Springfield-Holyoke,1030,11335,312,323,272,907,0.080017644
Minneapolis-St. Paul,56482,6836,195,169,183,547,0.080017554
Syracuse,14541,2362,74,59,56,189,0.080016935
Wausau-Rhinelander,54484,4999,160,136,104,400,0.080016003
Jacksonville,32220,13435,370,372,333,1075,0.080014886
Burlington-Plattsburgh,5478,16360,423,442,444,1309,0.080012225
"Springfield, MO",65052,3512,107,87,87,281,0.08001139
Tampa-St. Pete (Sarasota),33618,27759,635,772,814,2221,0.080010087
"Columbia, SC",29032,4587,137,118,112,367,0.08000872
Milwaukee,53538,18348,542,477,449,1468,0.08000872
Hartford & New Haven,6260,9249,230,267,243,740,0.08000865
Hartford & New Haven,6109,27485,752,719,728,2199,0.080007277
Burlington-Plattsburgh,5101,4250,122,105,113,340,0.08
Watertown,13608,1375,42,36,32,110,0.08
Philadelphia,18934,375,11,11,8,30,0.08
"Tri-Cities, TN-VA",24269,200,6,6,4,16,0.08
Bluefield-Beckley-Oak Hill,24849,525,13,16,13,42,0.08
Charleston-Huntington,25208,800,28,18,18,64,0.08
Charleston-Huntington,25520,925,28,25,21,74,0.08
Charleston-Huntington,26660,250,8,5,7,20,0.08
Montgomery-Selma,36039,275,7,6,9,22,0.08
Nashville,37141,1125,37,26,27,90,0.08
Memphis,38645,975,32,21,25,78,0.08
Charleston-Huntington,41159,550,17,16,11,44,0.08
"Tri-Cities, TN-VA",41821,500,15,13,12,40,0.08
Bowling Green,42124,125,4,3,3,10,0.08
Charleston-Huntington,45688,425,15,9,10,34,0.08
South Bend-Elkhart,46960,1200,39,35,22,96,0.08
Des Moines-Ames,50155,250,8,7,5,20,0.08
Sioux City,51052,1200,40,33,23,96,0.08
Davenport-R.Island-Moline,52727,300,8,9,7,24,0.08
Great Falls,59461,25,0,1,1,2,0.08
St. Louis,63656,225,7,5,6,18,0.08
Topeka,66417,450,13,11,12,36,0.08
Wichita-Hutchinson Plus,67483,275,9,7,6,22,0.08
"Alexandria, LA",71417,4600,145,127,96,368,0.08
Jonesboro,72410,425,13,11,10,34,0.08
"Springfield, MO",72538,425,13,11,10,34,0.08
Oklahoma City,73753,475,15,14,9,38,0.08
Ft. Smith-Fay-Sprngdl-Rgrs,74944,1100,33,30,25,88,0.08
Dallas-Ft. Worth,76077,650,22,18,12,52,0.08
San Angelo,76955,125,5,3,2,10,0.08
San Angelo,76957,125,5,3,2,10,0.08
Abilene-Sweetwater,79544,400,15,11,6,32,0.08
Fresno-Visalia,93603,350,10,10,8,28,0.08
Sacramnto-Stkton-Modesto,95674,650,18,20,14,52,0.08
Philadelphia,8033,18788,585,497,421,1503,0.079997871
Terre Haute,47441,8663,261,229,203,693,0.079995383
Knoxville,37938,19590,587,516,464,1567,0.079989791
Mobile-Pensacola (Ft Walt),32531,6701,205,173,158,536,0.079988061
Denver,80543,9614,302,222,245,769,0.079987518
Minneapolis-St. Paul,55038,27467,963,684,550,2197,0.079986893
San Francisco-Oak-San Jose,94588,36569,1118,991,816,2925,0.07998578
Minneapolis-St. Paul,56331,2113,77,53,39,169,0.07998107
Nashville,37146,7702,239,197,180,616,0.079979226
Oklahoma City,73632,3651,104,95,93,292,0.079978088
Orlando-Daytona Bch-Melbrn,32907,45713,1263,1208,1185,3656,0.079977249
New York,7071,21819,526,547,672,1745,0.079976168
Lexington,40385,3276,104,85,73,262,0.07997558
Indianapolis,47394,7915,220,195,218,633,0.079974732
Tyler-Longview(Lfkn&Ncgd),75765,7840,309,209,109,627,0.07997449
New York,8879,22445,553,573,669,1795,0.079973268
Philadelphia,19963,22658,590,635,587,1812,0.079971754
"Springfield, MO",72576,4164,131,111,91,333,0.079971182
Ft. Wayne,47359,2626,77,63,70,210,0.079969535
Springfield-Holyoke,1033,5990,176,142,161,479,0.079966611
Little Rock-Pine Bluff,72127,2226,70,55,53,178,0.079964061
Paducah-Cape Girard-Harsbg,62896,11080,298,290,298,886,0.079963899
Lake Charles,70661,2151,58,60,54,172,0.079962808
Paducah-Cape Girard-Harsbg,42051,3139,94,75,82,251,0.079961771
Little Rock-Pine Bluff,72650,4177,128,110,96,334,0.079961695
Dayton,45871,2026,58,52,52,162,0.079960513
Nashville,37135,26676,959,668,506,2133,0.079959514
Kansas City,64035,963,26,29,22,77,0.079958463
Paducah-Cape Girard-Harsbg,38229,2639,75,73,63,211,0.079954528
Philadelphia,8036,6091,196,159,132,487,0.079954031
Bluefield-Beckley-Oak Hill,24701,19449,517,489,549,1555,0.079952697
New York,7850,5916,163,153,157,473,0.079952671
Harrisburg-Lncstr-Leb-York,17082,3277,96,87,79,262,0.079951175
Minneapolis-St. Paul,56282,1626,60,36,34,130,0.0799508
Detroit,48315,29143,795,780,755,2330,0.079950588
Little Rock-Pine Bluff,72111,1601,47,44,37,128,0.079950031
Memphis,38646,2389,58,67,66,191,0.07994977
Utica,13469,788,25,20,18,63,0.079949239
"Tri-Cities, TN-VA",24609,6279,179,163,160,502,0.079949036
Toledo,43359,763,25,21,15,61,0.079947575
Des Moines-Ames,50529,763,22,23,16,61,0.079947575
Parkersburg,26150,5954,162,154,160,476,0.079946255
Kansas City,64761,1476,48,37,33,118,0.079945799
Ft. Smith-Fay-Sprngdl-Rgrs,72774,6417,190,169,154,513,0.079943899
Orlando-Daytona Bch-Melbrn,32119,23254,466,683,710,1859,0.079943236
Philadelphia,19425,16975,648,416,293,1357,0.07994109
New York,8817,47436,1248,1179,1365,3792,0.079939287
Monroe-El Dorado,71454,1964,57,47,53,157,0.0799389
Beaumont-Port Arthur,77625,9620,285,260,224,769,0.07993763
Chicago,46360,44197,1170,1156,1207,3533,0.079937552
Evansville,47649,1251,45,28,27,100,0.079936051
Roanoke-Lynchburg,24179,19203,514,523,498,1535,0.079935427
Shreveport,74764,3040,81,85,77,243,0.079934211
Birmingham (Ann and Tusc),36740,1201,27,36,33,96,0.079933389
La Crosse-Eau Claire,54456,5780,170,144,148,462,0.079930796
"Charleston, SC",29440,27399,822,717,651,2190,0.079929924
Huntsville-Decatur (Flor),35633,20906,567,573,531,1671,0.079929207
Providence-New Bedford,2703,47392,1229,1277,1282,3788,0.079929102
Terre Haute,62436,563,19,14,12,45,0.079928952
Denver,81041,563,20,16,9,45,0.079928952
Tallahassee-Thomasville,32024,20569,651,499,494,1644,0.079926102
Philadelphia,18976,22133,678,558,533,1769,0.079925902
"Washington, DC (Hagrstwn)",20636,10610,332,258,258,848,0.079924599
Johnstown-Altoona-St Colge,15824,5280,161,123,138,422,0.079924242
Macon,31050,1026,31,27,24,82,0.079922027
Macon,31077,1026,32,27,23,82,0.079922027
Wichita-Hutchinson Plus,67008,513,18,10,13,41,0.079922027
Detroit,48023,4955,128,118,150,396,0.079919273
Chattanooga,37309,1952,57,53,46,156,0.079918033
Kansas City,64649,976,32,23,23,78,0.079918033
Ft. Smith-Fay-Sprngdl-Rgrs,74956,1927,63,51,40,154,0.079916969
Wilkes Barre-Scranton-Hztn,18519,4805,109,123,152,384,0.079916753
Baltimore,21797,9110,263,260,205,728,0.079912184
Cedar Rapids-Wtrlo-IWC&Dub,52035,876,28,23,19,70,0.079908676
Mankato,56171,1752,43,43,54,140,0.079908676
Wichita Falls & Lawton,73548,438,15,11,9,35,0.079908676
Toledo,49248,851,26,18,24,68,0.079905993
"Columbus, OH",45766,1264,39,32,30,101,0.079905063
Wheeling-Steubenville,26437,413,9,10,14,33,0.079903148
Sherman-Ada,74735,2040,66,54,43,163,0.079901961
Paducah-Cape Girard-Harsbg,38242,19837,600,508,477,1585,0.079901195
Cincinnati,45148,1602,59,39,30,128,0.079900125
Syracuse,13440,39925,1087,1034,1069,3190,0.079899812
Dallas-Ft. Worth,75474,15933,489,416,368,1273,0.079897069
"Washington, DC (Hagrstwn)",20198,2328,59,60,67,186,0.079896907
Indianapolis,46033,40127,1362,1082,762,3206,0.079896329
Tulsa,74342,2691,69,82,64,215,0.079895949
Los Angeles,90503,44871,1160,1208,1217,3585,0.079895701
Dallas-Ft. Worth,75161,8048,245,212,186,643,0.079895626
Seattle-Tacoma,98043,23056,491,571,780,1842,0.079892436
Sioux City,51248,1840,59,38,50,147,0.079891304
Pittsburgh,16334,363,10,10,9,29,0.079889807
Lexington,41640,1089,34,27,26,87,0.079889807
Traverse City-Cadillac,49727,7210,207,190,179,576,0.079889043
Oklahoma City,73086,8575,275,212,198,685,0.079883382
San Francisco-Oak-San Jose,94940,338,9,9,9,27,0.079881657
Birmingham (Ann and Tusc),35214,18077,484,466,494,1444,0.079880511
Denver,69358,1665,46,41,46,133,0.07987988
Birmingham (Ann and Tusc),35083,3305,95,87,82,264,0.079878971
Dallas-Ft. Worth,76433,1953,63,51,42,156,0.079877112
San Francisco-Oak-San Jose,94061,36882,879,966,1101,2946,0.079876362
Austin,78628,71035,2196,1742,1736,5674,0.079876117
Minneapolis-St. Paul,55371,17590,558,468,379,1405,0.079874929
Paducah-Cape Girard-Harsbg,42024,1277,34,30,38,102,0.079874706
Augusta-Aiken,30823,1590,44,42,41,127,0.079874214
Shreveport,75668,1590,51,37,39,127,0.079874214
Minneapolis-St. Paul,54015,4044,127,106,90,323,0.079871414
Joplin-Pittsburg,66783,2166,69,54,50,173,0.079870729
Lexington,41301,5246,151,137,131,419,0.079870377
Wichita-Hutchinson Plus,67104,2141,62,57,52,171,0.07986922
Ft. Smith-Fay-Sprngdl-Rgrs,72937,3656,114,94,84,292,0.079868709
Tulsa,74467,15551,492,354,396,1242,0.079866247
New York,7711,1490,43,40,36,119,0.079865772
Dallas-Ft. Worth,75477,889,14,27,30,71,0.079865017
Minneapolis-St. Paul,54011,6937,217,174,163,554,0.079861612
Green Bay-Appleton,54949,3456,106,85,85,276,0.079861111
Wichita Falls & Lawton,73055,9429,277,243,233,753,0.079860006
New Orleans,39556,7526,214,190,197,601,0.079856497
Savannah,29911,1390,39,34,38,111,0.079856115
Buffalo,14129,1653,37,57,38,132,0.079854809
Abilene-Sweetwater,79501,3569,112,79,94,285,0.079854301
Minneapolis-St. Paul,55065,1077,38,27,21,86,0.079851439
Charleston-Huntington,41146,263,6,8,7,21,0.079847909
Flint-Saginaw-Bay City,48757,3419,92,88,93,273,0.079847909
Des Moines-Ames,50055,1052,38,31,15,84,0.079847909
Detroit,48442,22230,620,606,549,1775,0.079847054
Flint-Saginaw-Bay City,48622,6425,185,161,167,513,0.079844358
Seattle-Tacoma,98027,30522,825,821,791,2437,0.079844047
Philadelphia,19525,17334,584,457,343,1384,0.079843083
Chicago,60526,12713,411,326,278,1015,0.079839534
New York,11710,34219,932,877,923,2732,0.079838686
Dayton,45382,977,28,25,25,78,0.079836233
Nashville,38450,2430,70,60,64,194,0.079835391
Nashville,42140,1215,31,31,35,97,0.079835391
Harrisburg-Lncstr-Leb-York,17406,24576,700,607,655,1962,0.079833984
Champaign&Sprngfld-Decatur,61745,4334,155,101,90,346,0.079833872
"Washington, DC (Hagrstwn)",20676,3833,114,103,89,306,0.079833029
Boston (Manchester),2472,36639,571,797,1557,2925,0.079832965
Sioux Falls(Mitchell),57256,238,7,6,6,19,0.079831933
Davenport-R.Island-Moline,61466,238,8,6,5,19,0.079831933
Wichita Falls & Lawton,73537,476,17,12,9,38,0.079831933
Waco-Temple-Bryan,76664,3332,109,92,65,266,0.079831933
Boston (Manchester),3839,4184,100,110,124,334,0.079827916
Rochestr-Mason City-Austin,55920,8769,322,220,158,700,0.079826662
Chicago,60472,4347,121,111,115,347,0.079825167
"Portland, OR",97224,38159,946,1004,1096,3046,0.079823895
Indianapolis,46126,4723,153,120,104,377,0.079822147
"Columbia, SC",29036,29829,1015,772,594,2381,0.07982165
Sioux Falls(Mitchell),56164,5788,194,136,132,462,0.079820318
Birmingham (Ann and Tusc),35503,8657,237,232,222,691,0.079819799
Pittsburgh,16314,5312,167,141,116,424,0.079819277
"Tri-Cities, TN-VA",24263,5525,163,138,140,441,0.079819005
Cleveland-Akron (Canton),44041,13018,370,349,320,1039,0.079812567
Bluefield-Beckley-Oak Hill,25920,1065,29,29,27,85,0.079812207
Kansas City,64453,213,7,3,7,17,0.079812207
"Portland, OR",98647,426,13,12,9,34,0.079812207
Birmingham (Ann and Tusc),35051,9748,243,251,284,778,0.079811243
Johnstown-Altoona-St Colge,15521,1679,49,44,41,134,0.07980941
Detroit,48144,10212,313,281,221,815,0.079808069
"Columbia, SC",29666,6854,191,187,169,547,0.079807412
Boston (Manchester),3036,5388,157,146,127,430,0.079806978
Dallas-Ft. Worth,75225,22918,767,618,444,1829,0.079806266
Cleveland-Akron (Canton),44145,33758,857,888,949,2694,0.079803306
Philadelphia,19440,20112,487,536,582,1605,0.079803103
Nashville,37335,3045,100,73,70,243,0.079802956
Clarksburg-Weston,26292,802,21,21,22,64,0.079800499
Ft. Myers-Naples,33991,28822,949,704,647,2300,0.079800153
Chicago,60155,8183,199,201,253,653,0.079799585
Indianapolis,47989,1391,48,33,30,111,0.079798706
Albany-Schenectady-Troy,1220,8083,205,202,238,645,0.079797105
Columbus-Tupelo-West Point,39741,1178,33,34,27,94,0.079796265
Wilkes Barre-Scranton-Hztn,18640,16693,446,446,440,1332,0.079793926
Jacksonville,32226,21744,627,546,562,1735,0.079792127
Dallas-Ft. Worth,75117,4424,134,127,92,353,0.079792043
"Columbus, OH",43780,2306,70,59,55,184,0.079791847
Louisville,47122,11668,363,302,266,931,0.079790881
New York,7748,28625,861,804,619,2284,0.079790393
Peoria-Bloomington,61546,3785,115,104,83,302,0.079788639
Lexington,41862,752,30,17,13,60,0.079787234
La Crosse-Eau Claire,54493,752,26,17,17,60,0.079787234
Rapid City,57725,188,7,4,4,15,0.079787234
Lincoln & Hastings-Krny,68936,188,7,4,4,15,0.079787234
Tulsa,74002,2256,75,47,58,180,0.079787234
Harrisburg-Lncstr-Leb-York,17017,1667,55,45,33,133,0.079784043
"Jackson, MS",39647,1805,56,45,43,144,0.079778393
Minneapolis-St. Paul,56074,1805,64,45,35,144,0.079778393
Richmond-Petersburg,22560,6656,189,176,166,531,0.079777644
Nashville,38473,1078,31,28,27,86,0.079777365
Charleston-Huntington,25067,890,24,22,25,71,0.079775281
Indianapolis,46106,11169,379,264,248,891,0.079774376
Myrtle Beach-Florence,29525,1592,48,41,38,127,0.079773869
Harrisburg-Lncstr-Leb-York,17019,19593,616,503,444,1563,0.079773388
Evansville,47601,13727,434,346,315,1095,0.079769797
Flint-Saginaw-Bay City,48616,7459,203,200,192,595,0.079769406
Kansas City,66092,4325,141,117,87,345,0.079768786
Boise,97901,514,18,14,9,41,0.079766537
Oklahoma City,73639,677,20,20,14,54,0.079763663
Minneapolis-St. Paul,55424,10268,396,266,157,819,0.079762369
Topeka,66617,8538,278,209,194,681,0.079761068
"Columbus, OH",43065,49448,1822,1325,797,3944,0.079760557
Omaha,68130,21828,788,543,410,1741,0.079759941
Des Moines-Ames,50322,32198,863,868,837,2568,0.079756507
Baltimore,21219,10018,271,257,271,799,0.079756438
Raleigh-Durham (Fayetvlle),23964,978,26,19,33,78,0.079754601
"Columbus, OH",43082,33580,1081,945,652,2678,0.079749851
Chicago,61373,1279,39,29,34,102,0.079749805
Minneapolis-St. Paul,56479,5530,160,141,140,441,0.079746835
Philadelphia,19060,11524,395,310,214,919,0.079746616
Bluefield-Beckley-Oak Hill,25918,4527,139,114,108,361,0.07974376
Chicago,60048,29069,968,808,542,2318,0.079741305
Houston,77563,10133,279,269,260,808,0.079739465
Little Rock-Pine Bluff,72132,3223,101,74,82,257,0.079739373
St. Louis,63650,3938,108,108,98,314,0.079735907
Parkersburg,45788,903,23,27,22,72,0.079734219
Davenport-R.Island-Moline,52655,4214,142,107,87,336,0.079734219
Charleston-Huntington,25635,2847,80,83,64,227,0.079733052
Nashville,37122,69545,2186,1742,1617,5545,0.079732547
Boston (Manchester),1540,11062,275,318,289,882,0.079732417
Charleston-Huntington,25564,1342,37,36,34,107,0.079731744
Des Moines-Ames,52211,2521,83,62,56,201,0.079730266
Burlington-Plattsburgh,5070,439,16,11,8,35,0.079726651
New Orleans,70343,4967,166,127,103,396,0.079726193
Oklahoma City,74854,2333,66,60,60,186,0.079725675
New York,7052,48768,1377,1308,1203,3888,0.079724409
Joplin-Pittsburg,64832,715,25,15,17,57,0.07972028
Detroit,48130,16094,536,444,303,1283,0.07971915
Sioux City,51436,853,25,19,24,68,0.07971864
Buffalo,14058,2120,64,48,57,169,0.079716981
Salt Lake City,84759,2120,75,58,36,169,0.079716981
Philadelphia,18069,7903,218,223,189,630,0.079716563
Evansville,42256,5068,140,123,141,404,0.079715864
St. Louis,62092,2672,84,70,59,213,0.079715569
New York,11793,31901,915,833,795,2543,0.079715369
New York,7663,14314,350,375,416,1141,0.07971217
Evansville,47521,828,26,19,21,66,0.079710145
Rochestr-Mason City-Austin,50454,138,4,4,3,11,0.079710145
Champaign&Sprngfld-Decatur,62465,828,23,21,22,66,0.079710145
Abilene-Sweetwater,79548,138,5,3,3,11,0.079710145
Los Angeles,92677,63594,1679,1703,1687,5069,0.079708778
Youngstown,44445,3011,92,80,68,240,0.079707738
New York,8807,39094,1235,1031,850,3116,0.079705326
Ft. Wayne,46982,2572,75,57,73,205,0.07970451
Kansas City,66032,5006,162,113,124,399,0.079704355
New York,6905,20263,435,576,604,1615,0.07970192
New York,7438,11242,312,301,283,896,0.079701121
Oklahoma City,73063,665,22,19,12,53,0.079699248
Syracuse,13027,34919,977,851,955,2783,0.079698731
Des Moines-Ames,50225,2911,101,66,65,232,0.079697698
Columbia-Jefferson City,65010,7629,254,181,173,608,0.079695897
Kansas City,64088,1443,47,37,31,115,0.07969508
Jacksonville,32025,23013,633,567,634,1834,0.079694086
Seattle-Tacoma,98391,61322,2084,1491,1312,4887,0.079694074
Medford-Klamath Falls,96094,6726,202,187,147,536,0.079690752
"Portland, OR",97347,2196,73,57,45,175,0.079690346
Pittsburgh,15067,2058,59,56,49,164,0.079689018
Philadelphia,19362,5898,175,143,152,470,0.07968803
Syracuse,13057,14946,391,381,419,1191,0.079686873
Lansing,48827,16038,481,417,380,1278,0.079685746
Idaho Fals-Pocatllo(Jcksn),83241,1895,72,46,33,151,0.079683377
Pittsburgh,15053,251,6,7,7,20,0.079681275
Wichita-Hutchinson Plus,67232,502,18,11,11,40,0.079681275
Monroe-El Dorado,71747,753,22,18,20,60,0.079681275
Harrisburg-Lncstr-Leb-York,17552,20570,549,490,600,1639,0.079679144
Parkersburg,45784,3489,102,90,86,278,0.079678991
Johnstown-Altoona-St Colge,15762,866,23,28,18,69,0.079676674
Chicago,60091,26859,984,765,391,2140,0.079675342
San Angelo,76950,3188,105,78,71,254,0.079673777
Seattle-Tacoma,98022,23798,679,629,588,1896,0.079670561
Sioux City,51037,364,13,7,9,29,0.07967033
Minneapolis-St. Paul,56224,364,10,11,8,29,0.07967033
Omaha,68066,6276,212,164,124,500,0.079668579
Burlington-Plattsburgh,12937,1318,36,41,28,105,0.079666161
Los Angeles,93013,16042,440,383,455,1278,0.079665877
Bluefield-Beckley-Oak Hill,24910,4268,112,91,137,340,0.079662605
Milwaukee,53170,2134,60,59,51,170,0.079662605
Columbus-Tupelo-West Point,39767,590,18,16,13,47,0.079661017
Atlanta,30734,3766,103,96,101,300,0.079660117
Hartford & New Haven,6024,703,19,18,19,56,0.079658606
Richmond-Petersburg,23930,5260,147,148,124,419,0.079657795
Richmond-Petersburg,23824,6616,187,174,166,527,0.079655381
Kansas City,66075,2197,83,59,33,175,0.079654074
Abilene-Sweetwater,76371,1494,50,30,39,119,0.079651941
Boston (Manchester),2351,16999,406,463,485,1354,0.079651744
Anchorage,99669,14991,459,380,355,1194,0.079647789
Clarksburg-Weston,26431,6240,180,154,163,497,0.079647436
Bangor,4475,339,11,9,7,27,0.079646018
Lima,45819,226,7,7,4,18,0.079646018
Terre Haute,47858,678,20,18,16,54,0.079646018
Sioux Falls(Mitchell),57381,565,20,14,11,45,0.079646018
Rockford,61353,1243,38,25,36,99,0.079646018
Shreveport,75556,1130,30,32,28,90,0.079646018
Detroit,48003,6755,196,169,173,538,0.079644708
St. Louis,63367,29029,983,719,610,2312,0.079644493
"Rochester, NY",14414,6881,193,193,162,548,0.079639587
Gainesville,32615,17341,515,423,443,1381,0.079637852
Mobile-Pensacola (Ft Walt),36521,5500,157,134,147,438,0.079636364
Memphis,38381,1532,45,39,38,122,0.079634465
Bluefield-Beckley-Oak Hill,25827,2838,73,73,80,226,0.079633545
Seattle-Tacoma,98252,10900,309,271,288,868,0.079633028
Shreveport,71063,653,18,18,16,52,0.079632466
Tulsa,74442,653,22,18,12,52,0.079632466
Champaign&Sprngfld-Decatur,62428,2813,85,71,68,224,0.079630288
Dothan,36373,540,14,14,15,43,0.07962963
"Tri-Cities, TN-VA",40862,540,19,15,9,43,0.07962963
"Washington, DC (Hagrstwn)",20817,38667,1374,1030,675,3079,0.079628624
Utica,13407,4810,127,122,134,383,0.07962578
New York,7645,9080,277,253,193,723,0.079625551
Quincy-Hannibal-Keokuk,62366,1281,33,35,34,102,0.079625293
Chattanooga,37343,45777,1210,1204,1231,3645,0.079625139
Atlanta,30075,55523,1805,1483,1133,4421,0.07962466
Cleveland-Akron (Canton),44470,3504,98,80,101,279,0.079623288
Charleston-Huntington,25607,1796,48,55,40,143,0.079621381
Richmond-Petersburg,24590,8239,246,211,199,656,0.079621313
Chicago,60067,36725,1009,935,980,2924,0.079618788
Tallahassee-Thomasville,39845,8390,248,221,199,668,0.079618594
Hartford & New Haven,6091,314,9,11,5,25,0.079617834
Shreveport,71031,628,16,12,22,50,0.079617834
Richmond-Petersburg,23856,829,20,21,25,66,0.079613993
Chicago,47943,829,26,21,19,66,0.079613993
Kansas City,66013,2374,82,65,42,189,0.079612468
Lincoln & Hastings-Krny,68930,1231,46,19,33,98,0.079610073
"Washington, DC (Hagrstwn)",22718,716,22,18,17,57,0.079608939
Cincinnati,41001,20174,649,494,463,1606,0.079607415
"Jackson, MS",39040,3040,97,78,67,242,0.079605263
Springfield-Holyoke,1071,1608,36,39,53,128,0.07960199
Wheeling-Steubenville,26348,201,4,5,7,16,0.07960199
"Albany, GA",31772,402,10,12,10,32,0.07960199
Toledo,45890,603,17,11,20,48,0.07960199
"Springfield, MO",65769,3216,107,77,72,256,0.07960199
Lake Charles,70653,3015,87,91,62,240,0.07960199
Denver,82731,201,7,5,4,16,0.07960199
"Washington, DC (Hagrstwn)",21780,1696,46,43,46,135,0.079599057
Philadelphia,19465,18430,580,476,411,1467,0.079598481
Johnstown-Altoona-St Colge,15851,6470,190,160,165,515,0.079598145
Pittsburgh,15714,6244,184,167,146,497,0.079596413
Harrisburg-Lncstr-Leb-York,17040,2676,67,73,73,213,0.079596413
Savannah,31567,691,18,17,20,55,0.07959479
Watertown,13659,490,17,13,9,39,0.079591837
Des Moines-Ames,50174,1470,53,39,25,117,0.079591837
Wichita-Hutchinson Plus,67859,490,13,14,12,39,0.079591837
Montgomery-Selma,36022,15115,459,406,338,1203,0.079589811
Santabarbra-Sanmar-Sanluob,93427,5805,183,166,113,462,0.079586563
Tulsa,74073,6559,206,165,151,522,0.079585303
"Rochester, NY",14551,5202,150,141,123,414,0.079584775
"Washington, DC (Hagrstwn)",22603,17730,524,460,427,1411,0.079582628
"Washington, DC (Hagrstwn)",20124,14551,468,413,277,1158,0.079582159
Cleveland-Akron (Canton),44024,23523,697,641,534,1872,0.079581686
St. Louis,62854,1621,40,44,45,129,0.079580506
Detroit,48348,25723,832,691,524,2047,0.079578587
"Columbus, OH",43145,1797,51,48,44,143,0.079577073
Greensboro-H.Point-W.Salem,27051,8872,247,242,217,706,0.079576195
Charleston-Huntington,25545,6120,165,163,159,487,0.079575163
Cleveland-Akron (Canton),44256,65952,1985,1694,1569,5248,0.079573023
Jacksonville,32095,25236,839,617,552,2008,0.07956887
Grand Rapids-Kalmzoo-B.Crk,49097,10972,341,284,248,873,0.079566168
"Albany, GA",39870,2300,62,52,69,183,0.079565217
Orlando-Daytona Bch-Melbrn,32617,4575,136,129,99,364,0.079562842
Mobile-Pensacola (Ft Walt),32533,31837,959,780,794,2533,0.079561516
Joplin-Pittsburg,64748,1458,48,33,35,116,0.079561043
New York,7069,6825,192,192,159,543,0.07956044
Birmingham (Ann and Tusc),35207,7818,199,198,225,622,0.07955999
Charlotte,28023,15347,443,366,412,1221,0.079559523
San Diego,92131,36439,1178,1032,689,2899,0.079557617
Chattanooga,30707,16089,458,410,412,1280,0.079557462
Charlottesville,23022,1081,40,19,27,86,0.079555967
"Jackson, MS",39663,2514,79,63,58,200,0.079554495
Nashville,37398,16517,441,433,440,1314,0.079554398
Sacramnto-Stkton-Modesto,95742,21043,668,455,551,1674,0.079551395
New York,7726,45644,1384,1188,1059,3631,0.079550434
Seattle-Tacoma,98146,29428,745,745,851,2341,0.079550088
Evansville,42409,2489,81,68,49,198,0.07955002
Knoxville,40873,2753,88,72,59,219,0.079549582
Wilkes Barre-Scranton-Hztn,18224,6914,185,178,187,550,0.079548742
Omaha,68008,12810,425,320,274,1019,0.079547229
Mobile-Pensacola (Ft Walt),36454,88,2,2,3,7,0.079545455
Minneapolis-St. Paul,55335,1496,54,40,25,119,0.079545455
Corpus Christi,78391,264,9,8,4,21,0.079545455
San Francisco-Oak-San Jose,95429,88,3,2,2,7,0.079545455
Youngstown,44481,9605,261,259,244,764,0.079541905
New York,8741,2879,82,78,69,229,0.079541507
Montgomery-Selma,36093,12899,427,322,277,1026,0.07954105
New York,8734,7405,217,185,187,589,0.079540851
Wichita-Hutchinson Plus,67050,2087,73,48,45,166,0.07954001
"Washington, DC (Hagrstwn)",25405,15766,451,363,440,1254,0.079538247
Minneapolis-St. Paul,56069,5004,142,123,133,398,0.079536371
Providence-New Bedford,2920,37430,881,954,1142,2977,0.079535132
Dallas-Ft. Worth,76020,34841,1026,903,842,2771,0.079532734
Sioux City,68767,3219,114,73,69,256,0.079527804
Charleston-Huntington,41255,1270,38,36,27,101,0.079527559
Seattle-Tacoma,98422,21477,609,547,552,1708,0.079526936
Miami-Ft. Lauderdale,33174,30330,664,864,884,2412,0.079525223
Richmond-Petersburg,23233,32493,943,831,810,2584,0.079524821
Louisville,42716,1597,55,36,36,127,0.079524108
Atlanta,30107,18712,590,473,425,1488,0.079521163
Fargo,56725,918,31,22,20,73,0.079520697
Greensboro-H.Point-W.Salem,27310,9092,328,251,144,723,0.079520458
"Portland, OR",97045,57910,1656,1487,1462,4605,0.079519945
Sioux Falls(Mitchell),56134,415,12,12,9,33,0.079518072
Lincoln & Hastings-Krny,68938,415,15,10,8,33,0.079518072
Davenport-R.Island-Moline,61279,981,32,18,28,78,0.079510703
Dallas-Ft. Worth,76070,654,24,17,11,52,0.079510703
Baltimore,21014,38863,1091,999,1000,3090,0.079510074
Charleston-Huntington,25082,1874,59,50,40,149,0.079509072
Shreveport,75551,9848,295,261,227,783,0.07950853
New Orleans,70435,21508,645,549,516,1710,0.0795053
Huntsville-Decatur (Flor),35759,11333,351,286,264,901,0.079502338
Charleston-Huntington,41567,239,6,5,8,19,0.079497908
Wilkes Barre-Scranton-Hztn,18071,10680,306,262,281,849,0.079494382
Charleston-Huntington,25039,2214,70,52,54,176,0.079494128
San Diego,92064,48054,1425,1303,1092,3820,0.079493903
Cincinnati,45249,13435,385,345,338,1068,0.079493859
Eugene,97448,14404,413,376,356,1145,0.079491808
Dallas-Ft. Worth,76691,7133,204,197,166,567,0.079489696
Youngstown,43920,21110,569,577,532,1678,0.079488394
Gainesville,32669,18833,635,469,393,1497,0.079488133
Chicago,60448,24834,707,669,598,1974,0.079487799
New York,10522,11700,343,309,278,930,0.079487179
Cedar Rapids-Wtrlo-IWC&Dub,52323,780,28,20,14,62,0.079487179
Sioux Falls(Mitchell),57374,390,16,9,6,31,0.079487179
Burlington-Plattsburgh,12916,2164,66,61,45,172,0.07948244
New York,7936,11034,258,355,264,877,0.079481602
New York,6614,33807,933,853,901,2687,0.079480581
Shreveport,74740,1925,68,50,35,153,0.079480519
Philadelphia,19567,6090,176,152,156,484,0.079474548
Harrisburg-Lncstr-Leb-York,17304,3712,123,86,86,295,0.079471983
"Washington, DC (Hagrstwn)",20871,29885,1125,719,531,2375,0.079471307
Columbus-Tupelo-West Point,38844,151,5,4,3,12,0.079470199
Sacramnto-Stkton-Modesto,95970,453,16,11,9,36,0.079470199
St. Louis,62849,2026,61,49,51,161,0.07946693
Denver,82604,26615,772,675,668,2115,0.079466466
Greenville-N.Bern-Washngtn,28523,2391,72,64,54,190,0.079464659
Shreveport,71060,2756,72,73,74,219,0.07946299
Omaha,51528,818,24,20,21,65,0.079462103
Tulsa,74047,6758,227,176,134,537,0.079461379
Chattanooga,37313,1334,38,35,33,106,0.07946027
Colorado Springs-Pueblo,81067,5336,181,139,104,424,0.07946027
Nashville,37052,3184,101,81,71,253,0.079459799
Sioux Falls(Mitchell),57366,2366,77,58,53,188,0.079459003
New York,11792,7828,219,214,189,622,0.079458355
Johnstown-Altoona-St Colge,15554,2731,81,67,69,217,0.079458074
Chattanooga,37377,17481,626,468,295,1389,0.079457697
Cleveland-Akron (Canton),44093,1397,45,33,33,111,0.079455977
Indianapolis,46050,1611,54,40,34,128,0.079453755
Boston (Manchester),1906,29917,695,834,848,2377,0.079453154
Philadelphia,8628,10006,206,243,346,795,0.079452329
Des Moines-Ames,50420,365,12,7,10,29,0.079452055
Sioux Falls(Mitchell),57560,365,14,9,6,29,0.079452055
Kansas City,64670,1095,31,31,25,87,0.079452055
Green Bay-Appleton,54157,5903,174,152,143,469,0.079451127
Chicago,60103,40453,1216,1008,990,3214,0.079450226
Des Moines-Ames,50058,1888,54,43,53,150,0.079449153
Wichita-Hutchinson Plus,67227,579,18,18,10,46,0.079447323
Des Moines-Ames,50247,2379,88,60,41,189,0.079445145
Houston,75936,793,28,17,18,63,0.079445145
Zanesville,43767,1435,49,34,31,114,0.079442509
Norfolk-Portsmth-Newpt Nws,23878,1070,33,29,23,85,0.079439252
Champaign&Sprngfld-Decatur,61957,1926,56,53,44,153,0.079439252
Paducah-Cape Girard-Harsbg,63952,428,15,12,7,34,0.079439252
Amarillo,79063,642,27,14,10,51,0.079439252
San Francisco-Oak-San Jose,94805,15358,378,407,435,1220,0.079437427
Burlington-Plattsburgh,5661,6181,159,154,178,491,0.079436984
"Washington, DC (Hagrstwn)",26704,5753,194,133,130,457,0.079436816
Milwaukee,53007,1775,44,50,47,141,0.07943662
Chattanooga,28901,5237,153,136,127,416,0.079434791
Joplin-Pittsburg,66771,919,26,26,21,73,0.079434168
Flint-Saginaw-Bay City,48746,7944,245,205,181,631,0.079431017
Paducah-Cape Girard-Harsbg,42050,3160,83,79,89,251,0.07943038
Fargo,56544,5527,192,142,105,439,0.079428261
Greenvll-Spart-Ashevll-And,29321,2581,71,65,69,205,0.079426579
Minneapolis-St. Paul,55307,3135,107,72,70,249,0.079425837
Houston,77872,1939,59,47,48,154,0.079422383
Nashville,37033,7945,228,212,191,631,0.07942102
Harlingen-Wslco-Brnsvl-Mca,78578,10262,342,252,221,815,0.079419217
Burlington-Plattsburgh,12958,2065,65,44,55,164,0.079418886
Paducah-Cape Girard-Harsbg,63834,5641,156,160,132,448,0.079418543
Baltimore,21060,40142,926,1002,1260,3188,0.079418066
Cleveland-Akron (Canton),44608,2405,75,56,60,191,0.079417879
Boston (Manchester),1331,13788,372,389,334,1095,0.079416884
Greenwood-Greenville,38943,617,18,15,16,49,0.079416532
New York,11782,15891,430,441,391,1262,0.079416022
Oklahoma City,73727,340,10,10,7,27,0.079411765
Houston,77406,70533,2279,1701,1621,5601,0.079409638
Columbia-Jefferson City,65559,9407,288,255,204,747,0.079408951
Huntsville-Decatur (Flor),35803,30199,850,745,803,2398,0.079406603
Paducah-Cape Girard-Harsbg,62930,5390,145,127,156,428,0.079406308
Charlottesville,22732,403,11,10,11,32,0.079404467
Indianapolis,47451,1209,24,32,40,96,0.079404467
Champaign&Sprngfld-Decatur,62601,403,10,10,12,32,0.079404467
Terre Haute,62477,869,29,20,20,69,0.079401611
Greensboro-H.Point-W.Salem,27024,2670,62,66,84,212,0.079400749
Ft. Wayne,47336,3262,85,92,82,259,0.079399142
Baltimore,21403,30479,734,797,889,2420,0.07939893
Champaign&Sprngfld-Decatur,62691,2393,69,59,62,190,0.079398245
Charlottesville,22968,11512,362,292,260,914,0.079395413
Columbus-Tupelo-West Point,38847,2960,89,72,74,235,0.079391892
Paducah-Cape Girard-Harsbg,62860,592,18,16,13,47,0.079391892
Paducah-Cape Girard-Harsbg,42053,4799,155,128,98,381,0.07939154
Louisville,42349,1247,40,32,27,99,0.079390537
Louisville,40243,12533,318,347,330,995,0.079390409
"Tri-Cities, TN-VA",41824,655,18,17,17,52,0.079389313
St. Louis,63069,16375,446,443,411,1300,0.079389313
Philadelphia,8007,5429,145,131,155,431,0.079388469
Amarillo,79059,718,27,12,18,57,0.079387187
Wilkes Barre-Scranton-Hztn,17851,7243,189,194,192,575,0.079386994
New York,10707,10896,295,300,270,865,0.079386931
Ft. Wayne,46776,1499,35,45,39,119,0.079386258
Burlington-Plattsburgh,5301,17107,395,542,421,1358,0.079382709
New York,8514,4598,146,121,98,365,0.07938234
Wichita-Hutchinson Plus,67062,3754,120,96,82,298,0.079381993
Des Moines-Ames,50211,16301,554,403,337,1294,0.079381633
"Columbus, GA (Opelika, AL)",39851,2129,66,59,44,169,0.079379991
"Columbus, OH",45601,56452,1539,1452,1490,4481,0.07937717
New York,11379,38084,941,1004,1078,3023,0.079377166
"Columbus, OH",43302,53290,1394,1445,1391,4230,0.079376994
New York,7649,8378,262,221,182,665,0.079374552
Nashville,38231,1852,52,49,46,147,0.07937365
Minneapolis-St. Paul,55311,38338,1384,916,743,3043,0.079372946
Madison,53597,21733,769,584,372,1725,0.079372383
San Francisco-Oak-San Jose,95035,85333,1920,2123,2730,6773,0.079371404
"Albany, GA",39842,7698,199,211,201,611,0.079371265
"Tri-Cities, TN-VA",24251,8517,237,224,215,676,0.07937067
Tampa-St. Pete (Sarasota),34266,29961,855,770,753,2378,0.079369847
New York,12401,35543,868,960,993,2821,0.079368652
Des Moines-Ames,50548,5758,195,144,118,457,0.079367836
Binghamton,13748,3717,92,83,120,295,0.079365079
"Tri-Cities, TN-VA",24646,567,17,15,13,45,0.079365079
Rochestr-Mason City-Austin,50434,441,11,13,11,35,0.079365079
Jonesboro,72458,567,18,13,14,45,0.079365079
Tulsa,74472,567,17,13,15,45,0.079365079
Beaumont-Port Arthur,77660,1449,48,35,32,115,0.079365079
Boise,83602,63,2,1,2,5,0.079365079
Macon,31028,6439,178,166,167,511,0.079360149
Charlotte,27013,6376,184,160,162,506,0.0793601
Des Moines-Ames,50250,2369,76,56,56,188,0.079358379
Buffalo,14217,22191,476,591,694,1761,0.079356496
New York,8512,12677,347,333,326,1006,0.079356315
Bowling Green,42171,7498,228,186,181,595,0.079354495
"Washington, DC (Hagrstwn)",21754,8910,301,218,188,707,0.079349046
Binghamton,13750,983,28,27,23,78,0.079348932
Cleveland-Akron (Canton),44087,22673,665,587,547,1799,0.079345477
Charleston-Huntington,41139,8104,242,201,200,643,0.079343534
Butte-Bozeman,59741,6075,207,161,114,482,0.079341564
Omaha,51530,668,21,17,15,53,0.079341317
Duluth-Superior,55750,2004,66,53,40,159,0.079341317
Harrisburg-Lncstr-Leb-York,17038,7764,242,191,183,616,0.079340546
Traverse City-Cadillac,49337,12869,373,338,310,1021,0.079337944
Cincinnati,45107,9907,291,243,252,786,0.079337842
Lincoln & Hastings-Krny,68662,1084,30,32,24,86,0.079335793
Green Bay-Appleton,54974,1563,53,38,33,124,0.079334613
Nashville,37051,4374,134,116,97,347,0.079332419
"Columbus, OH",43973,1853,57,46,44,147,0.079330815
Denver,80207,20888,549,546,562,1657,0.079327844
Mobile-Pensacola (Ft Walt),36436,416,11,11,11,33,0.079326923
New York,7405,17901,499,463,458,1420,0.079325177
Reno,89310,706,25,15,16,56,0.079320113
Savannah,31303,2408,77,57,57,191,0.079318937
"Rochester, NY",14837,5043,145,136,119,400,0.079317866
St. Louis,62690,3631,101,104,83,288,0.079316993
Paducah-Cape Girard-Harsbg,62906,7174,200,198,171,569,0.07931419
Birmingham (Ann and Tusc),35135,1866,45,44,59,148,0.079314041
New York,11716,10137,289,257,258,804,0.079313406
St. Louis,65066,6405,193,149,166,508,0.079313037
Louisville,42782,870,25,24,20,69,0.079310345
Los Angeles,90808,37927,1024,1028,956,3008,0.079310254
Hartford & New Haven,6239,10894,264,282,318,864,0.079309712
Evansville,47598,3127,99,76,73,248,0.079309242
Portland-Auburn,4252,4804,126,111,144,381,0.079308909
Knoxville,37766,17981,464,495,467,1426,0.079305934
Spokane,99111,4262,134,101,103,338,0.07930549
Pittsburgh,16038,3455,90,93,91,274,0.079305355
Kansas City,64620,517,15,14,12,41,0.079303675
Cleveland-Akron (Canton),44866,2295,77,54,51,182,0.079302832
Elmira (Corning),16917,1261,40,33,27,100,0.079302141
"Tri-Cities, TN-VA",24281,2232,72,53,52,177,0.079301075
Chicago,46310,14237,436,363,330,1129,0.079300414
Greenvll-Spart-Ashevll-And,30538,2913,97,67,67,231,0.079299691
Cincinnati,47031,4893,144,112,132,388,0.079296955
Albany-Schenectady-Troy,12071,227,7,5,6,18,0.079295154
Meridian,36919,2043,54,55,53,162,0.079295154
Minneapolis-St. Paul,54020,7491,235,188,171,594,0.079295154
Champaign&Sprngfld-Decatur,61844,908,25,22,25,72,0.079295154
Joplin-Pittsburg,66779,681,25,17,12,54,0.079295154
Chicago,61341,7819,208,215,197,620,0.079294027
Madison,53813,6306,207,139,154,500,0.079289565
Champaign&Sprngfld-Decatur,60942,5499,150,138,148,436,0.079287143
Charleston-Huntington,25524,3254,100,85,73,258,0.079287031
Bluefield-Beckley-Oak Hill,25831,1627,43,43,43,129,0.079287031
Minneapolis-St. Paul,56266,1627,50,45,34,129,0.079287031
San Francisco-Oak-San Jose,94583,40108,1337,1043,800,3180,0.079285928
New York,7110,29211,731,788,797,2316,0.079285201
Omaha,68301,1728,64,42,31,137,0.079282407
Cleveland-Akron (Canton),44264,3620,99,90,98,287,0.079281768
Burlington-Plattsburgh,12917,1501,47,39,33,119,0.07928048
Sioux Falls(Mitchell),56185,555,17,15,12,44,0.079279279
Tucson (Sierra Vista),85742,33073,945,804,873,2622,0.07927917
Rochestr-Mason City-Austin,56036,1766,54,50,36,140,0.079275198
Quincy-Hannibal-Keokuk,62321,3835,119,79,106,304,0.079269883
Detroit,48381,13574,386,353,337,1076,0.079269191
Dallas-Ft. Worth,76088,14987,439,391,358,1188,0.0792687
Burlington-Plattsburgh,12998,492,16,11,12,39,0.079268293
Lexington,41408,328,9,9,8,26,0.079268293
Wheeling-Steubenville,43902,164,5,4,4,13,0.079268293
Louisville,40162,6333,211,161,130,502,0.07926733
"Columbia, SC",29126,2334,71,62,52,185,0.079263068
Cincinnati,41043,1678,51,49,33,133,0.079261025
Hartford & New Haven,6033,29649,900,772,678,2350,0.079260683
Des Moines-Ames,50049,6220,164,163,166,493,0.07926045
Charlotte,28128,7242,212,184,178,574,0.079259873
"Springfield, MO",65789,1779,58,43,40,141,0.07925801
Atlanta,30317,14598,231,313,613,1157,0.079257433
Ottumwa-Kirksville,63546,1451,44,37,34,115,0.079255686
Indianapolis,46017,6170,157,149,183,489,0.079254457
Charleston-Huntington,41659,429,14,11,9,34,0.079254079
Little Rock-Pine Bluff,72024,3432,100,91,81,272,0.079254079
Indianapolis,46077,37639,1383,864,736,2983,0.079252903
Davenport-R.Island-Moline,61379,1123,32,29,28,89,0.079252004
Duluth-Superior,55746,17085,491,446,417,1354,0.079250805
Birmingham (Ann and Tusc),35098,1388,35,35,40,110,0.07925072
San Francisco-Oak-San Jose,94559,28303,712,732,799,2243,0.07924955
Charleston-Huntington,25235,959,32,23,21,76,0.079249218
Oklahoma City,73004,959,30,25,21,76,0.079249218
Chicago,60130,14322,211,320,604,1135,0.079248708
Minneapolis-St. Paul,55349,4240,112,124,100,336,0.079245283
Little Rock-Pine Bluff,72523,795,29,19,15,63,0.079245283
Columbus-Tupelo-West Point,38878,2486,60,76,61,197,0.079243765
Nashville,42166,2587,73,69,63,205,0.079242366
"Springfield, MO",65705,3748,103,104,90,297,0.079242263
Kansas City,66021,2688,81,75,57,213,0.079241071
Cleveland-Akron (Canton),44685,28382,890,728,631,2249,0.079240364
New York,7717,1893,42,51,57,150,0.079239303
Macon,30233,27234,749,690,719,2158,0.079239186
Buffalo,14482,8405,215,216,235,666,0.079238548
Clarksburg-Weston,26448,997,36,26,17,79,0.079237713
Minneapolis-St. Paul,55317,21102,687,549,436,1672,0.079234196
Sacramnto-Stkton-Modesto,95762,50951,1860,1361,816,4037,0.079232989
Baton Rouge,70755,1666,44,42,46,132,0.079231693
"Washington, DC (Hagrstwn)",22611,9630,286,280,197,763,0.079231568
Detroit,48088,22731,496,627,678,1801,0.079231006
Chicago,60137,38206,1173,1055,799,3027,0.079228393
Boston (Manchester),1534,5907,170,138,160,468,0.079228035
Grand Rapids-Kalmzoo-B.Crk,49448,4140,128,109,91,328,0.079227053
Traverse City-Cadillac,49735,21104,606,520,546,1672,0.079226687
Dayton,45822,19703,563,489,509,1561,0.079226514
Lexington,40484,12092,331,312,315,958,0.079225935
Macon,31216,16611,422,430,464,1316,0.07922461
Jacksonville,32054,12736,393,306,310,1009,0.079224246
Toledo,43525,1237,44,31,23,98,0.079223929
Portland-Auburn,4289,1906,59,47,45,151,0.079223505
Grand Rapids-Kalmzoo-B.Crk,49079,13683,407,354,323,1084,0.079222393
Greensboro-H.Point-W.Salem,27341,5289,154,137,128,419,0.079221025
Charleston-Huntington,41601,770,22,20,19,61,0.079220779
Lansing,48837,20260,570,559,476,1605,0.079220138
Baltimore,21122,62551,1674,1628,1653,4955,0.07921536
San Francisco-Oak-San Jose,94954,37253,1009,1002,940,2951,0.079215097
Reno,89447,8698,281,206,202,689,0.079213612
Pittsburgh,16347,1881,56,49,44,149,0.079213184
Norfolk-Portsmth-Newpt Nws,27973,1982,59,49,49,157,0.079212916
Dayton,45432,14594,416,362,378,1156,0.079210635
Springfield-Holyoke,1376,5214,122,156,135,413,0.07920982
Wilkes Barre-Scranton-Hztn,18851,808,27,18,19,64,0.079207921
Philadelphia,19454,29328,777,774,772,2323,0.079207583
Baltimore,21050,19065,566,487,457,1510,0.079202728
Albuquerque-Santa Fe,87510,1553,49,40,34,123,0.079201545
Huntsville-Decatur (Flor),37348,1250,44,28,27,99,0.0792
Mobile-Pensacola (Ft Walt),32507,31693,803,858,849,2510,0.079197299
Chattanooga,37324,5278,140,144,134,418,0.079196665
Richmond-Petersburg,23106,1389,41,33,36,110,0.079193665
Parkersburg,26187,6200,181,167,143,491,0.079193548
Harrisburg-Lncstr-Leb-York,17221,644,18,18,15,51,0.079192547
Greensboro-H.Point-W.Salem,27315,1932,50,55,48,153,0.079192547
Dallas-Ft. Worth,76389,1187,37,31,26,94,0.079191238
Dothan,36009,2273,57,58,65,180,0.079190497
Monroe-El Dorado,71226,1528,51,41,29,121,0.079188482
Phoenix (Prescott),85253,18387,546,515,395,1456,0.079186382
Sioux Falls(Mitchell),57569,442,17,11,7,35,0.07918552
Lexington,40322,3132,102,76,70,248,0.079182631
Harrisburg-Lncstr-Leb-York,17532,3473,100,90,85,275,0.079182263
"Rochester, NY",14626,29641,740,733,874,2347,0.079180864
Louisville,47138,4294,139,107,94,340,0.079180252
Bangor,4455,922,28,26,19,73,0.079175705
St. Louis,62056,8071,230,207,202,639,0.079172345
Kansas City,64661,821,24,25,16,65,0.079171742
St. Louis,63123,50562,1156,1302,1545,4003,0.079170128
St. Louis,62086,1301,41,36,26,103,0.079169869
New York,12780,2261,56,55,68,179,0.07916851
Chattanooga,35746,720,20,21,16,57,0.079166667
Abilene-Sweetwater,79510,8274,256,212,187,655,0.079163645
Atlanta,30082,29168,675,787,847,2309,0.079162095
San Francisco-Oak-San Jose,94304,4434,70,105,176,351,0.079161028
Rochestr-Mason City-Austin,50479,619,13,18,18,49,0.079159935
Bismarck-Mnt-Dcknsn(Wlstn),58622,1857,62,37,48,147,0.079159935
Amarillo,88401,6607,183,183,157,523,0.079158468
Seattle-Tacoma,98059,41866,1294,1053,967,3314,0.079157311
Paducah-Cape Girard-Harsbg,38225,6064,178,157,145,480,0.079155673
Minneapolis-St. Paul,55333,758,21,22,17,60,0.079155673
Nashville,37145,2552,74,65,63,202,0.079153605
Johnstown-Altoona-St Colge,15956,2729,69,74,73,216,0.079149872
Portland-Auburn,4068,1693,52,44,38,134,0.079149439
Chicago,46341,10424,314,272,239,825,0.079144282
Cleveland-Akron (Canton),44699,1074,36,29,20,85,0.079143389
Pittsburgh,16101,31121,849,794,820,2463,0.079142701
Kansas City,66220,8529,322,202,151,675,0.079141752
Buffalo,14024,1491,51,33,34,118,0.079141516
Orlando-Daytona Bch-Melbrn,34475,14228,368,372,386,1126,0.079139724
Lincoln & Hastings-Krny,69130,4928,139,116,135,390,0.07913961
St. Louis,63044,11145,311,286,285,882,0.079138627
Davenport-R.Island-Moline,52730,4966,146,116,131,393,0.079138139
New York,10535,834,20,23,23,66,0.079136691
San Angelo,76940,139,5,3,3,11,0.079136691
Shreveport,71071,2818,77,69,77,223,0.079134138
Atlanta,30733,1984,54,57,46,157,0.079133065
"Columbus, OH",43011,8012,233,223,178,634,0.079131303
Roanoke-Lynchburg,24323,872,26,22,21,69,0.07912844
Evansville,62842,733,23,15,20,58,0.079126876
Charleston-Huntington,25266,594,16,16,15,47,0.079124579
Chattanooga,35769,10730,277,289,283,849,0.079123952
Springfield-Holyoke,1035,5384,125,120,181,426,0.079123328
Denver,80734,3008,101,74,63,238,0.07912234
Pittsburgh,15442,2275,55,60,65,180,0.079120879
Kansas City,64064,20412,664,509,442,1615,0.079120125
Philadelphia,18017,39952,1091,1023,1047,3161,0.079119944
Minneapolis-St. Paul,55014,28716,860,723,689,2272,0.079119655
Nashville,37101,6661,191,154,182,527,0.07911725
Syracuse,13142,6522,209,150,157,516,0.079116835
Louisville,47260,1719,47,47,42,136,0.079115765
Grand Rapids-Kalmzoo-B.Crk,49067,4386,147,109,91,347,0.079115367
Greensboro-H.Point-W.Salem,27295,40966,1187,1046,1008,3241,0.079114388
New York,11694,19276,499,495,531,1525,0.079113924
Macon,31812,316,7,9,9,25,0.079113924
Knoxville,38589,316,10,7,8,25,0.079113924
Sioux Falls(Mitchell),57349,1479,44,36,37,117,0.079107505
Marquette,49829,17192,467,451,442,1360,0.079106561
Dayton,45359,1656,61,36,34,131,0.07910628
Albany-Schenectady-Troy,12077,6131,176,175,134,485,0.079106182
Baton Rouge,70740,1163,30,33,29,92,0.079105761
Paducah-Cape Girard-Harsbg,63937,1833,59,47,39,145,0.079105292
Davenport-R.Island-Moline,61283,1517,43,39,38,120,0.079103494
Boston (Manchester),1982,7939,272,206,150,628,0.079103162
Miami-Ft. Lauderdale,33135,37092,805,997,1132,2934,0.079100615
Knoxville,38553,2579,82,61,61,204,0.079100427
Albany-Schenectady-Troy,12450,177,4,5,5,14,0.079096045
Nashville,42167,8193,221,217,210,648,0.079091908
Cincinnati,45247,22583,636,576,574,1786,0.079086038
Macon,31002,2883,82,73,73,228,0.079084287
Davenport-R.Island-Moline,52645,3275,89,82,88,259,0.079083969
Charlotte,28080,9117,263,251,207,721,0.079083032
"Columbus, OH",45673,392,11,10,10,31,0.079081633
Great Falls,59520,1568,59,36,29,124,0.079081633
Cedar Rapids-Wtrlo-IWC&Dub,52315,1214,44,27,25,96,0.07907743
St. Louis,63664,8321,252,210,196,658,0.079077034
Cleveland-Akron (Canton),44904,15188,442,401,358,1201,0.079075586
Phoenix (Prescott),85310,19513,596,504,443,1543,0.079075488
Charleston-Huntington,25262,822,22,21,22,65,0.079075426
Flint-Saginaw-Bay City,48626,5577,166,148,127,441,0.079074771
Richmond-Petersburg,23954,1897,54,52,44,150,0.079072219
Topeka,66419,430,14,10,10,34,0.079069767
Wichita-Hutchinson Plus,67023,215,8,3,6,17,0.079069767
Peoria-Bloomington,61569,1113,37,30,21,88,0.079065588
"Washington, DC (Hagrstwn)",25427,17100,533,422,397,1352,0.079064327
New York,6907,9233,227,235,268,730,0.079064226
Shreveport,71855,683,22,16,16,54,0.079062958
Salt Lake City,84051,468,14,13,10,37,0.079059829
Des Moines-Ames,50595,8715,243,220,226,689,0.079059094
"Washington, DC (Hagrstwn)",25420,5009,152,108,136,396,0.079057696
Atlanta,30137,1442,44,36,34,114,0.079056865
Louisville,47108,2163,66,55,50,171,0.079056865
Ft. Smith-Fay-Sprngdl-Rgrs,72717,974,29,26,22,77,0.079055441
San Antonio,78006,48245,1619,1232,963,3814,0.079054824
Nashville,38460,1227,36,29,32,97,0.079054605
Wichita-Hutchinson Plus,67058,1733,56,42,39,137,0.079053664
Miami-Ft. Lauderdale,33069,29866,631,831,899,2361,0.079053104
St. Louis,63011,37671,1165,943,870,2978,0.079052852
Minneapolis-St. Paul,55319,6034,197,166,114,477,0.079052038
Tampa-St. Pete (Sarasota),34207,35496,876,939,991,2806,0.079051161
Chattanooga,37353,4921,140,131,118,389,0.079048974
Bangor,4427,3150,86,83,80,249,0.079047619
Wilkes Barre-Scranton-Hztn,17812,1341,46,37,23,106,0.079045488
Binghamton,13904,8919,226,233,246,705,0.079044736
Casper-Riverton,82636,4605,141,116,107,364,0.079044517
Cedar Rapids-Wtrlo-IWC&Dub,52320,1088,34,29,23,86,0.079044118
Indianapolis,46118,4934,142,118,130,390,0.079043373
Hattiesburg-Laurel,39464,2505,71,70,57,198,0.079041916
Toledo,43617,6971,218,184,149,551,0.079041744
"Rochester, NY",14476,2252,59,62,57,178,0.079040853
New York,7747,32895,813,825,962,2600,0.079039368
Boston (Manchester),3801,23811,487,557,838,1882,0.0790391
Huntsville-Decatur (Flor),35670,8034,230,205,200,635,0.079039084
Los Angeles,91206,32592,668,827,1081,2576,0.079037801
Dayton,45325,2366,69,63,55,187,0.079036348
Champaign&Sprngfld-Decatur,60953,1784,47,54,40,141,0.079035874
New York,7403,7579,158,204,237,599,0.079034173
St. Louis,62240,1531,42,36,43,121,0.079033312
Birmingham (Ann and Tusc),35983,3581,84,100,99,283,0.079028204
New York,7034,9794,223,245,306,774,0.079027976
Sioux Falls(Mitchell),57076,329,12,8,6,26,0.079027356
Jonesboro,72469,1316,35,30,39,104,0.079027356
Abilene-Sweetwater,79502,1025,32,28,21,81,0.07902439
Boston (Manchester),3263,4176,108,97,125,330,0.079022989
"Washington, DC (Hagrstwn)",25446,1430,35,41,37,113,0.079020979
Tampa-St. Pete (Sarasota),34286,23956,720,593,580,1893,0.07901987
Elmira (Corning),14885,734,14,25,19,58,0.079019074
Bluefield-Beckley-Oak Hill,25837,367,10,10,9,29,0.079019074
Nashville,37359,734,24,20,14,58,0.079019074
Kansas City,64454,2569,75,72,56,203,0.079019074
Cleveland-Akron (Canton),44130,50115,1048,1291,1621,3960,0.079018258
"Columbus, OH",43071,2240,64,57,56,177,0.079017857
Portland-Auburn,4239,4670,160,105,104,369,0.079014989
Syracuse,13165,10150,287,258,257,802,0.079014778
Minneapolis-St. Paul,55367,1177,40,28,25,93,0.079014444
Las Vegas,89011,43815,1096,1128,1238,3462,0.079014036
Presque Isle,4730,9682,301,232,232,765,0.079012601
Johnstown-Altoona-St Colge,16859,405,12,10,10,32,0.079012346
Fargo,56557,2949,84,76,73,233,0.079009834
Oklahoma City,73067,1772,55,39,46,140,0.079006772
Montgomery-Selma,36003,1810,47,46,50,143,0.079005525
New York,7462,6734,174,166,192,532,0.079002079
Lexington,41847,481,19,12,7,38,0.079002079
New York,7702,3962,142,89,82,313,0.079000505
Greenvll-Spart-Ashevll-And,28789,6962,216,154,180,550,0.079000287
Montgomery-Selma,36105,9785,259,258,256,773,0.078998467
Little Rock-Pine Bluff,72072,519,14,10,17,41,0.078998073
Chicago,60096,6608,178,164,180,522,0.078995157
Grand Rapids-Kalmzoo-B.Crk,49089,1671,51,46,35,132,0.078994614
Cleveland-Akron (Canton),44260,12963,343,342,339,1024,0.07899406
St. Louis,62285,4570,152,109,100,361,0.078993435
Kansas City,64739,1152,34,30,27,91,0.078993056
Cincinnati,47006,12710,358,326,320,1004,0.078992919
Davenport-R.Island-Moline,52769,633,20,14,16,50,0.078988942
Shreveport,71047,10293,273,275,265,813,0.078985718
Grand Rapids-Kalmzoo-B.Crk,48884,4406,132,104,112,348,0.078983205
Green Bay-Appleton,53919,2507,76,66,56,198,0.078978859
Buffalo,14138,1760,43,47,49,139,0.078977273
Nashville,37185,9104,241,246,232,719,0.078976274
Greenville-N.Bern-Washngtn,28349,3153,96,90,63,249,0.078972407
"Columbus, OH",45711,1165,37,30,25,92,0.078969957
Seattle-Tacoma,98520,24655,711,644,592,1947,0.078969783
Tulsa,74044,7826,234,195,189,618,0.078967544
Detroit,48082,16146,360,393,522,1275,0.078966927
Paducah-Cape Girard-Harsbg,63863,5129,157,134,114,405,0.078962761
Augusta-Aiken,30828,3698,99,104,89,292,0.078961601
Burlington-Plattsburgh,5495,11360,301,288,308,897,0.078961268
Charleston-Huntington,25508,10043,291,278,224,793,0.07896047
Youngstown,44484,22240,592,584,580,1756,0.078956835
St. Louis,62858,2951,88,79,66,233,0.078956286
Burlington-Plattsburgh,5833,38,1,1,1,3,0.078947368
New York,11579,4902,149,139,99,387,0.078947368
Johnstown-Altoona-St Colge,16821,152,4,4,4,12,0.078947368
Roanoke-Lynchburg,24570,38,1,1,1,3,0.078947368
Clarksburg-Weston,26210,38,1,1,1,3,0.078947368
Clarksburg-Weston,26230,114,3,4,2,9,0.078947368
Clarksburg-Weston,26268,114,4,3,2,9,0.078947368
Lexington,41421,342,10,8,9,27,0.078947368
Lexington,41861,190,6,5,4,15,0.078947368
Bowling Green,42163,38,1,1,1,3,0.078947368
Evansville,47552,190,7,5,3,15,0.078947368
Sioux Falls(Mitchell),57421,76,2,2,2,6,0.078947368
Fargo,58262,114,2,3,4,9,0.078947368
Chicago,61358,380,12,9,9,30,0.078947368
Champaign&Sprngfld-Decatur,61855,114,3,3,3,9,0.078947368
Quincy-Hannibal-Keokuk,62345,266,9,7,5,21,0.078947368
Quincy-Hannibal-Keokuk,62359,152,5,3,4,12,0.078947368
"Springfield, MO",65541,228,8,6,4,18,0.078947368
Topeka,66522,38,1,1,1,3,0.078947368
Little Rock-Pine Bluff,72584,646,19,14,18,51,0.078947368
Little Rock-Pine Bluff,72856,152,5,4,3,12,0.078947368
Oklahoma City,73061,1520,54,38,28,120,0.078947368
Albuquerque-Santa Fe,88421,38,1,1,1,3,0.078947368
San Francisco-Oak-San Jose,95141,76,2,2,2,6,0.078947368
Milwaukee,53925,8335,246,206,206,658,0.078944211
Houston,77486,8297,260,196,199,655,0.078944197
Greenvll-Spart-Ashevll-And,28792,37470,1026,951,981,2958,0.078943155
Las Vegas,89012,37242,1029,954,957,2940,0.078943129
Chicago,60119,11312,339,305,249,893,0.078942716
Miami-Ft. Lauderdale,33027,64617,1866,1668,1567,5101,0.078942074
"Columbus, GA (Opelika, AL)",36866,4003,113,103,100,316,0.078940794
Indianapolis,46923,8209,236,202,210,648,0.078937751
Dallas-Ft. Worth,75103,16089,481,435,354,1270,0.078935919
Knoxville,37821,23653,673,596,598,1867,0.078932905
Buffalo,14108,5435,158,140,131,429,0.078932843
Hartford & New Haven,6333,7703,255,189,164,608,0.078930287
Cedar Rapids-Wtrlo-IWC&Dub,52237,1533,56,36,29,121,0.078930202
Charleston-Huntington,45669,9895,302,239,240,781,0.078928752
Greensboro-H.Point-W.Salem,27320,38314,1033,961,1030,3024,0.078926763
Green Bay-Appleton,54143,15242,411,402,390,1203,0.07892665
Las Vegas,89052,64238,1769,1775,1526,5070,0.078925247
Greensboro-H.Point-W.Salem,27349,6462,183,161,166,510,0.078922934
Charlotte,28168,10618,320,268,250,838,0.078922584
Paducah-Cape Girard-Harsbg,42064,8122,249,192,200,641,0.078921448
Dallas-Ft. Worth,75853,1001,30,20,29,79,0.078921079
Norfolk-Portsmth-Newpt Nws,23851,13292,366,329,354,1049,0.078919651
Pittsburgh,15675,887,25,22,23,70,0.0789177
Boston (Manchester),3865,7907,194,192,238,624,0.078917415
Birmingham (Ann and Tusc),35179,9960,295,242,249,786,0.078915663
Syracuse,13355,811,25,20,19,64,0.07891492
Providence-New Bedford,2808,2319,67,64,52,183,0.078913325
Oklahoma City,74604,11988,357,312,277,946,0.078912246
Richmond-Petersburg,23093,15549,476,379,372,1227,0.078911827
"Washington, DC (Hagrstwn)",20639,16284,532,431,322,1285,0.078911815
New York,7435,2129,59,51,58,168,0.078910287
Spokane,99022,9302,294,226,214,734,0.078907762
Charleston-Huntington,25666,583,19,12,15,46,0.07890223
Chattanooga,37307,5171,152,122,134,408,0.078901566
Louisville,47106,4588,147,104,111,362,0.078901482
Green Bay-Appleton,54216,6071,173,165,141,479,0.078899687
New York,7869,25894,756,694,593,2043,0.078898587
New Orleans,70057,4208,120,103,109,332,0.078897338
Fresno-Visalia,93636,16997,511,450,380,1341,0.078896276
Lansing,49264,1952,61,50,43,154,0.078893443
Paducah-Cape Girard-Harsbg,63960,2890,90,72,66,228,0.078892734
Toledo,43430,4728,136,107,130,373,0.078891709
Bakersfield,93252,1407,36,32,43,111,0.078891258
St. Joseph,64504,9811,277,218,279,774,0.078891041
Detroit,48471,5679,165,134,149,448,0.078887128
La Crosse-Eau Claire,54667,4741,161,114,99,374,0.078886311
La Crosse-Eau Claire,54629,2510,82,54,62,198,0.078884462
Roanoke-Lynchburg,24147,824,20,22,23,65,0.078883495
Phoenix (Prescott),85137,2041,66,49,46,161,0.078882901
Albany-Schenectady-Troy,12822,6757,196,157,180,533,0.07888116
Utica,13406,393,11,10,10,31,0.078880407
Buffalo,14769,1179,39,31,23,93,0.078880407
Pittsburgh,15129,11397,270,304,325,899,0.078880407
"Washington, DC (Hagrstwn)",17233,5109,155,122,126,403,0.078880407
Detroit,49238,1572,40,45,39,124,0.078880407
Ft. Smith-Fay-Sprngdl-Rgrs,72863,1572,44,45,35,124,0.078880407
New York,7013,29006,733,742,813,2288,0.078880232
New York,10562,34483,901,923,896,2720,0.078879448
Jacksonville,32112,7746,222,197,192,611,0.078879422
Chicago,46340,1141,37,29,24,90,0.078878177
Mankato,56031,12006,340,313,294,947,0.078877228
New York,10512,24456,641,670,618,1929,0.078876349
Paducah-Cape Girard-Harsbg,63825,3943,119,98,94,311,0.078873954
Cincinnati,41044,1065,33,26,25,84,0.078873239
New York,10989,8837,243,214,240,697,0.078872921
Omaha,51579,2409,75,53,62,190,0.078870901
Madison,53807,4463,133,115,104,352,0.078870715
Spokane,99169,2688,78,66,68,212,0.078869048
Tampa-St. Pete (Sarasota),34668,49259,1244,1300,1341,3885,0.078868836
Sacramnto-Stkton-Modesto,95650,14074,457,370,283,1110,0.078868836
Detroit,48320,4273,82,130,125,337,0.078867306
Cleveland-Akron (Canton),44444,9814,241,261,272,774,0.078866925
Los Angeles,91755,27338,597,749,810,2156,0.078864584
Evansville,42344,913,25,24,23,72,0.078860898
Cincinnati,45241,25133,679,595,708,1982,0.078860462
Sacramnto-Stkton-Modesto,95690,2663,75,67,68,210,0.07885843
Indianapolis,47433,4096,130,101,92,323,0.078857422
Dallas-Ft. Worth,75778,4375,126,94,125,345,0.078857143
Champaign&Sprngfld-Decatur,62531,1712,46,47,42,135,0.07885514
Greensboro-H.Point-W.Salem,27408,17678,435,461,498,1394,0.078855074
Binghamton,13072,558,16,15,13,44,0.078853047
Chicago,60042,8015,209,207,216,632,0.078852152
Quincy-Hannibal-Keokuk,63440,1319,40,35,29,104,0.078847612
Waco-Temple-Bryan,76640,3158,90,86,73,249,0.078847372
Memphis,72438,2359,68,61,57,186,0.078846969
Butte-Bozeman,59758,2080,51,73,40,164,0.078846154
"Tri-Cities, TN-VA",37711,5162,148,131,128,407,0.078845409
Greenville-N.Bern-Washngtn,28585,3843,113,101,89,303,0.078844653
St. Louis,62062,8181,216,205,224,645,0.078841217
Pittsburgh,15126,7179,166,181,219,566,0.078841064
Indianapolis,46149,1966,66,52,37,155,0.078840285
Milwaukee,53074,13610,361,351,361,1073,0.078839089
Quincy-Hannibal-Keokuk,61470,482,14,15,9,38,0.078838174
Los Angeles,92328,241,3,7,9,19,0.078838174
Chicago,60424,2334,55,73,56,184,0.078834619
Terre Haute,62441,7002,219,163,170,552,0.078834619
Dallas-Ft. Worth,76462,4148,134,111,82,327,0.078833173
Evansville,42456,1611,49,41,37,127,0.078833023
Abilene-Sweetwater,79530,685,25,15,14,54,0.078832117
Phoenix (Prescott),85653,23785,791,554,530,1875,0.078831196
Chicago,60706,23100,605,603,613,1821,0.078831169
Gainesville,32626,9235,271,231,226,728,0.078830536
Albany-Schenectady-Troy,12431,1573,46,40,38,124,0.078830261
Colorado Springs-Pueblo,80938,4478,162,97,94,353,0.078829835
Des Moines-Ames,50035,10288,388,238,185,811,0.078829705
Cincinnati,45066,27236,951,709,487,2147,0.07882949
Ft. Wayne,46760,1332,40,32,33,105,0.078828829
"Lafayette, LA",70512,10390,329,271,219,819,0.078825794
Knoxville,40977,7358,189,203,188,580,0.078825768
Paducah-Cape Girard-Harsbg,62917,2309,68,60,54,182,0.078822001
Hartford & New Haven,6353,203,4,5,7,16,0.078817734
Madison,53901,14616,384,385,383,1152,0.078817734
Fargo,56738,1218,39,29,28,96,0.078817734
Evansville,62827,1015,31,26,23,80,0.078817734
Joplin-Pittsburg,66758,203,8,4,4,16,0.078817734
Clarksburg-Weston,26330,15999,465,401,395,1261,0.078817426
"Washington, DC (Hagrstwn)",21769,12130,414,301,241,956,0.078812861
Cedar Rapids-Wtrlo-IWC&Dub,52057,7981,232,205,192,629,0.078812179
Panama City,32439,17104,503,421,424,1348,0.078811974
New York,11501,21748,465,579,670,1714,0.078811845
Yakima-Pasco-Rchlnd-Knnwck,99360,1548,41,46,35,122,0.07881137
Charleston-Huntington,25535,2119,64,55,48,167,0.07881076
"Tri-Cities, TN-VA",37857,21330,617,567,497,1681,0.078809189
Dallas-Ft. Worth,76230,10494,333,249,245,827,0.078806937
Richmond-Petersburg,23966,2614,64,67,75,206,0.078806427
Charleston-Huntington,25302,13730,329,379,374,1082,0.078805535
Eugene,97470,20760,467,584,585,1636,0.078805395
Johnstown-Altoona-St Colge,15539,368,11,9,9,29,0.078804348
Lansing,49254,3312,89,92,80,261,0.078804348
Chicago,60005,32043,788,824,913,2525,0.078800362
Wilkes Barre-Scranton-Hztn,18603,18693,495,473,505,1473,0.078799551
Charleston-Huntington,41604,533,17,14,11,42,0.07879925
"Washington, DC (Hagrstwn)",26719,2462,80,56,58,194,0.078797725
Green Bay-Appleton,54922,1231,38,35,24,97,0.078797725
Roanoke-Lynchburg,24382,13795,368,339,380,1087,0.078796665
Peoria-Bloomington,61567,698,27,12,16,55,0.078796562
Los Angeles,90305,14988,367,385,429,1181,0.07879637
"Tri-Cities, TN-VA",37686,8503,210,241,219,670,0.078795719
Roanoke-Lynchburg,24347,1726,53,38,45,136,0.078794902
Greenvll-Spart-Ashevll-And,29669,15509,460,385,377,1222,0.078792959
Cedar Rapids-Wtrlo-IWC&Dub,52040,6257,188,160,145,493,0.078791753
Little Rock-Pine Bluff,72126,3668,109,91,89,289,0.078789531
Columbia-Jefferson City,65239,1320,42,35,27,104,0.078787879
"Springfield, MO",72660,495,14,14,11,39,0.078787879
Dallas-Ft. Worth,76252,3097,101,72,71,244,0.078785922
Shreveport,71764,1612,48,42,37,127,0.078784119
Houston,77418,10142,295,277,227,799,0.078781305
Milwaukee,53932,2691,94,63,55,212,0.078781122
Little Rock-Pine Bluff,72065,5382,158,140,126,424,0.078781122
New York,7027,5052,132,112,154,398,0.078780681
"Rochester, NY",14878,787,23,21,18,62,0.078780178
Boston (Manchester),3303,16731,423,452,443,1318,0.078775925
Kansas City,64402,2285,69,44,67,180,0.078774617
Toledo,43447,3161,93,83,73,249,0.07877254
Seattle-Tacoma,98042,50665,1501,1305,1185,3991,0.078772328
Pittsburgh,15742,1333,34,32,39,105,0.078769692
Great Falls,59404,28387,872,721,643,2236,0.07876845
Providence-New Bedford,2764,4380,122,98,125,345,0.078767123
Baltimore,21036,2463,95,62,37,194,0.078765733
Fargo,58237,5180,162,121,125,408,0.078764479
"Portland, OR",97344,1295,39,33,30,102,0.078764479
Greenvll-Spart-Ashevll-And,29655,7478,211,186,192,589,0.078764376
Burlington-Plattsburgh,5033,3009,94,73,70,237,0.078763709
Indianapolis,47427,1003,36,26,17,79,0.078763709
Burlington-Plattsburgh,5440,2133,54,56,58,168,0.078762307
Louisville,47166,1511,45,39,35,119,0.078755791
Bangor,4671,546,17,14,12,43,0.078754579
Greenvll-Spart-Ashevll-And,29693,14742,434,364,363,1161,0.078754579
Louisville,47143,4330,128,103,110,341,0.078752887
Tucson (Sierra Vista),85736,4673,145,128,95,368,0.078750267
Raleigh-Durham (Fayetvlle),28373,2400,62,59,68,189,0.07875
Milwaukee,53022,20267,605,532,459,1596,0.078748705
Indianapolis,47320,3797,113,97,89,299,0.078746379
Dallas-Ft. Worth,75420,1308,38,31,34,103,0.078746177
Charleston-Huntington,25570,5613,174,135,133,442,0.078745769
Lincoln & Hastings-Krny,68310,14096,407,360,343,1110,0.078745743
"Springfield, MO",72633,1943,59,49,45,153,0.07874421
"Columbus, OH",43062,33590,1048,833,764,2645,0.078743674
Augusta-Aiken,29164,4775,127,128,121,376,0.078743455
Johnstown-Altoona-St Colge,15801,19621,531,540,474,1545,0.078742164
Dothan,36010,5245,165,124,124,413,0.078741659
Syracuse,13021,38354,934,1001,1085,3020,0.078740157
Richmond-Petersburg,22538,254,5,7,8,20,0.078740157
Bluefield-Beckley-Oak Hill,24898,127,3,4,3,10,0.078740157
Minneapolis-St. Paul,56175,2921,91,58,81,230,0.078740157
Minneapolis-St. Paul,56583,127,3,4,3,10,0.078740157
Kansas City,64725,2159,67,51,52,170,0.078740157
Honolulu,96861,127,4,3,3,10,0.078740157
Miami-Ft. Lauderdale,33319,50357,1269,1339,1357,3965,0.078737812
Waco-Temple-Bryan,76511,2756,74,74,69,217,0.0787373
Marquette,49866,8230,281,192,175,648,0.07873633
Champaign&Sprngfld-Decatur,62612,1740,41,55,41,137,0.078735632
Baton Rouge,70749,978,30,25,22,77,0.078732106
Phoenix (Prescott),85643,8294,241,201,211,653,0.078731613
Shreveport,71103,6262,166,163,164,493,0.078728841
Flint-Saginaw-Bay City,48658,5030,145,135,116,396,0.078727634
Knoxville,38565,1194,38,29,27,94,0.078726968
Paducah-Cape Girard-Harsbg,62983,1791,49,38,54,141,0.078726968
"Columbus, OH",44854,1664,47,47,37,131,0.078725962
Denver,69357,3328,103,93,66,262,0.078725962
Pittsburgh,15030,1067,28,21,35,84,0.078725398
Denver,80212,21518,357,575,762,1694,0.078724789
Pittsburgh,16242,4573,124,109,127,360,0.078722939
Buffalo,14062,3163,80,83,86,249,0.078722732
New York,8822,34565,966,935,820,2721,0.07872125
Phoenix (Prescott),85361,6847,215,168,156,539,0.078720608
Detroit,48331,20961,550,534,566,1650,0.078717618
Des Moines-Ames,50223,343,10,8,9,27,0.078717201
Beaumont-Port Arthur,77622,1372,52,31,25,108,0.078717201
Cedar Rapids-Wtrlo-IWC&Dub,50676,1931,53,49,50,152,0.078715691
Billings,59088,1245,45,35,18,98,0.078714859
Dothan,36353,2020,61,54,44,159,0.078712871
New York,11358,38965,862,1035,1170,3067,0.078711664
Cincinnati,45101,2109,55,56,55,166,0.078710289
Albany-Schenectady-Troy,12068,3100,83,81,80,244,0.078709677
Atlanta,30216,2325,62,58,63,183,0.078709677
Cedar Rapids-Wtrlo-IWC&Dub,52078,775,24,20,17,61,0.078709677
"Washington, DC (Hagrstwn)",20658,991,30,26,22,78,0.078708375
Minneapolis-St. Paul,55012,2198,70,55,48,173,0.078707916
Rochestr-Mason City-Austin,56007,21383,592,548,543,1683,0.078707384
"Washington, DC (Hagrstwn)",20818,1855,67,52,27,146,0.078706199
Lima,45807,11219,362,258,263,883,0.078705767
Albany-Schenectady-Troy,1201,44965,1154,1230,1155,3539,0.07870566
Greensboro-H.Point-W.Salem,27355,3151,101,81,66,248,0.078705173
Monterey-Salinas,95010,9110,195,231,291,717,0.07870472
Phoenix (Prescott),85086,43238,1489,1140,774,3403,0.078703918
Denver,80835,864,28,26,14,68,0.078703704
Amarillo,88132,216,6,4,7,17,0.078703704
La Crosse-Eau Claire,54436,2249,67,55,55,177,0.078701645
Lubbock,79370,1385,41,46,22,109,0.078700361
Terre Haute,47842,9873,279,246,252,777,0.078699483
New York,7461,18489,477,502,476,1455,0.078695441
Flint-Saginaw-Bay City,48420,21361,544,572,565,1681,0.078694818
Davenport-R.Island-Moline,61312,521,14,12,15,41,0.078694818
San Francisco-Oak-San Jose,94552,14207,426,357,335,1118,0.078693602
"Columbus, OH",43152,826,22,23,20,65,0.078692494
"Washington, DC (Hagrstwn)",17236,8489,257,213,198,668,0.07869007
St. Louis,62288,2618,89,64,53,206,0.07868602
Louisville,42214,699,17,20,18,55,0.078683834
Detroit,49228,5287,135,143,138,416,0.078683563
Colorado Springs-Pueblo,80927,6774,245,147,141,533,0.0786832
Cheyenne-Scottsbluff,82240,9672,285,256,220,761,0.078680728
Meridian,36908,1970,53,56,46,155,0.078680203
Joplin-Pittsburg,66717,394,15,8,8,31,0.078680203
Sherman-Ada,74756,394,10,10,11,31,0.078680203
Roanoke-Lynchburg,24422,5961,160,160,149,469,0.078678074
Grand Rapids-Kalmzoo-B.Crk,49421,5707,173,151,125,449,0.078675311
Charleston-Huntington,41535,483,13,13,12,38,0.078674948
Charleston-Huntington,45629,2987,88,75,72,235,0.078674255
Wichita-Hutchinson Plus,67235,15380,575,370,265,1210,0.078673602
Jonesboro,72466,1538,43,40,38,121,0.078673602
Minneapolis-St. Paul,55033,30227,901,788,689,2378,0.078671387
Joplin-Pittsburg,64861,1233,43,31,23,97,0.078669911
Lincoln & Hastings-Krny,68818,5771,195,129,130,454,0.078669208
Cleveland-Akron (Canton),44303,6610,128,179,213,520,0.078668684
Kansas City,66095,928,31,16,26,73,0.078663793
Buffalo,16743,3890,119,98,89,306,0.078663239
Joplin-Pittsburg,66743,4246,135,109,90,334,0.07866227
Houston,77358,5352,165,140,116,421,0.078662182
New York,8837,19463,446,485,600,1531,0.078662077
Pittsburgh,15672,3496,87,78,110,275,0.078661327
Lexington,40442,1195,32,31,31,94,0.078661088
Traverse City-Cadillac,49631,6115,186,149,146,481,0.078659035
Providence-New Bedford,2818,20481,633,546,432,1611,0.078658269
Detroit,48419,2174,61,55,55,171,0.078656854
Parkersburg,26142,2619,79,63,64,206,0.078655976
"Charleston, SC",29059,5683,164,136,147,447,0.07865564
Indianapolis,46936,5912,162,167,136,465,0.078653586
Green Bay-Appleton,54944,9650,305,244,210,759,0.07865285
San Francisco-Oak-San Jose,95030,12587,425,338,227,990,0.078652578
Rochestr-Mason City-Austin,50444,356,9,10,9,28,0.078651685
Flint-Saginaw-Bay City,48509,9307,245,238,249,732,0.078650478
Dayton,45331,21971,631,560,537,1728,0.078649128
Birmingham (Ann and Tusc),35481,3166,92,84,73,249,0.078648136
Seattle-Tacoma,98371,25685,716,629,675,2020,0.078645124
Louisville,42757,3217,83,78,92,253,0.0786447
Huntsville-Decatur (Flor),35749,31255,948,763,747,2458,0.078643417
Wheeling-Steubenville,43754,1297,43,29,30,102,0.078643022
Los Angeles,91105,13784,290,375,419,1084,0.078641904
Greensboro-H.Point-W.Salem,28642,5341,142,136,142,420,0.078636959
Los Angeles,92220,35556,957,937,902,2796,0.078636517
Lincoln & Hastings-Krny,68926,674,25,14,14,53,0.078635015
Birmingham (Ann and Tusc),35594,7643,219,182,200,601,0.078634044
Boise,83669,19305,673,488,357,1518,0.078632479
Watertown,13327,2251,68,55,54,177,0.078631719
San Francisco-Oak-San Jose,95070,30688,987,858,568,2413,0.078630083
Atlanta,30222,4464,135,106,110,351,0.078629032
Pittsburgh,15690,8394,219,220,221,660,0.078627591
Cedar Rapids-Wtrlo-IWC&Dub,52351,1310,43,32,28,103,0.078625954
Bangor,4495,407,12,12,8,32,0.078624079
Bluefield-Beckley-Oak Hill,24880,407,11,12,9,32,0.078624079
"Portland, OR",97841,407,15,8,9,32,0.078624079
Pittsburgh,15062,6741,168,181,181,530,0.07862335
Kansas City,64018,725,26,17,14,57,0.07862069
Cleveland-Akron (Canton),44721,14068,421,329,356,1106,0.07861814
Nashville,42133,1590,48,38,39,125,0.078616352
Omaha,68349,1183,40,31,22,93,0.078613694
Wheeling-Steubenville,43713,6920,194,184,166,544,0.078612717
Cleveland-Akron (Canton),44843,2277,70,60,49,179,0.078612209
Des Moines-Ames,50222,547,18,14,11,43,0.078610603
Bluefield-Beckley-Oak Hill,24918,1323,39,32,33,104,0.078609221
Cleveland-Akron (Canton),44201,6577,198,160,159,517,0.078607268
Syracuse,13140,4020,107,115,94,316,0.078606965
Rockford,61070,1005,30,22,27,79,0.078606965
Los Angeles,92629,26207,611,681,768,2060,0.078604953
Grand Rapids-Kalmzoo-B.Crk,49331,18981,574,486,432,1492,0.078604921
New York,10994,7328,213,214,149,576,0.07860262
Harrisburg-Lncstr-Leb-York,17271,458,13,12,11,36,0.07860262
Kansas City,64021,687,17,19,18,54,0.07860262
Memphis,72348,2061,56,48,58,162,0.07860262
Minneapolis-St. Paul,56057,3944,116,106,88,310,0.078600406
Spokane,83857,827,28,21,16,65,0.07859734
"Washington, DC (Hagrstwn)",26722,598,19,15,13,47,0.078595318
Philadelphia,19954,1565,46,34,43,123,0.078594249
Flint-Saginaw-Bay City,48831,3130,91,81,74,246,0.078594249
Santabarbra-Sanmar-Sanluob,93444,22610,617,619,541,1777,0.078593543
Salisbury,21659,1247,36,23,39,98,0.078588613
"Portland, OR",97375,1247,45,31,22,98,0.078588613
Detroit,48418,4441,130,126,93,349,0.078585904
Bluefield-Beckley-Oak Hill,24839,1018,30,29,21,80,0.078585462
Champaign&Sprngfld-Decatur,61917,509,14,15,11,40,0.078585462
New York,11946,15652,389,435,406,1230,0.078584206
"Portland, OR",97360,2227,60,59,56,175,0.078581051
Boston (Manchester),1879,12446,338,328,312,978,0.078579463
Topeka,66523,3716,118,87,87,292,0.078579117
Watertown,13636,140,4,3,4,11,0.078571429
Bluefield-Beckley-Oak Hill,25118,420,13,11,9,33,0.078571429
Lincoln & Hastings-Krny,68453,280,11,7,4,22,0.078571429
Detroit,48350,7382,209,184,187,580,0.078569493
Austin,78659,3882,118,103,84,305,0.078567749
Honolulu,96813,31808,632,802,1065,2499,0.078565141
Buffalo,14221,55559,1483,1497,1385,4365,0.078565129
"Portland, OR",98685,30001,951,800,606,2357,0.078564048
Rochestr-Mason City-Austin,50458,1922,68,31,52,151,0.078563996
Minneapolis-St. Paul,56449,1922,62,47,42,151,0.078563996
Ft. Wayne,46795,6237,189,145,156,490,0.078563412
Flint-Saginaw-Bay City,48655,6237,170,163,157,490,0.078563412
Milwaukee,53956,3144,106,78,63,247,0.078562341
San Angelo,76861,1973,68,46,41,155,0.078560568
Charleston-Huntington,45769,5779,160,161,133,454,0.078560305
Denver,80652,611,16,17,15,48,0.078559738
San Diego,92009,44184,1434,1184,853,3471,0.078557849
Burlington-Plattsburgh,5072,471,17,11,9,37,0.078556263
Joplin-Pittsburg,66780,471,14,11,12,37,0.078556263
"Tri-Cities, TN-VA",37681,5983,166,162,142,470,0.078555908
Miami-Ft. Lauderdale,33138,27242,711,701,728,2140,0.078555172
Roanoke-Lynchburg,24517,5703,155,125,168,448,0.078555146
New York,11561,39285,773,899,1414,3086,0.078554156
San Francisco-Oak-San Jose,95008,48261,1131,1196,1464,3791,0.07855204
Green Bay-Appleton,54106,4914,169,116,101,386,0.078551079
Columbus-Tupelo-West Point,39747,1655,49,42,39,130,0.078549849
Lexington,40481,331,8,9,9,26,0.078549849
Charleston-Huntington,41124,993,28,27,23,78,0.078549849
Bowling Green,42259,993,27,29,22,78,0.078549849
"Washington, DC (Hagrstwn)",20854,49893,1756,1350,813,3919,0.078548093
Chicago,60480,5589,140,159,140,439,0.078547146
Detroit,48741,1897,56,55,38,149,0.078545071
New York,7054,31218,694,751,1007,2452,0.078544429
Oklahoma City,73007,3132,113,77,56,246,0.078544061
Seattle-Tacoma,98388,7563,179,171,244,594,0.078540262
"Columbia, SC",29020,24090,709,607,576,1892,0.078538813
Terre Haute,47850,2050,61,48,52,161,0.078536585
Panama City,32446,10836,325,293,233,851,0.078534515
Flint-Saginaw-Bay City,48662,1337,40,34,31,105,0.078534031
Ottumwa-Kirksville,52651,573,21,13,11,45,0.078534031
Minneapolis-St. Paul,54755,7411,230,184,168,582,0.078531912
Philadelphia,19438,24729,737,644,561,1942,0.078531279
Wilkes Barre-Scranton-Hztn,17830,2012,54,53,51,158,0.078528827
Tampa-St. Pete (Sarasota),33702,28042,631,749,822,2202,0.07852507
Sherman-Ada,74748,433,13,10,11,34,0.07852194
Boston (Manchester),3861,4623,150,117,96,363,0.078520441
Chicago,60157,2509,55,77,65,197,0.078517338
Traverse City-Cadillac,49649,6903,210,168,164,542,0.078516587
Dayton,43009,2318,81,56,45,182,0.078515962
Charleston-Huntington,41649,2369,71,50,65,186,0.078514141
Minneapolis-St. Paul,54021,7400,245,180,156,581,0.078513514
Minneapolis-St. Paul,54763,968,32,21,23,76,0.078512397
Knoxville,37934,27907,982,720,489,2191,0.078510768
Chicago,61377,1261,34,30,35,99,0.07850912
Shreveport,71006,16151,565,391,312,1268,0.078509071
Syracuse,13031,15922,429,396,425,1250,0.078507725
New York,10475,40060,915,1091,1139,3145,0.078507239
"Tri-Cities, TN-VA",41837,777,20,21,20,61,0.078507079
Pittsburgh,15090,23998,730,632,522,1884,0.078506542
Kansas City,64726,535,16,14,12,42,0.078504673
Rochestr-Mason City-Austin,55909,1363,43,31,33,107,0.078503302
Sioux City,50583,2637,69,62,76,207,0.078498294
Amarillo,88120,293,10,7,6,23,0.078498294
Charleston-Huntington,45659,2548,77,57,66,200,0.078492936
Utica,13340,8039,209,211,211,631,0.07849235
"Columbia, SC",29052,1618,47,42,38,127,0.078491965
Paducah-Cape Girard-Harsbg,62995,3631,102,93,90,285,0.078490774
San Angelo,76941,1325,41,36,27,104,0.078490566
Minneapolis-St. Paul,54822,4765,151,109,114,374,0.078488982
Billings,59057,688,24,17,13,54,0.078488372
Des Moines-Ames,50170,2905,81,80,67,228,0.07848537
Orlando-Daytona Bch-Melbrn,32750,28617,768,756,722,2246,0.078484817
Rockford,61310,3746,107,92,95,294,0.078483716
Rochestr-Mason City-Austin,55960,4587,180,109,71,360,0.078482668
Boston (Manchester),2052,13073,449,340,237,1026,0.078482368
Huntsville-Decatur (Flor),35646,4294,128,101,108,337,0.078481602
Philadelphia,8004,12347,320,298,351,969,0.078480603
Indianapolis,47968,841,25,20,21,66,0.078478002
Sioux City,51338,943,32,24,18,74,0.078472959
Greensboro-H.Point-W.Salem,27021,17522,479,452,444,1375,0.078472777
"Rochester, NY",14470,7646,202,197,201,600,0.078472404
Norfolk-Portsmth-Newpt Nws,23696,3823,126,97,77,300,0.078472404
Lincoln & Hastings-Krny,68824,1491,39,43,35,117,0.078470825
Greenville-N.Bern-Washngtn,28521,2039,62,49,49,160,0.078469838
Peoria-Bloomington,61534,1542,48,39,34,121,0.07846952
Roanoke-Lynchburg,24065,6270,186,167,139,492,0.0784689
Louisville,40009,1096,35,26,25,86,0.078467153
Colorado Springs-Pueblo,80908,26954,902,672,541,2115,0.078467018
"Columbus, OH",43021,15994,644,405,206,1255,0.078466925
Pittsburgh,16255,1899,52,47,50,149,0.078462349
"Columbia, SC",29070,16250,467,429,379,1275,0.078461538
Beaumont-Port Arthur,75933,1351,39,36,31,106,0.0784604
Philadelphia,8350,701,18,18,19,55,0.078459344
Greensboro-H.Point-W.Salem,27371,7112,192,194,172,558,0.078458943
Louisville,40069,8476,217,210,238,665,0.078456819
Springfield-Holyoke,1001,16965,395,419,517,1331,0.078455644
Los Angeles,90292,29112,271,592,1421,2284,0.07845562
La Crosse-Eau Claire,54773,3467,97,93,82,272,0.078453995
Tampa-St. Pete (Sarasota),33549,19145,477,484,541,1502,0.078453904
Billings,59041,2218,76,54,44,174,0.078449053
North Platte,69143,1313,42,38,23,103,0.078446306
New York,7727,8172,218,193,230,641,0.078438571
New York,11953,12392,309,317,346,972,0.078437702
Dallas-Ft. Worth,76008,27731,1031,658,486,2175,0.07843208
New York,12737,1887,54,49,45,148,0.078431373
Pittsburgh,16364,1377,47,34,27,108,0.078431373
Buffalo,16937,102,3,3,2,8,0.078431373
Harrisonburg,24471,1479,43,35,38,116,0.078431373
"Columbus, OH",43321,255,8,6,6,20,0.078431373
Charleston-Huntington,45770,561,16,14,14,44,0.078431373
Des Moines-Ames,50033,51,2,1,1,4,0.078431373
La Crosse-Eau Claire,54625,255,8,5,7,20,0.078431373
Minneapolis-St. Paul,54733,918,33,19,20,72,0.078431373
Sioux Falls(Mitchell),57312,408,18,9,5,32,0.078431373
Champaign&Sprngfld-Decatur,62556,357,13,8,7,28,0.078431373
Columbia-Jefferson City,65058,1071,34,30,20,84,0.078431373
Wichita-Hutchinson Plus,67733,204,6,6,4,16,0.078431373
Sioux City,68724,153,5,4,3,12,0.078431373
Ft. Smith-Fay-Sprngdl-Rgrs,72865,1122,35,31,22,88,0.078431373
Boise,83322,102,4,2,2,8,0.078431373
Albuquerque-Santa Fe,87321,408,14,8,10,32,0.078431373
Amarillo,88422,51,2,1,1,4,0.078431373
Cleveland-Akron (Canton),44647,18195,531,453,443,1427,0.07842814
Roanoke-Lynchburg,24092,3124,102,79,64,245,0.078425096
Grand Rapids-Kalmzoo-B.Crk,49415,7128,206,184,169,559,0.07842312
Paducah-Cape Girard-Harsbg,42058,2206,65,55,53,173,0.078422484
Wichita-Hutchinson Plus,67067,2206,61,53,59,173,0.078422484
San Francisco-Oak-San Jose,95139,5292,146,140,129,415,0.078420257
St. Louis,62557,6695,188,175,162,525,0.078416729
New York,8751,3966,94,111,106,311,0.078416541
Spokane,98841,8965,256,229,218,703,0.078416062
Burlington-Plattsburgh,5408,10776,241,254,350,845,0.078414996
Davenport-R.Island-Moline,52658,982,30,25,22,77,0.078411405
Champaign&Sprngfld-Decatur,61813,1658,45,46,39,130,0.07840772
St. Louis,62009,1607,45,39,42,126,0.07840697
Minneapolis-St. Paul,56340,2385,82,55,50,187,0.078406709
Greenvll-Spart-Ashevll-And,29626,13430,386,335,332,1053,0.078406552
"Portland, OR",97115,4515,143,113,98,354,0.078405316
Chicago,60184,2028,61,58,40,159,0.078402367
Tulsa,67024,676,21,18,14,53,0.078402367
Denver,81621,6033,157,138,178,473,0.078402122
Harrisburg-Lncstr-Leb-York,17565,2602,74,65,65,204,0.07840123
Ft. Smith-Fay-Sprngdl-Rgrs,74571,3227,102,80,71,253,0.078400992
Chicago,60525,30944,937,828,661,2426,0.07839969
Topeka,66439,2398,68,53,67,188,0.078398666
New York,7080,24032,622,617,645,1884,0.078395473
Boston (Manchester),1944,5383,181,159,82,422,0.078394947
Raleigh-Durham (Fayetvlle),27243,4503,134,115,104,353,0.078392183
Macon,31066,944,25,25,24,74,0.078389831
Boston (Manchester),3856,1837,55,53,36,144,0.078388677
Philadelphia,8619,24570,514,614,798,1926,0.078388278
Cincinnati,45053,3151,105,74,68,247,0.078387813
Philadelphia,8534,13446,426,375,253,1054,0.078387625
Indianapolis,47340,2679,81,70,59,210,0.078387458
Davenport-R.Island-Moline,52749,893,32,23,15,70,0.078387458
Pittsburgh,15323,4414,126,98,122,346,0.078386951
"Tri-Cities, TN-VA",40868,1263,40,31,28,99,0.078384798
Lexington,41348,1263,42,27,30,99,0.078384798
Sioux City,50581,842,28,17,21,66,0.078384798
San Antonio,78015,23640,804,561,488,1853,0.078384095
Paducah-Cape Girard-Harsbg,62958,2054,63,52,46,161,0.078383642
Cleveland-Akron (Canton),43908,1212,40,32,23,95,0.078382838
Seattle-Tacoma,98847,1952,51,47,55,153,0.078381148
Birmingham (Ann and Tusc),35441,1161,33,32,26,91,0.078380706
Minneapolis-St. Paul,55406,35111,697,950,1105,2752,0.078379995
Paducah-Cape Girard-Harsbg,63935,7719,228,208,169,605,0.078378028
Ft. Smith-Fay-Sprngdl-Rgrs,72946,3075,92,80,69,241,0.078373984
Dothan,39861,957,28,22,25,75,0.078369906
Tampa-St. Pete (Sarasota),34614,11191,353,274,250,877,0.078366545
Charleston-Huntington,26205,3369,98,86,80,264,0.078361532
Los Angeles,92691,45201,1184,1223,1135,3542,0.078361098
New York,7946,3318,96,108,56,260,0.078360458
St. Louis,65446,268,10,6,5,21,0.078358209
Joplin-Pittsburg,66716,536,21,12,9,42,0.078358209
Cleveland-Akron (Canton),44236,25564,887,702,414,2003,0.078352371
Hartford & New Haven,6415,16107,436,409,417,1262,0.078351028
Dallas-Ft. Worth,75838,485,15,12,11,38,0.078350515
Detroit,48017,11755,190,321,410,921,0.078349638
Hartford & New Haven,6278,4263,110,102,122,334,0.078348581
Montgomery-Selma,36782,2106,57,60,48,165,0.078347578
Tampa-St. Pete (Sarasota),34608,36109,1016,936,877,2829,0.078346119
"Washington, DC (Hagrstwn)",20607,12624,364,286,339,989,0.078342839
Atlanta,30175,6561,188,174,152,514,0.078341716
Philadelphia,18913,217,7,6,4,17,0.078341014
Charlotte,28033,2604,69,71,64,204,0.078341014
Rockford,61054,3689,123,83,83,289,0.078341014
Davenport-R.Island-Moline,61345,651,22,16,13,51,0.078341014
Sherman-Ada,73441,217,8,5,4,17,0.078341014
Detroit,48316,28159,799,714,693,2206,0.07834085
San Francisco-Oak-San Jose,95135,20347,704,540,350,1594,0.078340787
"Columbia, SC",29075,3421,97,85,86,268,0.078339667
"Jackson, TN",38343,16301,454,411,412,1277,0.078338752
Champaign&Sprngfld-Decatur,62665,1251,30,31,37,98,0.07833733
Los Angeles,92363,5604,169,149,121,439,0.078336902
Roanoke-Lynchburg,24014,16787,406,384,525,1315,0.078334425
Salt Lake City,84093,23821,780,579,507,1866,0.078334243
New York,7753,37239,843,950,1124,2917,0.078331856
Dayton,45317,983,30,26,21,77,0.078331638
Wilmington,28456,3332,96,91,74,261,0.078331333
"Alexandria, LA",71485,2732,87,68,59,214,0.078330893
Charleston-Huntington,41250,766,24,23,13,60,0.078328982
Little Rock-Pine Bluff,72473,2298,62,59,59,180,0.078328982
Toledo,49286,15333,426,402,373,1201,0.07832779
Milwaukee,53114,2413,68,61,60,189,0.078325736
New York,7416,5605,145,150,144,439,0.078322926
"Washington, DC (Hagrstwn)",21771,30453,948,812,625,2385,0.078317407
Philadelphia,17067,15782,483,391,362,1236,0.07831707
Lexington,40489,4086,135,106,79,320,0.078316202
Pittsburgh,15683,7738,208,203,195,606,0.07831481
Chattanooga,37365,1494,39,42,36,117,0.078313253
Louisville,40170,332,11,8,7,26,0.078313253
Ottumwa-Kirksville,63540,166,5,3,5,13,0.078313253
Wichita-Hutchinson Plus,66851,498,14,15,10,39,0.078313253
North Platte,69170,332,13,7,6,26,0.078313253
New York,12592,1111,31,26,30,87,0.078307831
Charlottesville,22542,1890,52,46,50,148,0.078306878
New York,11566,34812,1019,938,769,2726,0.078306331
Charleston-Huntington,41636,779,22,19,20,61,0.07830552
Dallas-Ft. Worth,76087,38567,1227,987,806,3020,0.078305287
Norfolk-Portsmth-Newpt Nws,27976,4125,118,114,91,323,0.07830303
Waco-Temple-Bryan,77836,12503,356,307,316,979,0.078301208
Bluefield-Beckley-Oak Hill,25817,447,15,10,10,35,0.078299776
Albuquerque-Santa Fe,87068,4917,148,123,114,385,0.078299776
Denver,81137,5198,161,125,121,407,0.078299346
Sioux City,68644,728,20,18,19,57,0.078296703
Lexington,41831,1009,25,29,25,79,0.078295342
Kansas City,65339,562,18,15,11,44,0.078291815
Oklahoma City,73768,1405,45,33,32,110,0.078291815
Chicago,60191,14242,370,357,388,1115,0.078289566
"Albany, GA",31784,677,20,16,17,53,0.078286558
New York,10548,3104,66,106,71,243,0.078286082
Shreveport,71740,1469,45,38,32,115,0.078284547
Oklahoma City,73073,396,13,11,7,31,0.078282828
Spokane,99008,792,21,21,20,62,0.078282828
Minneapolis-St. Paul,55347,31080,955,799,679,2433,0.078281853
Indianapolis,47421,28602,789,749,701,2239,0.078281239
Green Bay-Appleton,54213,1303,40,33,29,102,0.07828089
New York,6804,17846,516,464,417,1397,0.078280847
Chattanooga,37419,6630,158,174,187,519,0.078280543
Lexington,40456,9070,255,249,206,710,0.078280044
Cedar Rapids-Wtrlo-IWC&Dub,50644,8789,273,191,224,688,0.078279668
West Palm Beach-Ft. Pierce,33438,511,12,14,14,40,0.078277886
Madison,53810,511,18,9,13,40,0.078277886
St. Louis,63339,1022,29,20,31,80,0.078277886
Minneapolis-St. Paul,55325,4829,162,124,92,378,0.078277076
Knoxville,37748,17732,449,479,460,1388,0.078276562
Indianapolis,47342,2453,73,67,52,192,0.078271504
"Columbus, OH",43755,1942,53,47,52,152,0.078269825
Albuquerque-Santa Fe,87560,1546,39,42,40,121,0.078266494
Oklahoma City,74883,1891,54,58,36,148,0.078265468
Green Bay-Appleton,54966,2006,57,52,48,157,0.078265204
Des Moines-Ames,50161,2121,67,52,47,166,0.078264969
Boston (Manchester),2347,12100,350,310,287,947,0.078264463
Burlington-Plattsburgh,12930,690,25,16,13,54,0.07826087
Wilmington,28442,1380,35,36,37,108,0.07826087
Detroit,48050,1610,44,38,44,126,0.07826087
Cedar Rapids-Wtrlo-IWC&Dub,50671,230,9,5,4,18,0.07826087
Paducah-Cape Girard-Harsbg,63955,460,14,11,11,36,0.07826087
Albuquerque-Santa Fe,87027,115,3,3,3,9,0.07826087
Miami-Ft. Lauderdale,33175,51088,1311,1364,1323,3998,0.078257125
"Jackson, MS",39039,2134,61,51,55,167,0.078256795
Youngstown,16130,1904,55,44,50,149,0.078256303
Richmond-Petersburg,23920,3003,73,98,64,235,0.078255078
Flint-Saginaw-Bay City,48449,3067,84,81,75,240,0.078252364
Minneapolis-St. Paul,55006,4051,121,109,87,317,0.078252283
Houston,77401,17674,650,446,287,1383,0.078250538
Green Bay-Appleton,54208,6492,210,164,134,508,0.078250154
Denver,81146,639,17,17,16,50,0.078247261
Los Angeles,92646,55953,1342,1491,1545,4378,0.078244241
Harrisburg-Lncstr-Leb-York,17324,4486,133,109,109,351,0.078243424
Oklahoma City,73766,933,33,24,16,73,0.078242229
Tampa-St. Pete (Sarasota),34610,16270,456,400,417,1273,0.078242163
Philadelphia,19950,7298,210,167,194,571,0.078240614
Roanoke-Lynchburg,24572,16296,469,382,424,1275,0.078240059
Lexington,41425,1227,39,32,25,96,0.078239609
Chicago,47951,2045,47,55,58,160,0.078239609
Charlotte,28090,8155,249,196,193,638,0.078234212
Spokane,99173,1879,61,49,37,147,0.078233103
Lexington,40316,294,12,6,5,23,0.078231293
Des Moines-Ames,50523,588,19,12,15,46,0.078231293
Milwaukee,53079,1470,48,30,37,115,0.078231293
Tampa-St. Pete (Sarasota),34604,13652,411,331,326,1068,0.078230296
Ft. Wayne,47369,1355,46,29,31,106,0.078228782
Chicago,60189,30066,798,756,798,2352,0.078227899
"Springfield, MO",65614,473,15,12,10,37,0.078224101
"Tri-Cities, TN-VA",24210,16913,414,441,468,1323,0.078223851
Birmingham (Ann and Tusc),35960,9946,282,251,245,778,0.078222401
"Washington, DC (Hagrstwn)",22151,16875,493,442,385,1320,0.078222222
Dallas-Ft. Worth,75754,7147,203,190,166,559,0.078214636
Knoxville,37770,2685,76,69,65,210,0.078212291
Omaha,51563,716,27,17,12,56,0.078212291
Seattle-Tacoma,98040,25840,858,650,513,2021,0.078212074
Utica,13365,8260,238,222,186,646,0.078208232
Lexington,41719,1138,31,29,29,89,0.078207381
Beaumont-Port Arthur,77664,3414,103,88,76,267,0.078207381
"Jackson, TN",38475,780,26,20,15,61,0.078205128
Wausau-Rhinelander,54410,2340,80,60,43,183,0.078205128
Champaign&Sprngfld-Decatur,62670,2941,85,79,66,230,0.078204692
Louisville,47230,2161,63,55,51,169,0.078204535
Philadelphia,19150,22595,572,583,612,1767,0.078203142
Boston (Manchester),2322,4808,126,122,128,376,0.078202995
Elmira (Corning),14814,1803,56,50,35,141,0.078202995
Kansas City,64780,601,22,10,15,47,0.078202995
New York,10970,10524,290,258,275,823,0.078202204
"Tri-Cities, TN-VA",37690,4936,144,127,115,386,0.078200972
Cedar Rapids-Wtrlo-IWC&Dub,50643,2890,100,66,60,226,0.078200692
Pittsburgh,15329,1266,39,30,30,99,0.078199052
Evansville,47635,5013,137,128,127,392,0.078196689
Chicago,60417,14809,374,403,381,1158,0.078195692
Minneapolis-St. Paul,56277,2903,83,69,75,227,0.078194971
Paducah-Cape Girard-Harsbg,63764,5141,151,119,132,402,0.078194904
Evansville,62410,908,28,26,17,71,0.078193833
Topeka,66608,5026,141,133,119,393,0.078193394
Duluth-Superior,54814,3031,81,83,73,237,0.078192016
Hartford & New Haven,6471,7290,188,203,179,570,0.0781893
Sioux Falls(Mitchell),57323,243,8,6,5,19,0.0781893
Dallas-Ft. Worth,76182,31194,928,805,706,2439,0.078188113
New York,10590,6689,219,184,120,523,0.07818807
New York,11786,6203,182,167,136,485,0.078187974
Raleigh-Durham (Fayetvlle),27541,4208,136,87,106,329,0.078184411
Minneapolis-St. Paul,54767,3300,103,82,73,258,0.078181818
Buffalo,14012,2264,85,51,41,177,0.078180212
St. Louis,63377,3121,98,83,63,244,0.07818007
Roanoke-Lynchburg,24528,2878,69,70,86,225,0.078179291
Boston (Manchester),1821,30879,785,796,833,2414,0.078176107
Roanoke-Lynchburg,24105,614,20,16,12,48,0.078175896
Columbia-Jefferson City,65347,614,18,14,16,48,0.078175896
Tampa-St. Pete (Sarasota),34288,15888,481,411,350,1242,0.078172205
Cedar Rapids-Wtrlo-IWC&Dub,52336,2341,70,59,54,183,0.078171721
Topeka,66509,2405,80,57,51,188,0.078170478
Portland-Auburn,4292,1049,29,29,24,82,0.078169685
Bluefield-Beckley-Oak Hill,25139,371,8,12,9,29,0.078167116
Charleston-Huntington,41622,371,12,9,8,29,0.078167116
Denver,80750,371,14,7,8,29,0.078167116
Boston (Manchester),1518,3160,90,87,70,247,0.078164557
Ft. Wayne,46787,3659,102,80,104,286,0.078163433
Charlotte,29742,2482,73,62,59,194,0.078162772
Cleveland-Akron (Canton),44278,18385,493,453,491,1437,0.078161545
San Francisco-Oak-San Jose,94945,18513,509,504,434,1447,0.078161292
Cleveland-Akron (Canton),44287,7766,245,188,174,607,0.078161216
Detroit,48182,21942,567,601,547,1715,0.078160605
Birmingham (Ann and Tusc),35118,3237,98,79,76,253,0.078158789
Philadelphia,8043,31385,796,800,857,2453,0.078158356
Knoxville,40813,499,14,12,13,39,0.078156313
Cincinnati,45146,1497,48,35,34,117,0.078156313
Lincoln & Hastings-Krny,68404,1062,35,25,23,83,0.078154426
Grand Rapids-Kalmzoo-B.Crk,49343,5758,180,141,129,450,0.078152136
Wilkes Barre-Scranton-Hztn,18517,5195,142,120,144,406,0.078152069
Evansville,62837,8100,255,212,166,633,0.078148148
Nashville,37328,1382,41,34,33,108,0.078147612
Greensboro-H.Point-W.Salem,28635,3583,105,95,80,280,0.078146804
Peoria-Bloomington,61772,755,24,18,17,59,0.078145695
"Jackson, TN",38390,819,24,20,20,64,0.078144078
Flint-Saginaw-Bay City,48807,819,21,22,21,64,0.078144078
Ft. Wayne,46793,4159,100,104,121,325,0.078143785
Johnstown-Altoona-St Colge,16678,2521,67,58,72,197,0.078143594
Nashville,38468,5234,161,129,119,409,0.078142912
Houston,77971,947,25,25,24,74,0.078141499
Myrtle Beach-Florence,29563,2150,57,58,53,168,0.078139535
Baltimore,21638,5196,159,133,114,406,0.078137028
Paducah-Cape Girard-Harsbg,63769,1587,48,41,35,124,0.078134846
Detroit,48178,38204,1244,982,759,2985,0.07813318
St. Louis,63459,4198,132,101,95,328,0.078132444
Panama City,32578,36259,1125,941,767,2833,0.078132326
Paducah-Cape Girard-Harsbg,62832,8652,255,226,195,676,0.078132224
Buffalo,14120,44604,1093,1212,1180,3485,0.078132006
Youngstown,44406,21720,604,566,527,1697,0.078130755
Huntsville-Decatur (Flor),35672,6054,167,152,154,473,0.078130162
Bluefield-Beckley-Oak Hill,25962,3251,98,82,74,254,0.078129806
Pittsburgh,15033,4723,112,120,137,369,0.078128308
"Washington, DC (Hagrstwn)",20675,1792,57,42,41,140,0.078125
Cincinnati,47043,5184,153,119,133,405,0.078125
Quincy-Hannibal-Keokuk,63450,128,4,3,3,10,0.078125
Wichita-Hutchinson Plus,67105,192,7,5,3,15,0.078125
Harlingen-Wslco-Brnsvl-Mca,78536,128,3,5,2,10,0.078125
Albuquerque-Santa Fe,87832,64,2,2,1,5,0.078125
Amarillo,88126,64,2,1,2,5,0.078125
Philadelphia,8343,4621,125,128,108,361,0.078121619
Harrisburg-Lncstr-Leb-York,17074,7399,185,189,204,578,0.078118665
Minneapolis-St. Paul,56359,3751,122,84,87,293,0.078112503
Charlotte,28124,7182,225,165,171,561,0.078111947
"Jackson, TN",38368,2138,61,54,52,167,0.078110384
Lincoln & Hastings-Krny,68872,909,32,24,15,71,0.078107811
Minneapolis-St. Paul,55435,14480,252,341,538,1131,0.078107735
Shreveport,75975,3316,101,89,69,259,0.078106152
"Portland, OR",97146,7618,230,194,171,595,0.078104489
Boston (Manchester),2601,17464,416,468,480,1364,0.078103527
Chicago,61354,10166,261,276,257,794,0.078103482
Fargo,56742,717,24,17,15,56,0.078103208
Wichita-Hutchinson Plus,67123,717,23,17,16,56,0.078103208
Charlotte,28021,13828,346,359,375,1080,0.078102401
Salt Lake City,84520,1242,45,29,23,97,0.078099839
Minneapolis-St. Paul,56292,589,24,15,7,46,0.078098472
"Columbia, SC",29102,15852,453,417,368,1238,0.078097401
Panama City,32464,4136,121,101,101,323,0.078094778
Philadelphia,18013,17927,457,480,463,1400,0.078094494
Macon,31029,18721,555,478,429,1462,0.078094119
New York,8723,32551,764,848,930,2542,0.078092839
"Tri-Cities, TN-VA",37810,1908,49,55,45,149,0.078092243
Sioux Falls(Mitchell),57334,922,33,23,16,72,0.078091106
Indianapolis,46985,1319,44,33,26,103,0.078089462
New York,7720,4226,75,114,141,330,0.078088027
Omaha,68448,397,13,10,8,31,0.078085642
Albuquerque-Santa Fe,87418,1191,36,34,23,93,0.078085642
Philadelphia,18951,38407,1103,1008,888,2999,0.078084724
Boston (Manchester),3261,4790,127,125,122,374,0.078079332
Boston (Manchester),1532,15779,456,436,340,1232,0.078078459
Indianapolis,46127,333,10,9,7,26,0.078078078
Oklahoma City,73169,5482,157,157,114,428,0.078073696
Harrisburg-Lncstr-Leb-York,17044,20545,540,516,548,1604,0.078072524
Boston (Manchester),2537,6225,184,167,135,486,0.078072289
Paducah-Cape Girard-Harsbg,62907,2075,65,52,45,162,0.078072289
Sherman-Ada,75021,8659,240,206,230,676,0.078069061
Syracuse,13029,6917,176,175,189,540,0.078068527
Knoxville,37762,2754,57,77,81,215,0.078068264
Lincoln & Hastings-Krny,68367,538,17,12,13,42,0.078066914
Cleveland-Akron (Canton),44070,31077,762,792,872,2426,0.078064163
Knoxville,37876,34408,883,851,952,2686,0.078063241
Pittsburgh,16301,14655,434,362,348,1144,0.078062095
Sioux Falls(Mitchell),57017,1217,50,21,24,95,0.078060805
Peoria-Bloomington,61722,474,13,12,12,37,0.078059072
"Springfield, MO",65620,474,17,10,10,37,0.078059072
St. Louis,63624,3254,99,86,69,254,0.078057775
Champaign&Sprngfld-Decatur,62545,1153,44,27,19,90,0.078057242
Sioux Falls(Mitchell),57018,1563,54,38,30,122,0.078055022
Memphis,38068,11275,295,306,279,880,0.07804878
Baton Rouge,70733,1845,53,49,42,144,0.07804878
Tampa-St. Pete (Sarasota),34210,16887,327,454,537,1318,0.078048203
Fargo,56756,756,26,18,15,59,0.078042328
St. Louis,62893,756,25,20,14,59,0.078042328
Tulsa,74547,3921,120,102,84,306,0.078041316
Detroit,48005,5305,136,143,135,414,0.078039585
Charlotte,28107,10956,336,281,238,855,0.07803943
New York,12746,897,26,22,22,70,0.078037904
Wichita-Hutchinson Plus,67864,1794,52,44,44,140,0.078037904
Pittsburgh,15207,10354,236,265,307,808,0.078037473
Memphis,72392,346,12,9,6,27,0.078034682
Chicago,60047,43521,1443,1127,826,3396,0.078031295
Cincinnati,45159,3332,89,88,83,260,0.078031212
Abilene-Sweetwater,79532,833,23,25,17,65,0.078031212
Kansas City,64484,974,30,23,23,76,0.078028747
Wilkes Barre-Scranton-Hztn,18853,4037,113,95,107,315,0.078028239
Phoenix (Prescott),85501,12445,366,310,295,971,0.078023303
New York,7860,26390,727,686,646,2059,0.078021978
Birmingham (Ann and Tusc),35973,2730,79,66,68,213,0.078021978
Little Rock-Pine Bluff,72013,1961,60,49,44,153,0.078021418
Wilkes Barre-Scranton-Hztn,18344,3435,87,94,87,268,0.078020378
Davenport-R.Island-Moline,52037,1192,36,32,25,93,0.078020134
Wichita-Hutchinson Plus,67228,2807,109,62,48,219,0.078019238
San Antonio,78113,2179,67,53,50,170,0.078017439
Cleveland-Akron (Canton),44022,16099,524,446,286,1256,0.078017268
Nashville,37058,7242,202,199,164,565,0.078017122
Greenwood-Greenville,38746,423,12,14,7,33,0.078014184
Charleston-Huntington,41621,282,5,8,9,22,0.078014184
Sioux City,51055,1410,41,35,34,110,0.078014184
Champaign&Sprngfld-Decatur,62534,1128,33,27,28,88,0.078014184
Kansas City,64682,282,8,8,6,22,0.078014184
Boston (Manchester),1749,20074,530,525,511,1566,0.078011358
Augusta-Aiken,29105,1487,43,33,40,116,0.078009415
Charlottesville,22959,2128,76,53,37,166,0.078007519
Wilkes Barre-Scranton-Hztn,18252,11320,307,303,273,883,0.078003534
Wilkes Barre-Scranton-Hztn,17772,2423,69,66,54,189,0.078002476
Philadelphia,19526,11269,292,302,285,879,0.078001597
Seattle-Tacoma,98274,19705,553,483,501,1537,0.078000507
Shreveport,75572,3218,89,84,78,251,0.077998757
Charlottesville,22931,359,11,9,8,28,0.077994429
"Columbus, OH",45776,718,21,19,16,56,0.077994429
Ft. Wayne,46990,718,23,14,19,56,0.077994429
Little Rock-Pine Bluff,72517,359,10,8,10,28,0.077994429
Detroit,48336,26310,620,675,757,2052,0.077993158
Minneapolis-St. Paul,56347,7488,219,193,172,584,0.077991453
Cleveland-Akron (Canton),44827,6988,163,187,195,545,0.077990841
Buffalo,14086,34479,868,888,933,2689,0.077989501
San Angelo,76933,1372,33,39,35,107,0.077988338
"Jackson, TN",38366,2385,61,66,59,186,0.077987421
Minneapolis-St. Paul,56283,6591,173,162,179,514,0.077985131
Elmira (Corning),16929,2680,84,64,61,209,0.077985075
Pittsburgh,15012,15503,391,400,418,1209,0.077984906
Cleveland-Akron (Canton),44012,25582,822,696,477,1995,0.07798452
New York,7724,24685,544,692,689,1925,0.077982581
Elmira (Corning),14823,3706,113,90,86,289,0.077981651
Chattanooga,37301,1744,42,47,47,136,0.077981651
Des Moines-Ames,50229,1308,42,31,29,102,0.077981651
Shreveport,71070,1308,39,31,32,102,0.077981651
St. Louis,63068,5104,144,135,119,398,0.077978056
Savannah,30473,2629,84,57,64,205,0.077976417
Phoenix (Prescott),85259,22802,611,635,532,1778,0.077975616
Buffalo,14422,2193,52,43,76,171,0.077975376
Paducah-Cape Girard-Harsbg,42411,2193,59,54,58,171,0.077975376
Minneapolis-St. Paul,56065,2706,77,67,67,211,0.077974871
Milwaukee,53095,27868,777,737,659,2173,0.077974738
Grand Rapids-Kalmzoo-B.Crk,49060,1975,57,50,47,154,0.077974684
"Washington, DC (Hagrstwn)",22567,3219,90,81,80,251,0.077974526
Rapid City,57567,1244,34,31,32,97,0.077974277
Hartford & New Haven,6351,15813,441,393,399,1233,0.077973819
Omaha,51551,1757,64,41,32,137,0.077973819
Rochestr-Mason City-Austin,50658,2270,72,55,50,177,0.077973568
Cedar Rapids-Wtrlo-IWC&Dub,52306,1539,40,44,36,120,0.07797271
New York,8510,5066,124,145,126,395,0.077970786
Cincinnati,41080,1911,57,48,44,149,0.077969649
Detroit,48386,18097,526,448,437,1411,0.077968724
Paducah-Cape Girard-Harsbg,42056,1770,47,46,45,138,0.077966102
Kansas City,64001,590,19,12,15,46,0.077966102
Topeka,67445,590,19,11,16,46,0.077966102
Little Rock-Pine Bluff,71674,590,17,15,14,46,0.077966102
Salt Lake City,84002,295,9,8,6,23,0.077966102
Greensboro-H.Point-W.Salem,27023,13878,464,358,260,1082,0.077965125
Philadelphia,8106,9081,228,215,265,708,0.077964982
Milwaukee,53090,21587,625,551,507,1683,0.077963589
New York,8827,5028,136,143,113,392,0.077963405
Austin,78132,48074,1533,1245,970,3748,0.07796314
Charleston-Huntington,45678,1039,36,25,20,81,0.077959577
Sioux City,50568,1411,44,35,31,110,0.077958894
Augusta-Aiken,29860,18420,517,463,456,1436,0.07795874
Gainesville,32621,6247,195,158,134,487,0.07795742
Richmond-Petersburg,23893,372,9,12,8,29,0.077956989
Charleston-Huntington,25113,744,23,19,16,58,0.077956989
Boston (Manchester),2367,2758,84,62,69,215,0.07795504
Macon,31072,1193,36,31,26,93,0.077954736
Ottumwa-Kirksville,63533,821,27,16,21,64,0.077953715
Philadelphia,19055,13662,386,323,356,1065,0.077953448
Omaha,51535,1719,61,40,33,134,0.077952298
Bluefield-Beckley-Oak Hill,25868,449,13,13,9,35,0.077951002
Little Rock-Pine Bluff,72471,898,26,21,23,70,0.077951002
Amarillo,79096,1873,52,52,42,146,0.077949813
St. Louis,62278,6530,183,164,162,509,0.077947933
Buffalo,14009,5260,157,133,120,410,0.077946768
Macon,31042,1129,31,29,28,88,0.077945084
Tampa-St. Pete (Sarasota),33714,20284,456,540,585,1581,0.077943206
Cincinnati,45118,3849,120,93,87,300,0.077942323
Madison,53586,2117,66,46,53,165,0.077940482
San Diego,92086,1437,22,37,53,112,0.077940153
New York,11743,41455,1115,1090,1026,3231,0.077939935
Grand Rapids-Kalmzoo-B.Crk,49070,2579,83,61,57,201,0.077937185
Bismarck-Mnt-Dcknsn(Wlstn),58318,3734,139,72,80,291,0.077932512
Raleigh-Durham (Fayetvlle),27816,2669,71,73,64,208,0.07793181
Burlington-Plattsburgh,12919,2900,85,64,77,226,0.077931034
Wilkes Barre-Scranton-Hztn,17856,3439,87,91,90,268,0.077929631
Dallas-Ft. Worth,76633,6198,207,158,118,483,0.077928364
Memphis,38367,2682,74,63,72,209,0.07792692
Little Rock-Pine Bluff,72046,3991,116,97,98,311,0.077925332
Watertown,13681,693,23,16,15,54,0.077922078
Watertown,13682,1001,29,30,19,78,0.077922078
Charlottesville,22948,231,6,6,6,18,0.077922078
Charleston-Huntington,25088,154,4,5,3,12,0.077922078
Charleston-Huntington,25547,616,17,15,16,48,0.077922078
Nashville,38471,616,19,19,10,48,0.077922078
Dallas-Ft. Worth,76445,308,8,7,9,24,0.077922078
Waco-Temple-Bryan,76685,77,2,2,2,6,0.077922078
Indianapolis,47362,29801,747,752,823,2322,0.077916848
Toledo,43457,1553,43,43,35,121,0.077913715
Lansing,48861,1476,45,36,34,115,0.077913279
Atlanta,30055,4120,126,100,95,321,0.077912621
Tampa-St. Pete (Sarasota),34602,9485,306,235,198,739,0.077912493
Sioux Falls(Mitchell),57226,1874,59,48,39,146,0.077908218
Shreveport,71838,783,23,20,18,61,0.077905492
Myrtle Beach-Florence,29574,10025,303,232,246,781,0.077905237
Philadelphia,8003,31487,953,838,662,2453,0.077905167
Charleston-Huntington,25638,706,16,18,21,55,0.077903683
Macon,31544,706,22,20,13,55,0.077903683
"Columbus, GA (Opelika, AL)",36311,2593,71,67,64,202,0.077902044
Honolulu,96744,56933,1533,1430,1472,4435,0.077898583
Springfield-Holyoke,1080,1900,48,43,57,148,0.077894737
Cleveland-Akron (Canton),44864,3248,83,90,80,253,0.077894089
Chicago,60940,3171,98,81,68,247,0.077893409
Orlando-Daytona Bch-Melbrn,32833,11426,319,289,282,890,0.077892526
Indianapolis,47264,1271,39,29,31,99,0.077891424
Watertown,12965,398,12,11,8,31,0.077889447
"Tri-Cities, TN-VA",24224,5495,149,153,126,428,0.07788899
"Tri-Cities, TN-VA",37663,13699,373,362,332,1067,0.077888897
"Washington, DC (Hagrstwn)",22153,31699,975,797,697,2469,0.077888892
Detroit,49267,4224,130,99,100,329,0.077888258
Buffalo,14550,1515,45,32,41,118,0.077887789
Dallas-Ft. Worth,76487,3916,120,101,84,305,0.077885598
Boston (Manchester),3052,8474,246,222,192,660,0.077885296
Greenville-N.Bern-Washngtn,27883,3762,108,101,84,293,0.077884104
"Springfield, MO",65791,3364,92,90,80,262,0.077883472
Indianapolis,47940,1528,47,36,36,119,0.077879581
Huntsville-Decatur (Flor),35651,1207,38,24,32,94,0.077879039
"Tri-Cities, TN-VA",41855,565,17,13,14,44,0.077876106
Detroit,48098,20263,644,574,360,1578,0.077875932
Little Rock-Pine Bluff,71968,4764,140,114,117,371,0.077875735
Louisville,47273,1862,48,44,53,145,0.077873255
Evansville,47527,1862,51,43,51,145,0.077873255
Raleigh-Durham (Fayetvlle),27523,21060,697,521,422,1640,0.077872745
Des Moines-Ames,50119,488,17,12,9,38,0.077868852
Joplin-Pittsburg,65730,244,8,6,5,19,0.077868852
Houston,77426,2196,70,54,47,171,0.077868852
Greenvll-Spart-Ashevll-And,30643,17658,447,443,485,1375,0.077868388
Philadelphia,8515,6293,245,144,101,490,0.077864294
Cedar Rapids-Wtrlo-IWC&Dub,52325,899,27,26,17,70,0.077864294
Charlotte,28655,56432,1494,1420,1480,4394,0.077863623
Charleston-Huntington,41514,3198,92,80,77,249,0.077861163
Lincoln & Hastings-Krny,68666,1644,51,38,39,128,0.077858881
Presque Isle,4757,2646,75,79,52,206,0.077853364
San Francisco-Oak-San Jose,94547,26743,662,705,715,2082,0.077852148
New York,8755,31227,819,816,796,2431,0.077849297
Raleigh-Durham (Fayetvlle),27252,1747,49,47,40,136,0.077847739
Buffalo,14708,167,5,4,4,13,0.077844311
Sioux City,51016,1336,40,32,32,104,0.077844311
Medford-Klamath Falls,96034,167,5,3,5,13,0.077844311
Richmond-Petersburg,23116,33799,1070,880,681,2631,0.07784254
Cedar Rapids-Wtrlo-IWC&Dub,52228,3443,107,92,69,268,0.077839094
Roanoke-Lynchburg,24574,3867,109,107,85,301,0.077838117
Roanoke-Lynchburg,24077,925,27,23,22,72,0.077837838
Hartford & New Haven,6795,13721,360,365,343,1068,0.077836892
Cincinnati,41004,4214,135,107,86,328,0.077835785
Monterey-Salinas,95075,591,16,18,12,46,0.077834179
"Rochester, NY",14533,1863,54,42,49,145,0.077831455
"Washington, DC (Hagrstwn)",20194,13478,311,307,431,1049,0.077830539
Wilkes Barre-Scranton-Hztn,18642,4664,133,113,117,363,0.077830189
"Columbus, GA (Opelika, AL)",31826,2223,62,57,54,173,0.077822762
"Columbus, OH",43730,2223,74,55,44,173,0.077822762
Watertown,13658,2827,90,68,62,220,0.077821012
Des Moines-Ames,50217,514,15,13,12,40,0.077821012
Des Moines-Ames,50156,4549,140,111,103,354,0.077819301
Wichita-Hutchinson Plus,67480,1632,53,43,31,127,0.077818627
Boston (Manchester),2067,19443,675,502,336,1513,0.077817209
"Washington, DC (Hagrstwn)",20736,8726,301,208,170,679,0.077813431
Albany-Schenectady-Troy,12804,27566,818,693,634,2145,0.077813248
Ft. Smith-Fay-Sprngdl-Rgrs,71953,14008,392,364,334,1090,0.077812678
"Columbus, OH",43812,18686,546,461,447,1454,0.077812266
Panama City,32435,7531,212,187,187,586,0.077811712
Boston (Manchester),2554,14137,354,365,381,1100,0.077810002
Philadelphia,19033,7981,194,205,222,621,0.077809798
Sioux Falls(Mitchell),57461,347,13,8,6,27,0.077809798
Chattanooga,37370,4871,132,134,113,379,0.077807432
Paducah-Cape Girard-Harsbg,62890,2699,70,75,65,210,0.077806595
Harrisburg-Lncstr-Leb-York,17309,2352,71,53,59,183,0.077806122
Joplin-Pittsburg,64767,784,26,18,17,61,0.077806122
Minneapolis-St. Paul,56314,1221,40,33,22,95,0.077805078
Grand Rapids-Kalmzoo-B.Crk,49339,2532,79,56,62,197,0.077804107
Pittsburgh,15655,437,13,11,10,34,0.077803204
Sioux City,68765,1311,45,25,32,102,0.077803204
Des Moines-Ames,50036,16465,464,384,433,1281,0.077801397
Missoula,59824,1581,46,46,31,123,0.077798861
Boston (Manchester),2061,11440,377,317,196,890,0.077797203
"Washington, DC (Hagrstwn)",22735,2288,69,53,56,178,0.077797203
Sioux Falls(Mitchell),57601,3612,95,98,88,281,0.077796235
"Rochester, NY",14568,5643,159,135,145,439,0.077795499
Wausau-Rhinelander,54426,4332,131,100,106,337,0.077793167
Albany-Schenectady-Troy,12025,5489,148,156,123,427,0.077791948
Albany-Schenectady-Troy,12198,7469,218,174,189,581,0.077788191
Charlotte,29709,5888,168,156,134,458,0.077785326
Evansville,47520,3034,91,62,83,236,0.077785102
Philadelphia,8554,3754,91,95,106,292,0.077783697
Memphis,38139,16238,573,449,241,1263,0.077780515
Boston (Manchester),3087,16380,584,431,259,1274,0.077777778
Buffalo,16727,180,6,4,4,14,0.077777778
Montgomery-Selma,36754,270,8,6,7,21,0.077777778
Knoxville,37726,2160,63,59,46,168,0.077777778
Paducah-Cape Girard-Harsbg,38259,810,23,24,16,63,0.077777778
Charleston-Huntington,41132,450,10,13,12,35,0.077777778
Indianapolis,47387,900,28,13,29,70,0.077777778
Sioux Falls(Mitchell),56158,450,14,11,10,35,0.077777778
Lincoln & Hastings-Krny,68946,90,3,2,2,7,0.077777778
Casper-Riverton,82642,90,3,2,2,7,0.077777778
Lincoln & Hastings-Krny,68352,5066,144,122,128,394,0.077773391
Pittsburgh,15220,17127,312,426,594,1332,0.077771939
Tallahassee-Thomasville,32312,33907,1080,901,656,2637,0.077771552
Wilkes Barre-Scranton-Hztn,18833,1723,50,42,42,134,0.077771329
Las Vegas,89138,28585,1088,694,441,2223,0.07776806
Kansas City,64037,6198,164,149,169,482,0.077767022
Raleigh-Durham (Fayetvlle),27242,2006,51,55,50,156,0.0777667
Great Falls,59422,2829,86,66,68,220,0.077765995
Sacramnto-Stkton-Modesto,95966,30669,873,766,746,2385,0.077765822
Idaho Fals-Pocatllo(Jcksn),83217,733,21,19,17,57,0.077762619
Chattanooga,37379,29115,844,706,714,2264,0.077760604
Sacramnto-Stkton-Modesto,95831,42786,933,1117,1277,3327,0.07775908
Des Moines-Ames,50138,11806,348,297,273,918,0.077757073
Johnstown-Altoona-St Colge,15552,5826,165,145,143,453,0.077754892
Watertown,13648,2225,74,51,48,173,0.077752809
Los Angeles,92694,36463,1483,834,518,2835,0.077750048
Cincinnati,45054,1955,58,51,43,152,0.077749361
Charlotte,29714,3074,89,72,78,239,0.077748861
Terre Haute,62419,373,13,10,6,29,0.077747989
Shreveport,71462,1492,47,28,41,116,0.077747989
Wilkes Barre-Scranton-Hztn,18407,14393,376,370,373,1119,0.077746127
La Crosse-Eau Claire,54614,2804,84,58,76,218,0.077746077
Pittsburgh,15066,11898,300,281,344,925,0.077744159
Johnstown-Altoona-St Colge,16674,656,20,16,15,51,0.077743902
Corpus Christi,78336,12850,353,364,282,999,0.077743191
Greenville-N.Bern-Washngtn,27860,1878,58,49,39,146,0.077742279
Spokane,98840,5647,163,150,126,439,0.077740393
Birmingham (Ann and Tusc),35463,1698,45,42,45,132,0.077738516
Knoxville,40830,283,9,7,6,22,0.077738516
Spokane,99018,283,10,6,6,22,0.077738516
Minneapolis-St. Paul,55126,27953,745,658,770,2173,0.077737631
Pittsburgh,15461,4065,100,110,106,316,0.077736777
Philadelphia,19067,53206,1474,1387,1275,4136,0.077735594
Detroit,48189,13829,341,357,377,1075,0.077735194
New York,6877,24841,832,688,411,1931,0.077734391
Butte-Bozeman,59635,8439,258,217,181,656,0.077734329
Cleveland-Akron (Canton),44054,12427,290,314,362,966,0.077733966
Hartford & New Haven,6762,8169,265,212,158,635,0.077732893
Greensboro-H.Point-W.Salem,28651,6085,172,143,158,473,0.077732128
Harrisburg-Lncstr-Leb-York,17545,22745,639,539,590,1768,0.07773137
"Lafayette, LA",70559,2792,76,69,72,217,0.077722063
Louisville,40052,579,15,16,14,45,0.077720207
Fargo,56724,193,5,6,4,15,0.077720207
Champaign&Sprngfld-Decatur,62535,3474,117,86,67,270,0.077720207
Boston (Manchester),2339,15453,491,402,308,1201,0.077719537
Detroit,48421,6279,181,160,147,488,0.077719382
Los Angeles,91784,28334,740,746,716,2202,0.077715818
New York,7821,9291,265,241,216,722,0.077709611
Buffalo,14880,1467,45,40,29,114,0.077709611
Wilkes Barre-Scranton-Hztn,17965,1956,50,47,55,152,0.077709611
Evansville,47613,2445,87,49,54,190,0.077709611
Honolulu,96760,3912,130,98,76,304,0.077709611
Jonesboro,72460,785,23,24,14,61,0.077707006
Sioux City,68741,592,19,17,10,46,0.077702703
Idaho Fals-Pocatllo(Jcksn),83234,1184,27,31,34,92,0.077702703
Nashville,37060,3076,106,73,60,239,0.077698309
Minneapolis-St. Paul,56219,695,23,14,17,54,0.077697842
Hartford & New Haven,6786,9550,234,244,264,742,0.077696335
Lansing,49237,2986,90,81,61,232,0.077695914
Shreveport,71836,2690,82,58,69,209,0.077695167
Minneapolis-St. Paul,56255,399,14,6,11,31,0.077694236
Champaign&Sprngfld-Decatur,61849,1596,48,35,41,124,0.077694236
Bismarck-Mnt-Dcknsn(Wlstn),58849,1300,43,31,27,101,0.077692308
Wilkes Barre-Scranton-Hztn,18321,1802,50,40,50,140,0.077691454
Miami-Ft. Lauderdale,33184,19861,487,541,515,1543,0.077689945
"Tri-Cities, TN-VA",37687,4634,123,118,119,360,0.077686664
Zanesville,43771,1815,54,47,40,141,0.07768595
"Springfield, MO",72626,1210,27,35,32,94,0.07768595
Indianapolis,46034,8277,271,207,165,643,0.077685152
Champaign&Sprngfld-Decatur,62688,708,19,18,18,55,0.077683616
"Portland, OR",98610,3038,85,70,81,236,0.077682686
Hartford & New Haven,6255,4982,125,134,128,387,0.077679647
Johnstown-Altoona-St Colge,15924,1017,27,23,29,79,0.077679449
Boston (Manchester),1542,2240,56,53,65,174,0.077678571
Columbia-Jefferson City,65016,1326,44,33,26,103,0.077677225
Greenvll-Spart-Ashevll-And,29653,4493,132,102,115,349,0.077676385
New York,11357,40734,1043,1030,1091,3164,0.07767467
Roanoke-Lynchburg,24527,2678,84,66,58,208,0.077669903
Chattanooga,37351,206,4,4,8,16,0.077669903
"Tri-Cities, TN-VA",40858,206,6,5,5,16,0.077669903
Minneapolis-St. Paul,56214,618,22,11,15,48,0.077669903
Bismarck-Mnt-Dcknsn(Wlstn),58524,103,4,2,2,8,0.077669903
Champaign&Sprngfld-Decatur,61811,721,26,19,11,56,0.077669903
"Springfield, MO",65788,412,13,9,10,32,0.077669903
Norfolk-Portsmth-Newpt Nws,23701,25274,591,616,756,1963,0.07766875
Roanoke-Lynchburg,24586,5382,142,153,123,418,0.077666295
Miami-Ft. Lauderdale,33026,30361,855,774,729,2358,0.077665426
Sioux Falls(Mitchell),69201,4249,141,90,99,330,0.077665333
Norfolk-Portsmth-Newpt Nws,23188,50165,1320,1320,1256,3896,0.07766371
Roanoke-Lynchburg,24556,3232,103,77,71,251,0.077660891
"Springfield, MO",65463,1043,33,29,19,81,0.077660594
Bluefield-Beckley-Oak Hill,25209,940,30,23,20,73,0.077659574
Albany-Schenectady-Troy,12834,6091,160,160,153,473,0.077655557
New York,11554,37963,957,974,1017,2948,0.077654558
Detroit,48356,8216,248,202,188,638,0.077653359
Grand Rapids-Kalmzoo-B.Crk,49302,9427,294,242,196,732,0.077649305
Buffalo,14081,3284,90,87,78,255,0.077649208
Rapid City,57760,1275,36,36,27,99,0.077647059
Champaign&Sprngfld-Decatur,62611,850,32,20,14,66,0.077647059
New York,6831,15313,452,421,316,1189,0.077646444
Utica,13424,2447,55,61,74,190,0.077646097
Louisville,40046,1919,64,47,38,149,0.077644607
Richmond-Petersburg,22427,3954,102,100,105,307,0.077642893
Rochestr-Mason City-Austin,55975,3851,114,85,100,299,0.077642171
Burlington-Plattsburgh,5672,5242,162,133,112,407,0.077642121
Wilkes Barre-Scranton-Hztn,17901,24111,650,610,612,1872,0.077640911
Monroe-El Dorado,71418,5384,164,136,118,418,0.077637444
Flint-Saginaw-Bay City,48723,11631,321,290,292,903,0.077637348
"Springfield, MO",72583,1726,54,47,33,134,0.077636153
Pittsburgh,21531,2164,69,45,54,168,0.077634011
Boston (Manchester),1801,41465,887,1056,1276,3219,0.077631738
Great Falls,59248,760,26,21,12,59,0.077631579
Elmira (Corning),17724,4457,131,116,99,346,0.077630693
Tampa-St. Pete (Sarasota),34212,26717,847,683,544,2074,0.077628476
Kansas City,66216,25558,695,627,662,1984,0.077627357
Chicago,46381,219,7,5,5,17,0.077625571
Amarillo,79079,2409,60,59,68,187,0.077625571
"Bend, OR",97703,34950,978,881,854,2713,0.077625179
Lexington,40962,17675,473,454,445,1372,0.077623762
Boston (Manchester),3053,27015,743,711,643,2097,0.077623542
Minneapolis-St. Paul,55082,36188,1122,985,702,2809,0.077622416
Boston (Manchester),1876,30971,715,793,896,2404,0.077621
Johnstown-Altoona-St Colge,15943,3646,103,85,95,283,0.077619309
Colorado Springs-Pueblo,81090,889,22,23,24,69,0.077615298
Philadelphia,18960,13786,396,351,323,1070,0.077614972
Richmond-Petersburg,23872,2448,60,72,58,190,0.077614379
Wichita-Hutchinson Plus,67879,1224,42,32,21,95,0.077614379
Minneapolis-St. Paul,55316,24081,709,612,548,1869,0.077613056
Charleston-Huntington,41560,335,11,9,6,26,0.07761194
New Orleans,70124,22394,499,483,756,1738,0.077610074
Columbus-Tupelo-West Point,38916,4149,113,110,99,322,0.077609062
Pittsburgh,15637,1907,57,39,52,148,0.07760881
Chicago,60512,1688,56,43,32,131,0.077606635
Rockford,61048,3827,112,89,96,297,0.07760648
Sioux Falls(Mitchell),57053,2139,72,53,41,166,0.077606358
New York,10709,9458,260,267,207,734,0.077606259
Cincinnati,47024,2822,81,72,66,219,0.077604536
Boston (Manchester),1747,5760,160,158,129,447,0.077604167
New York,11769,8814,217,252,215,684,0.077603812
New York,10710,28040,704,697,775,2176,0.077603424
Lexington,41339,10451,316,251,244,811,0.07760023
Harrisburg-Lncstr-Leb-York,17340,11250,309,277,287,873,0.0776
Nashville,37118,1482,38,39,38,115,0.077597841
Minneapolis-St. Paul,56241,3879,105,113,83,301,0.077597319
Wheeling-Steubenville,43788,799,21,23,18,62,0.077596996
Des Moines-Ames,50150,799,23,22,17,62,0.077596996
Los Angeles,90505,34822,940,960,802,2702,0.077594624
Louisville,47164,3557,116,79,81,276,0.077593478
Johnstown-Altoona-St Colge,16669,2075,64,56,41,161,0.077590361
Madison,53951,2423,82,61,45,188,0.077589765
Charleston-Huntington,25309,12463,314,306,347,967,0.077589665
Bluefield-Beckley-Oak Hill,24931,1624,46,43,37,126,0.077586207
Bluefield-Beckley-Oak Hill,25161,464,18,9,9,36,0.077586207
Memphis,38619,4292,118,113,102,333,0.077586207
Greenwood-Greenville,38740,348,9,10,8,27,0.077586207
Indianapolis,46930,232,7,7,4,18,0.077586207
Alpena,49744,812,27,17,19,63,0.077586207
Green Bay-Appleton,49848,116,4,3,2,9,0.077586207
Erie,16406,3261,97,80,76,253,0.077583563
Charlotte,27055,14230,377,353,374,1104,0.077582572
"Columbia, SC",29125,2810,83,73,62,218,0.077580071
Charleston-Huntington,45743,1405,37,42,30,109,0.077580071
Boise,83616,38645,1381,1002,615,2998,0.077577953
New York,7423,4112,142,119,58,319,0.077577821
Greensboro-H.Point-W.Salem,27233,3648,93,96,94,283,0.077576754
Cleveland-Akron (Canton),44319,21606,555,525,596,1676,0.077571045
St. Joseph,66087,2024,70,39,48,157,0.07756917
Joplin-Pittsburg,66736,3455,97,82,89,268,0.077568741
Quincy-Hannibal-Keokuk,63432,477,18,12,7,37,0.077568134
Kansas City,64746,1431,40,33,38,111,0.077568134
Hartford & New Haven,6082,42247,1007,1032,1238,3277,0.077567638
Minneapolis-St. Paul,55120,4783,124,113,134,371,0.077566381
Amarillo,79325,2153,57,57,53,167,0.077566187
Panama City,32421,4190,130,104,91,325,0.077565632
Bismarck-Mnt-Dcknsn(Wlstn),58634,361,9,11,8,28,0.077562327
Boston (Manchester),2021,25103,668,675,604,1947,0.077560451
Omaha,68788,4951,166,113,105,384,0.077560089
Huntsville-Decatur (Flor),35175,5106,149,132,115,396,0.077555817
Elmira (Corning),14816,245,6,6,7,19,0.07755102
Charleston-Huntington,25510,4900,146,120,114,380,0.07755102
Charleston-Huntington,41558,735,23,21,13,57,0.07755102
"Washington, DC (Hagrstwn)",21791,5519,150,151,127,428,0.077550281
Buffalo,14051,20516,618,545,428,1591,0.07754923
Macon,31033,2089,63,55,44,162,0.077549067
Albany-Schenectady-Troy,12413,2953,81,79,69,229,0.077548256
Paducah-Cape Girard-Harsbg,63662,1973,57,49,47,153,0.077546883
Utica,13490,1238,39,31,26,96,0.077544426
Clarksburg-Weston,26237,619,18,10,20,48,0.077544426
"Springfield, MO",65567,1238,44,28,24,96,0.077544426
Minneapolis-St. Paul,55431,19796,396,502,637,1535,0.077540917
New York,11426,18442,389,461,580,1430,0.077540397
Charleston-Huntington,25142,374,13,9,7,29,0.077540107
"Tri-Cities, TN-VA",41812,374,11,9,9,29,0.077540107
Detroit,48117,10227,282,272,239,793,0.077539846
Sacramnto-Stkton-Modesto,96122,4243,130,102,97,329,0.077539477
Philadelphia,19943,13735,386,334,345,1065,0.077539134
Norfolk-Portsmth-Newpt Nws,23314,9866,296,238,231,765,0.077539023
San Diego,92029,22248,552,568,605,1725,0.077535059
St. Louis,62015,503,16,8,15,39,0.077534791
Jacksonville,32087,4785,133,137,101,371,0.07753396
Oklahoma City,73116,9738,192,255,308,755,0.077531321
Binghamton,13787,3418,98,85,82,265,0.07753072
Omaha,68653,761,25,18,16,59,0.077529566
Portland-Auburn,4265,890,25,19,25,69,0.07752809
Cleveland-Akron (Canton),44814,2670,77,66,64,207,0.07752809
Indianapolis,47993,4076,117,98,101,316,0.077526987
Omaha,51576,2038,73,52,33,158,0.077526987
Flint-Saginaw-Bay City,48436,3186,82,88,77,247,0.077526679
Binghamton,13815,12757,333,332,324,989,0.077526064
Chicago,60081,9326,273,243,207,723,0.077525198
Albany-Schenectady-Troy,12828,9339,262,212,250,724,0.07752436
Indianapolis,46120,5766,160,146,141,447,0.077523413
Tampa-St. Pete (Sarasota),34609,48619,1399,1218,1152,3769,0.077521134
Fargo,56751,5663,192,127,120,439,0.077520749
Lansing,49227,1161,31,28,31,90,0.07751938
Beaumont-Port Arthur,75928,1161,31,30,29,90,0.07751938
Colorado Springs-Pueblo,81071,258,10,2,8,20,0.07751938
New York,11576,13907,424,355,299,1078,0.077514921
Lincoln & Hastings-Krny,68402,1432,48,38,25,111,0.077513966
Topeka,66534,3651,130,72,81,283,0.07751301
Paducah-Cape Girard-Harsbg,42035,787,26,17,18,61,0.07750953
Knoxville,37716,26036,727,665,626,2018,0.077508066
Knoxville,37721,14489,439,355,329,1123,0.077507074
Syracuse,13147,1187,31,30,31,92,0.077506318
Nashville,38461,1587,51,41,31,123,0.077504726
Houston,77422,13393,377,357,304,1038,0.077503173
Austin,78605,6374,199,171,124,494,0.077502353
Sacramnto-Stkton-Modesto,95837,400,11,10,10,31,0.0775
Raleigh-Durham (Fayetvlle),28391,5484,168,132,125,425,0.077498177
Abilene-Sweetwater,79541,1071,38,24,21,83,0.077497666
Los Angeles,92861,5626,179,148,109,436,0.077497334
Indianapolis,46128,2013,55,49,52,156,0.077496274
Savannah,29907,14930,435,364,358,1157,0.077494977
Binghamton,13797,2426,76,62,50,188,0.077493817
Buffalo,14036,4865,122,128,127,377,0.077492292
Cincinnati,41003,2439,68,67,54,189,0.077490775
Charleston-Huntington,41543,271,7,6,8,21,0.077490775
"Columbus, OH",43756,4878,140,127,111,378,0.077490775
San Francisco-Oak-San Jose,95428,2981,90,67,74,231,0.077490775
Flint-Saginaw-Bay City,48623,14957,494,377,288,1159,0.077488801
"Jackson, TN",38356,1910,48,54,46,148,0.077486911
"Rochester, NY",14468,18726,576,472,403,1451,0.077485849
San Diego,91901,17565,483,448,430,1361,0.077483632
Norfolk-Portsmth-Newpt Nws,27958,13603,433,335,286,1054,0.077482908
Shreveport,71770,3162,88,81,76,245,0.077482606
Oklahoma City,74023,12132,347,312,281,940,0.077481042
Indianapolis,46278,8441,262,197,195,654,0.077478972
Paducah-Cape Girard-Harsbg,42040,1110,27,27,32,86,0.077477477
Paducah-Cape Girard-Harsbg,63751,555,19,13,11,43,0.077477477
Sioux Falls(Mitchell),57451,2375,54,60,70,184,0.077473684
Pittsburgh,16254,3369,89,87,85,261,0.07747106
Roanoke-Lynchburg,24550,7448,218,182,177,577,0.077470462
Syracuse,13092,2530,88,59,49,196,0.077470356
Charleston-Huntington,26164,7603,219,182,188,589,0.07746942
Charlotte,28226,40623,1091,1062,994,3147,0.077468429
Pittsburgh,15235,33743,821,869,924,2614,0.077467919
San Francisco-Oak-San Jose,94002,28942,817,790,635,2242,0.077465275
Utica,13322,710,20,17,18,55,0.077464789
Louisville,40013,6816,221,154,153,528,0.077464789
Youngstown,44425,13774,343,367,357,1067,0.077464789
Sioux City,68786,852,35,19,12,66,0.077464789
Pittsburgh,15239,20332,532,497,546,1575,0.077464096
Tallahassee-Thomasville,32059,2711,88,63,59,210,0.077462191
Los Angeles,92372,5022,142,117,130,389,0.07745918
"Columbia, SC",29054,11787,366,304,243,913,0.077458217
Boston (Manchester),1068,1872,58,44,43,145,0.077457265
St. Louis,62418,1872,59,44,42,145,0.077457265
"Springfield, MO",65722,1588,43,41,39,123,0.077455919
Chicago,61348,4338,135,100,101,336,0.077455048
San Francisco-Oak-San Jose,94010,46298,1365,1202,1019,3586,0.07745475
Oklahoma City,74848,8121,217,235,177,629,0.077453516
Toledo,43524,1162,41,24,25,90,0.077452668
Kansas City,64011,3344,105,78,76,259,0.077452153
Detroit,48464,2040,60,47,51,158,0.07745098
Sioux Falls(Mitchell),51249,3512,98,96,78,272,0.077448747
Dallas-Ft. Worth,76442,7360,221,181,168,570,0.077445652
Boston (Manchester),2035,18697,467,468,513,1448,0.07744558
Fargo,56589,2066,57,57,46,160,0.077444337
Flint-Saginaw-Bay City,48848,7993,232,207,180,619,0.077442762
Sioux Falls(Mitchell),57015,891,30,21,18,69,0.077441077
"Rochester, NY",14561,3125,92,73,77,242,0.07744
Wichita-Hutchinson Plus,67068,4197,133,94,98,325,0.077436264
Wichita Falls & Lawton,73526,1950,60,46,45,151,0.077435897
Shreveport,74766,1201,36,31,26,93,0.07743547
Montgomery-Selma,36028,1653,46,41,41,128,0.077434967
Grand Rapids-Kalmzoo-B.Crk,49065,6470,183,163,155,501,0.077434312
Sioux Falls(Mitchell),57476,452,18,6,11,35,0.077433628
Montgomery-Selma,36024,6380,187,165,142,494,0.077429467
Wilkes Barre-Scranton-Hztn,18810,5954,166,145,150,461,0.07742694
Ft. Wayne,46747,2751,82,63,68,213,0.07742639
Greensboro-H.Point-W.Salem,27350,6587,201,147,162,510,0.077425232
Toledo,45881,1382,43,34,30,107,0.077424023
Erie,16371,3074,91,72,75,238,0.077423552
Abilene-Sweetwater,79567,3087,101,75,63,239,0.077421445
New York,7703,465,11,13,12,36,0.077419355
Paducah-Cape Girard-Harsbg,62923,465,13,14,9,36,0.077419355
Evansville,47567,5774,140,157,150,447,0.077416003
South Bend-Elkhart,46996,6601,165,172,174,511,0.077412513
Harrisburg-Lncstr-Leb-York,17560,5348,141,145,128,414,0.077412117
Little Rock-Pine Bluff,72121,2519,72,61,62,195,0.077411671
New York,8833,8358,262,217,168,647,0.077410864
Shreveport,71061,1421,37,31,42,110,0.077410274
Philadelphia,19063,39246,976,1132,930,3038,0.077409163
New York,7849,8423,218,222,212,652,0.0774071
"Washington, DC (Hagrstwn)",21798,2545,74,59,64,197,0.07740668
"Portland, OR",97089,14172,409,366,322,1097,0.077406153
Syracuse,13122,956,29,27,18,74,0.077405858
Minneapolis-St. Paul,54007,1434,53,34,24,111,0.077405858
Austin,78941,3036,95,71,69,235,0.07740448
Norfolk-Portsmth-Newpt Nws,23430,19831,609,488,438,1535,0.077404064
Miami-Ft. Lauderdale,33432,24792,478,671,770,1919,0.077404001
Minneapolis-St. Paul,55339,969,27,26,22,75,0.077399381
Albany-Schenectady-Troy,12029,1137,31,35,22,88,0.077396658
Minneapolis-St. Paul,54027,1137,41,27,20,88,0.077396658
Yakima-Pasco-Rchlnd-Knnwck,97810,814,24,23,16,63,0.077395577
Sioux City,68769,1796,48,37,54,139,0.077394209
San Francisco-Oak-San Jose,94597,25648,461,580,944,1985,0.077393949
Lexington,41332,1150,29,32,28,89,0.077391304
Champaign&Sprngfld-Decatur,60970,5944,173,154,133,460,0.077388964
Columbia-Jefferson City,65023,1822,54,42,45,141,0.077387486
"Tri-Cities, TN-VA",37743,25560,693,668,617,1978,0.077386541
Providence-New Bedford,2828,7379,245,183,143,571,0.077381759
Sioux Falls(Mitchell),51354,1008,25,27,26,78,0.077380952
Peoria-Bloomington,61526,1176,36,31,24,91,0.077380952
Seattle-Tacoma,98321,19385,599,456,445,1500,0.077379417
Des Moines-Ames,50144,2533,71,61,64,196,0.077378602
Cleveland-Akron (Canton),44662,9628,250,243,252,745,0.077378479
New York,7866,22190,608,571,538,1717,0.077377197
Wilkes Barre-Scranton-Hztn,18705,13919,326,365,386,1077,0.077376248
Greenvll-Spart-Ashevll-And,29351,1538,46,39,34,119,0.077373212
"Springfield, MO",65610,5816,163,150,137,450,0.077372765
Buffalo,14536,685,21,17,15,53,0.077372263
Pittsburgh,15772,1370,29,34,43,106,0.077372263
La Crosse-Eau Claire,54632,1202,35,36,22,93,0.077371048
Madison,53578,6385,181,178,135,494,0.077368833
Ft. Wayne,46702,2081,59,58,44,161,0.077366651
La Crosse-Eau Claire,54621,1396,50,26,32,108,0.077363897
Kansas City,64642,698,19,18,17,54,0.077363897
Oklahoma City,74570,1047,33,28,20,81,0.077363897
Birmingham (Ann and Tusc),35089,1926,50,50,49,149,0.077362409
"Portland, OR",97391,6205,181,128,171,480,0.07735697
Wilkes Barre-Scranton-Hztn,18844,1603,54,33,37,124,0.077354959
Philadelphia,19030,12475,326,312,327,965,0.077354709
Johnstown-Altoona-St Colge,16686,13742,391,315,357,1063,0.077354097
Terre Haute,62450,11622,293,316,290,899,0.077353295
Pittsburgh,16222,2870,84,70,68,222,0.077351916
Philadelphia,19540,11131,313,272,276,861,0.077351541
Greensboro-H.Point-W.Salem,27208,1616,45,40,40,125,0.077351485
St. Louis,63025,17078,562,460,299,1321,0.077350978
Lansing,48890,1978,57,49,47,153,0.077350859
Columbus-Tupelo-West Point,38951,1086,40,24,20,84,0.077348066
Ottumwa-Kirksville,52630,362,12,8,8,28,0.077348066
Salt Lake City,84310,5430,169,143,108,420,0.077348066
Youngstown,16150,7266,197,189,176,562,0.077346546
Los Angeles,91107,33124,674,838,1050,2562,0.077345731
Knoxville,38554,1099,32,28,25,85,0.077343039
Cleveland-Akron (Canton),44085,3297,94,80,81,255,0.077343039
Lansing,48895,11546,331,291,271,893,0.077342803
Bowling Green,42275,918,26,26,19,71,0.077342048
Indianapolis,47346,3698,106,98,82,286,0.077339102
Cedar Rapids-Wtrlo-IWC&Dub,50106,1112,36,28,22,86,0.077338129
Minneapolis-St. Paul,56054,1112,33,29,24,86,0.077338129
Little Rock-Pine Bluff,72564,556,19,11,13,43,0.077338129
Sioux City,68760,1487,46,36,33,115,0.07733692
Tyler-Longview(Lfkn&Ncgd),75943,1487,46,43,26,115,0.07733692
"Columbus, OH",44882,2612,78,65,59,202,0.077335375
Buffalo,14304,28202,695,677,809,2181,0.077334941
Chicago,60527,29146,730,794,730,2254,0.077334797
Cleveland-Akron (Canton),44214,2056,65,52,42,159,0.07733463
Indianapolis,46115,2069,68,50,42,160,0.077332044
Chicago,61325,944,22,26,25,73,0.077330508
Chicago,60084,16618,494,414,377,1285,0.077325791
New York,8802,3634,101,98,82,281,0.077325261
Bangor,4979,957,30,28,16,74,0.077324974
Knoxville,37854,12674,302,348,330,980,0.077323655
Honolulu,96746,20356,560,519,495,1574,0.077323639
Wilkes Barre-Scranton-Hztn,18249,5186,153,145,103,401,0.077323563
Hartford & New Haven,6365,4811,132,118,122,372,0.077322802
Chicago,60044,10230,335,264,192,791,0.077321603
Charleston-Huntington,25601,8911,231,241,217,689,0.077320166
Louisville,47227,1371,45,29,32,106,0.077315828
Omaha,68366,1177,38,35,18,91,0.077315208
Kansas City,66043,10839,341,257,240,838,0.077313405
Dallas-Ft. Worth,75124,4747,151,122,94,367,0.077311987
Youngstown,44413,7127,212,181,158,551,0.077311632
Madison,53532,17630,564,422,377,1363,0.077311401
Greenville-N.Bern-Washngtn,27829,1785,58,45,35,138,0.077310924
Memphis,38120,14306,361,335,410,1106,0.077310219
Ft. Wayne,47348,9339,234,250,238,722,0.077310205
Charlotte,28133,2587,70,69,61,200,0.077309625
New York,8867,4993,147,137,102,386,0.077308232
Baltimore,21409,20736,692,526,385,1603,0.07730517
Sioux City,51458,1410,38,40,31,109,0.077304965
Tucson (Sierra Vista),85704,35069,692,928,1091,2711,0.077304742
Charleston-Huntington,25608,608,16,15,16,47,0.077302632
Rochestr-Mason City-Austin,50449,608,19,12,16,47,0.077302632
St. Louis,62277,1216,33,32,29,94,0.077302632
Tyler-Longview(Lfkn&Ncgd),75946,3661,107,94,82,283,0.077301284
Peoria-Bloomington,61525,11022,400,262,190,852,0.077299946
La Crosse-Eau Claire,54732,2859,94,67,60,221,0.077299755
Louisville,47112,17646,509,450,405,1364,0.077297971
Columbia-Jefferson City,65078,3959,125,93,88,306,0.077292246
New York,11374,46163,889,1176,1503,3568,0.077291337
New York,8830,20999,525,519,579,1623,0.077289395
Evansville,42458,841,28,22,15,65,0.077288942
Cedar Rapids-Wtrlo-IWC&Dub,52175,3377,95,93,73,261,0.077287533
Charlotte,29593,1695,52,36,43,131,0.077286136
New York,10552,20146,421,522,614,1557,0.077285814
Phoenix (Prescott),85141,427,14,11,8,33,0.077283372
Albany-Schenectady-Troy,12020,33772,864,800,946,2610,0.077282956
Indianapolis,47462,4076,117,112,86,315,0.077281649
Detroit,48083,24676,603,587,717,1907,0.077281569
Richmond-Petersburg,23227,25582,541,639,797,1977,0.077280901
Flint-Saginaw-Bay City,48733,1721,47,42,44,133,0.077280651
Eugene,97496,7984,217,192,208,617,0.077279559
Cleveland-Akron (Canton),44057,19436,540,499,463,1502,0.077279276
St. Louis,65550,2381,62,65,57,184,0.077278454
Cleveland-Akron (Canton),44614,13523,374,339,332,1045,0.077275752
"Columbus, OH",45723,3714,116,92,79,287,0.077275175
"Rochester, NY",14513,13640,378,317,359,1054,0.077272727
Richmond-Petersburg,23084,1980,65,48,40,153,0.077272727
Roanoke-Lynchburg,24168,220,6,6,5,17,0.077272727
"Tri-Cities, TN-VA",41766,220,7,5,5,17,0.077272727
Wichita-Hutchinson Plus,67106,440,15,12,7,34,0.077272727
Lake Charles,70643,220,3,8,6,17,0.077272727
Milwaukee,53105,29286,824,742,697,2263,0.077272417
Johnstown-Altoona-St Colge,16636,893,28,21,20,69,0.077267637
Lexington,40346,893,26,21,22,69,0.077267637
San Francisco-Oak-San Jose,94510,26648,721,706,632,2059,0.077266587
"Tri-Cities, TN-VA",37641,9008,245,237,214,696,0.077264654
Birmingham (Ann and Tusc),35131,4090,115,102,99,316,0.077261614
Binghamton,14859,1139,35,29,24,88,0.077260755
South Bend-Elkhart,46555,2744,72,74,66,212,0.077259475
Medford-Klamath Falls,97502,30819,881,765,735,2381,0.077257536
Sioux City,51342,1152,42,34,13,89,0.077256944
"Washington, DC (Hagrstwn)",20662,2537,67,65,64,196,0.077256602
Philadelphia,18078,7171,195,190,169,554,0.077255613
Davenport-R.Island-Moline,52731,699,26,15,13,54,0.077253219
Milwaukee,53217,30330,945,761,637,2343,0.077250247
Springfield-Holyoke,1095,14589,441,392,294,1127,0.077249983
Lansing,49277,3301,112,77,66,255,0.077249318
Greensboro-H.Point-W.Salem,27048,7806,203,211,189,603,0.077248271
Binghamton,13835,1424,46,33,31,110,0.077247191
Cleveland-Akron (Canton),44084,4039,122,103,87,312,0.077246843
Cedar Rapids-Wtrlo-IWC&Dub,52349,7379,223,191,156,570,0.077246239
Indianapolis,47385,1670,37,39,53,129,0.077245509
Madison,54639,2628,88,59,56,203,0.077245053
Green Bay-Appleton,53061,5062,147,108,136,391,0.077242197
Buffalo,14042,4130,118,93,108,319,0.077239709
Louisville,47469,1709,55,40,37,132,0.077238151
Fargo,58047,5645,203,132,101,436,0.077236492
Syracuse,13073,6137,161,152,161,474,0.077236435
Rochestr-Mason City-Austin,50439,246,8,5,6,19,0.077235772
Sioux City,68790,738,21,16,20,57,0.077235772
San Antonio,78152,2460,71,60,59,190,0.077235772
Madison,53533,7160,185,191,177,553,0.077234637
"Jackson, MS",39110,49460,1631,1183,1006,3820,0.077234129
Providence-New Bedford,2919,30052,739,746,836,2321,0.077232796
Knoxville,40815,997,37,20,20,77,0.077231695
Tulsa,74042,751,24,15,19,58,0.07723036
"Portland, OR",97103,18529,490,452,489,1431,0.077230288
Evansville,42378,3263,98,83,71,252,0.077229543
New York,7656,9543,262,249,226,737,0.077229383
Milwaukee,53130,7536,188,189,205,582,0.077229299
"Charleston, SC",29481,1761,38,43,55,136,0.077228847
"Charleston, SC",29518,1269,38,31,29,98,0.077226162
Providence-New Bedford,2891,21638,526,537,608,1671,0.077225252
Wheeling-Steubenville,26167,764,24,20,15,59,0.077225131
Syracuse,13116,3574,98,86,92,276,0.077224398
"Tri-Cities, TN-VA",40810,1023,31,29,19,79,0.077223851
New York,6801,20473,605,478,498,1581,0.07722366
Richmond-Petersburg,23235,35106,931,868,912,2711,0.077223267
"Albany, GA",31733,1541,52,35,32,119,0.077222583
Boston (Manchester),1440,21458,477,532,648,1657,0.077220617
Toledo,49288,1295,36,34,30,100,0.077220077
Little Rock-Pine Bluff,71941,1813,60,37,43,140,0.077220077
"Rochester, NY",14098,2862,90,70,61,221,0.077218728
Champaign&Sprngfld-Decatur,62642,1308,39,34,28,101,0.077217125
Rockford,61072,11034,325,293,234,852,0.077215878
Sacramnto-Stkton-Modesto,95619,3950,104,105,96,305,0.07721519
Portland-Auburn,4020,1593,37,41,45,123,0.077212806
Boston (Manchester),2644,3989,133,95,80,308,0.077212334
Minneapolis-St. Paul,56345,15179,428,352,392,1172,0.077211938
"Columbus, OH",43845,4831,139,120,114,373,0.077209687
Clarksburg-Weston,26451,544,19,10,13,42,0.077205882
"Columbus, OH",45622,544,14,14,14,42,0.077205882
Paducah-Cape Girard-Harsbg,62970,544,21,13,8,42,0.077205882
Denver,80742,272,7,7,7,21,0.077205882
Parkersburg,26105,12331,319,300,333,952,0.077203795
Springfield-Holyoke,1022,2500,68,69,56,193,0.0772
"Rochester, NY",14505,5052,142,127,121,390,0.07719715
Tampa-St. Pete (Sarasota),34691,24146,604,602,658,1864,0.077197051
Nashville,37012,2539,65,65,66,196,0.077195746
Utica,12149,2280,58,64,54,176,0.077192982
Charleston-Huntington,25169,285,10,7,5,22,0.077192982
Fargo,56713,855,31,17,18,66,0.077192982
"Portland, OR",97019,3161,92,82,70,244,0.077190762
Baton Rouge,70783,2306,71,53,54,178,0.077189939
San Francisco-Oak-San Jose,94116,41638,800,1033,1381,3214,0.077189106
Fairbanks,99714,1179,43,24,24,91,0.077184054
Boston (Manchester),2341,10689,292,268,265,825,0.07718215
"Charleston, SC",29554,8020,226,205,188,619,0.077182045
Kansas City,64445,298,7,7,9,23,0.077181208
Yakima-Pasco-Rchlnd-Knnwck,97835,298,9,9,5,23,0.077181208
Denver,80105,2099,64,43,55,162,0.077179609
"Charleston, SC",29453,1205,34,36,23,93,0.077178423
Wausau-Rhinelander,54490,907,30,21,19,70,0.077177508
Dothan,36312,5766,163,151,131,445,0.077176552
"Washington, DC (Hagrstwn)",26761,609,18,14,15,47,0.077175698
Terre Haute,47557,1231,39,30,26,95,0.07717303
New Orleans,70005,24724,526,628,754,1908,0.077171979
"Columbus, OH",44818,2475,76,65,50,191,0.077171717
Kansas City,66078,933,29,25,18,72,0.077170418
Little Rock-Pine Bluff,72030,622,20,15,13,48,0.077170418
Seattle-Tacoma,98528,11546,313,269,309,891,0.077169583
Odessa-Midland,79331,11572,341,299,253,893,0.077169029
Raleigh-Durham (Fayetvlle),27589,6894,216,164,152,532,0.077168552
Baltimore,21140,3136,108,81,53,242,0.077168367
Norfolk-Portsmth-Newpt Nws,23421,4082,117,96,102,315,0.077168055
Hartford & New Haven,6234,8501,233,217,206,656,0.077167392
Wilkes Barre-Scranton-Hztn,18322,2229,62,55,55,172,0.077164648
Milwaukee,53147,18221,481,475,450,1406,0.077163712
Harrisburg-Lncstr-Leb-York,17315,26956,716,654,710,2080,0.077162784
Denver,80116,4821,164,130,78,372,0.077162414
Syracuse,13114,6493,191,142,168,501,0.077160018
Orlando-Daytona Bch-Melbrn,32784,11833,353,273,287,913,0.077157103
Indianapolis,47368,2631,76,70,57,203,0.077156975
Roanoke-Lynchburg,23962,661,18,17,16,51,0.077155825
"Columbus, OH",45672,1672,50,42,37,129,0.07715311
Birmingham (Ann and Tusc),35033,4044,110,102,100,312,0.077151335
Cincinnati,45162,2359,68,59,55,182,0.077151335
Peoria-Bloomington,62617,674,13,18,21,52,0.077151335
Wichita-Hutchinson Plus,67438,337,11,8,7,26,0.077151335
Minneapolis-St. Paul,55042,14841,500,384,261,1145,0.077151135
Philadelphia,8077,19715,536,503,482,1521,0.077149379
Reno,89521,44965,1241,1088,1140,3469,0.077148894
Lincoln & Hastings-Krny,68465,2385,71,61,52,184,0.077148847
New York,7853,12651,416,329,231,976,0.077148052
Los Angeles,90230,31887,733,779,948,2460,0.077147427
"Washington, DC (Hagrstwn)",20744,51020,1224,1244,1468,3936,0.077146217
Davenport-R.Island-Moline,61467,1050,37,25,19,81,0.077142857
Philadelphia,8067,1763,54,41,41,136,0.077141237
Missoula,59865,3578,113,86,77,276,0.077138066
Miami-Ft. Lauderdale,33031,6871,200,174,156,530,0.077135788
Mobile-Pensacola (Ft Walt),36535,40526,1093,971,1062,3126,0.077135666
Fargo,56550,363,15,7,6,28,0.077134986
Champaign&Sprngfld-Decatur,60968,363,11,9,8,28,0.077134986
Ft. Wayne,46779,1828,57,42,42,141,0.077133479
Greenville-N.Bern-Washngtn,28560,28587,768,693,744,2205,0.077132963
Greenvll-Spart-Ashevll-And,28748,12887,376,302,316,994,0.077131993
Buffalo,14145,1478,41,41,32,114,0.077131258
Hartford & New Haven,6085,7118,213,183,153,549,0.077128407
Charleston-Huntington,25573,752,19,21,18,58,0.07712766
"Columbus, OH",45778,752,24,19,15,58,0.07712766
Madison,53943,1128,30,30,27,87,0.07712766
Sioux Falls(Mitchell),56110,1880,53,45,47,145,0.07712766
Tyler-Longview(Lfkn&Ncgd),75835,10917,325,268,249,842,0.077127416
Peoria-Bloomington,61611,23377,623,601,579,1803,0.077127091
Boston (Manchester),2370,17828,451,429,495,1375,0.077125869
"Portland, OR",98671,25517,751,657,560,1968,0.077125054
Augusta-Aiken,29805,6483,184,164,152,500,0.077124788
"Columbus, OH",43105,8804,257,219,203,679,0.077124035
Pittsburgh,16046,20020,603,552,389,1544,0.077122877
Hartford & New Haven,6483,16675,419,431,436,1286,0.077121439
Terre Haute,62452,389,13,11,6,30,0.077120823
Amarillo,79036,4668,148,118,94,360,0.077120823
Pittsburgh,15681,4681,120,124,117,361,0.077120273
"Tri-Cities, TN-VA",24202,12526,375,303,288,966,0.077119591
New York,7935,1180,41,32,18,91,0.077118644
Greenville-N.Bern-Washngtn,27846,2762,65,74,74,213,0.07711803
Omaha,64482,1997,56,51,47,154,0.077115674
"Tri-Cities, TN-VA",24201,16080,415,383,442,1240,0.077114428
Knoxville,40819,402,13,10,8,31,0.077114428
Wichita-Hutchinson Plus,67663,2438,71,59,58,188,0.077112387
Kansas City,64624,1634,39,48,39,126,0.077111383
Bluefield-Beckley-Oak Hill,25083,415,11,11,10,32,0.077108434
Ft. Smith-Fay-Sprngdl-Rgrs,72948,415,13,11,8,32,0.077108434
Bangor,4493,1699,45,44,42,131,0.077104179
"Springfield, MO",65652,3826,119,102,74,295,0.077104025
Albany-Schenectady-Troy,12859,2140,64,51,50,165,0.077102804
Philadelphia,17026,3852,112,103,82,297,0.077102804
Greenville-N.Bern-Washngtn,28466,8599,261,208,194,663,0.077101989
Birmingham (Ann and Tusc),36251,5175,148,121,130,399,0.077101449
Savannah,30446,1738,48,35,51,134,0.077100115
Sioux City,51050,2607,92,56,53,201,0.077100115
Bluefield-Beckley-Oak Hill,25844,1310,43,28,30,101,0.077099237
Burlington-Plattsburgh,12946,5266,133,118,155,406,0.077098367
Champaign&Sprngfld-Decatur,60931,441,11,10,13,34,0.077097506
Memphis,38965,8911,223,226,238,687,0.077095724
Lansing,48820,17939,576,459,348,1383,0.077094598
Atlanta,30730,1816,53,47,40,140,0.077092511
Kansas City,66767,454,13,13,9,35,0.077092511
"Jackson, TN",38318,467,12,11,13,36,0.077087794
Charleston-Huntington,25202,1414,43,34,32,109,0.07708628
Pittsburgh,15017,17228,423,473,432,1328,0.077083817
Evansville,42366,6240,193,150,138,481,0.077083333
Cedar Rapids-Wtrlo-IWC&Dub,52362,960,31,26,17,74,0.077083333
"Charleston, SC",29477,6318,199,151,137,487,0.077081355
"Washington, DC (Hagrstwn)",22625,3892,115,99,86,300,0.077081192
Baltimore,21012,23443,732,597,478,1807,0.077080578
Sacramnto-Stkton-Modesto,95971,5955,149,149,161,459,0.077078086
Chicago,60056,53349,1431,1352,1329,4112,0.077077359
"Rochester, NY",14532,3996,116,103,89,308,0.077077077
Memphis,72101,3010,94,71,67,232,0.077076412
Dothan,36319,2517,81,63,50,194,0.077075884
Philadelphia,8034,19099,482,503,487,1472,0.077072098
Little Rock-Pine Bluff,71964,3620,110,93,76,279,0.077071823
Los Angeles,90402,11522,327,294,267,888,0.077069953
Terre Haute,47597,1064,30,30,22,82,0.077067669
Kansas City,64493,532,18,13,10,41,0.077067669
Oklahoma City,74834,7033,198,180,164,542,0.077065264
Roanoke-Lynchburg,24381,3789,90,102,100,292,0.077065189
Quincy-Hannibal-Keokuk,62358,545,16,12,14,42,0.07706422
Peoria-Bloomington,61725,1687,51,41,38,130,0.07705987
San Francisco-Oak-San Jose,94551,40021,1071,1027,986,3084,0.077059544
New York,11235,82975,1899,2164,2331,6394,0.077059355
Charlottesville,22715,1155,33,25,31,89,0.077056277
Beaumont-Port Arthur,77585,1765,58,42,36,136,0.077053824
Chicago,46348,1220,36,32,26,94,0.07704918
Roanoke-Lynchburg,24538,4893,138,110,129,377,0.077048845
Wilkes Barre-Scranton-Hztn,17756,10448,322,253,230,805,0.077048239
Louisville,40109,3699,97,89,99,285,0.077047851
Greensboro-H.Point-W.Salem,27042,623,16,17,15,48,0.077046549
Minneapolis-St. Paul,55051,10007,301,243,227,771,0.077046068
"Washington, DC (Hagrstwn)",20832,25247,767,632,546,1945,0.077038856
Presque Isle,4740,1363,40,31,34,105,0.07703595
Portland-Auburn,3901,8191,247,200,184,631,0.077035771
Boston (Manchester),3276,9022,224,234,237,695,0.077033917
Nashville,37352,3557,94,96,84,274,0.077031206
Burlington-Plattsburgh,5443,6465,157,173,168,498,0.077030162
New York,7045,10152,299,269,214,782,0.077029157
Joplin-Pittsburg,66751,727,24,16,16,56,0.077028886
"Washington, DC (Hagrstwn)",22724,2934,83,79,64,226,0.077027948
Sioux City,68729,1519,52,35,30,117,0.077024358
Nashville,37026,2285,63,58,55,176,0.07702407
Richmond-Petersburg,23181,6102,181,148,141,470,0.077023927
Los Angeles,92823,6219,172,152,155,479,0.077022029
Des Moines-Ames,50003,10556,367,245,201,813,0.07701781
Savannah,30471,4934,153,127,100,380,0.077016619
Kansas City,64631,857,32,19,15,66,0.077012835
Charleston-Huntington,25674,2584,81,65,53,199,0.077012384
Los Angeles,91202,22529,498,526,711,1735,0.077011851
Philadelphia,8270,7934,226,182,203,611,0.077010335
Dayton,45371,24296,742,600,529,1871,0.077008561
Dallas-Ft. Worth,75143,15388,436,371,378,1185,0.077008058
Boston (Manchester),1522,3662,111,90,81,282,0.0770071
Rochestr-Mason City-Austin,50461,5649,168,120,147,435,0.07700478
Minneapolis-St. Paul,56352,5688,184,131,123,438,0.077004219
Atlanta,36258,1935,55,45,49,149,0.077002584
Little Rock-Pine Bluff,71665,5078,137,138,116,391,0.076998818
Toledo,44867,2078,51,51,58,160,0.076997113
Cedar Rapids-Wtrlo-IWC&Dub,52358,4156,109,112,99,320,0.076997113
La Crosse-Eau Claire,54642,2156,65,52,49,166,0.076994434
Birmingham (Ann and Tusc),35564,2169,61,48,58,167,0.076994006
Pittsburgh,21520,2221,61,55,55,171,0.076992346
Philadelphia,19072,10170,314,277,192,783,0.07699115
Kansas City,66040,3481,113,93,62,268,0.076989371
Charlotte,29729,2325,75,56,48,179,0.076989247
St. Louis,62088,6430,208,161,126,495,0.076982893
Little Rock-Pine Bluff,71945,1286,43,32,24,99,0.076982893
Madison,53527,11704,403,295,203,901,0.076982228
Seattle-Tacoma,98072,26137,746,655,611,2012,0.076978995
Ft. Smith-Fay-Sprngdl-Rgrs,72847,2949,92,69,66,227,0.076975246
Lexington,41164,11939,367,281,271,919,0.076974621
Dallas-Ft. Worth,76365,4846,143,117,113,373,0.076970697
Meridian,36912,1650,45,49,33,127,0.076969697
Lincoln & Hastings-Krny,68638,1663,50,39,39,128,0.076969333
Huntsville-Decatur (Flor),35618,1689,40,40,50,130,0.07696862
Milwaukee,53085,11875,358,275,281,914,0.076968421
Syracuse,13131,3508,103,82,85,270,0.076966933
Shreveport,75638,5353,159,142,111,412,0.076966187
Dallas-Ft. Worth,75840,7497,246,191,140,577,0.076964119
Boston (Manchester),1364,7666,220,181,189,590,0.076963214
Yakima-Pasco-Rchlnd-Knnwck,99323,3859,115,94,88,297,0.076962944
"Albany, GA",31790,1936,66,40,43,149,0.07696281
Evansville,62863,9434,270,229,227,726,0.076955692
Tyler-Longview(Lfkn&Ncgd),75773,14190,426,345,321,1092,0.076955603
Los Angeles,92365,2443,68,66,54,188,0.076954564
Denver,80128,35255,973,939,801,2713,0.076953624
Seattle-Tacoma,98029,32215,1053,680,746,2479,0.076951731
Knoxville,37888,2820,86,65,66,217,0.076950355
San Francisco-Oak-San Jose,94043,31787,535,741,1170,2446,0.076949696
Columbia-Jefferson City,64658,3002,85,77,69,231,0.076948701
Cincinnati,45068,12255,421,295,227,943,0.076948184
Johnstown-Altoona-St Colge,15825,9591,259,245,234,738,0.076947138
Miami-Ft. Lauderdale,33004,18482,422,468,532,1422,0.076939725
Indianapolis,47446,9397,248,259,216,723,0.076939449
San Francisco-Oak-San Jose,95032,28101,917,782,463,2162,0.076936764
New York,11364,35172,802,936,968,2706,0.076936199
Detroit,48455,8670,248,228,191,667,0.076931949
Miami-Ft. Lauderdale,33125,52725,1220,1378,1458,4056,0.076927454
"Washington, DC (Hagrstwn)",20853,27988,800,727,626,2153,0.076925825
New York,7058,5798,149,151,146,446,0.076923077
Albany-Schenectady-Troy,12031,117,3,2,4,9,0.076923077
Albany-Schenectady-Troy,12094,2301,60,57,60,177,0.076923077
Albany-Schenectady-Troy,12485,1274,39,30,29,98,0.076923077
Albany-Schenectady-Troy,12886,91,3,2,2,7,0.076923077
Buffalo,14747,2080,62,51,47,160,0.076923077
Johnstown-Altoona-St Colge,15945,208,6,5,5,16,0.076923077
Wilkes Barre-Scranton-Hztn,16910,65,2,2,1,5,0.076923077
Baltimore,21650,65,2,2,1,5,0.076923077
Charlottesville,22730,78,2,2,2,6,0.076923077
Bluefield-Beckley-Oak Hill,24984,91,4,1,2,7,0.076923077
Charleston-Huntington,25021,156,5,3,4,12,0.076923077
Charleston-Huntington,25251,468,13,12,11,36,0.076923077
Charleston-Huntington,25505,39,1,1,1,3,0.076923077
Jacksonville,32139,1456,44,36,32,112,0.076923077
Montgomery-Selma,36030,559,15,15,13,43,0.076923077
"Jackson, TN",38313,3094,93,77,68,238,0.076923077
Lexington,40983,260,8,7,5,20,0.076923077
Charleston-Huntington,41135,247,8,5,6,19,0.076923077
Charleston-Huntington,41204,481,16,10,11,37,0.076923077
"Tri-Cities, TN-VA",41804,650,22,15,13,50,0.076923077
Paducah-Cape Girard-Harsbg,42078,1703,48,44,39,131,0.076923077
"Columbus, OH",43037,78,2,2,2,6,0.076923077
Cleveland-Akron (Canton),44321,16445,481,386,398,1265,0.076923077
Indianapolis,46146,65,2,1,2,5,0.076923077
Louisville,47174,65,2,2,1,5,0.076923077
Terre Haute,47449,442,13,12,9,34,0.076923077
Omaha,50042,260,9,5,6,20,0.076923077
Des Moines-Ames,50052,143,5,3,3,11,0.076923077
Des Moines-Ames,50101,65,2,2,1,5,0.076923077
Cedar Rapids-Wtrlo-IWC&Dub,52209,1066,31,26,25,82,0.076923077
Cedar Rapids-Wtrlo-IWC&Dub,52257,351,12,9,6,27,0.076923077
Davenport-R.Island-Moline,52750,585,15,17,13,45,0.076923077
Green Bay-Appleton,54127,156,5,3,4,12,0.076923077
Minneapolis-St. Paul,56481,2015,70,43,42,155,0.076923077
Sioux Falls(Mitchell),57344,208,7,4,5,16,0.076923077
Sioux Falls(Mitchell),57537,91,3,3,1,7,0.076923077
Fargo,58267,1534,61,35,22,118,0.076923077
Peoria-Bloomington,61336,507,15,14,10,39,0.076923077
Davenport-R.Island-Moline,61442,663,19,17,15,51,0.076923077
Peoria-Bloomington,61737,507,13,13,13,39,0.076923077
Champaign&Sprngfld-Decatur,62523,585,12,8,25,45,0.076923077
Quincy-Hannibal-Keokuk,63442,13,1,0,0,1,0.076923077
Kansas City,64652,390,14,9,7,30,0.076923077
Wichita-Hutchinson Plus,67019,897,30,14,25,69,0.076923077
Omaha,68002,2158,67,57,42,166,0.076923077
Lincoln & Hastings-Krny,68381,221,7,5,5,17,0.076923077
New Orleans,70036,1027,29,25,25,79,0.076923077
"Springfield, MO",72539,338,11,8,7,26,0.076923077
Oklahoma City,73638,104,2,3,3,8,0.076923077
Oklahoma City,73764,39,1,1,1,3,0.076923077
Tulsa,74633,546,17,15,10,42,0.076923077
Abilene-Sweetwater,79503,273,8,8,5,21,0.076923077
Denver,80746,39,1,1,1,3,0.076923077
Denver,81045,104,4,1,3,8,0.076923077
Denver,82222,195,2,6,7,15,0.076923077
Cheyenne-Scottsbluff,82223,819,25,21,17,63,0.076923077
Salt Lake City,82936,52,2,1,1,4,0.076923077
Salt Lake City,84533,117,3,3,3,9,0.076923077
Salt Lake City,84731,117,4,3,2,9,0.076923077
Albuquerque-Santa Fe,88344,143,4,4,3,11,0.076923077
San Francisco-Oak-San Jose,94143,78,2,2,2,6,0.076923077
"Portland, OR",97117,650,20,15,15,50,0.076923077
Grand Rapids-Kalmzoo-B.Crk,49053,7034,197,148,196,541,0.076912141
Boston (Manchester),2468,6436,234,153,108,495,0.076911125
Eugene,97424,18762,505,486,452,1443,0.076910777
Houston,77868,17137,522,390,406,1318,0.076909611
Chicago,60195,5136,102,114,179,395,0.0769081
"Albany, GA",31730,10142,280,248,252,780,0.076907908
Dallas-Ft. Worth,75473,3784,117,90,84,291,0.076902748
New York,7067,18530,502,469,454,1425,0.076902321
New York,7738,7334,232,187,145,564,0.0769021
Little Rock-Pine Bluff,72021,3511,86,90,94,270,0.076901168
Columbia-Jefferson City,65081,3420,113,82,68,263,0.076900585
Miami-Ft. Lauderdale,33021,51042,1259,1274,1392,3925,0.076897457
Lansing,49284,2939,88,67,71,226,0.076896904
Greensboro-H.Point-W.Salem,27025,11262,296,292,278,866,0.076895756
Baton Rouge,70722,5189,158,113,128,399,0.076893428
Wilkes Barre-Scranton-Hztn,18850,2445,63,61,64,188,0.076891616
Sioux City,51346,2302,60,64,53,177,0.076889661
Hartford & New Haven,6060,2263,83,59,32,174,0.076889085
New York,7885,13097,310,333,364,1007,0.076887837
Kansas City,65351,2107,67,62,33,162,0.076886569
Knoxville,37829,1860,58,37,48,143,0.07688172
Wheeling-Steubenville,26155,7401,209,178,182,569,0.076881502
Sioux Falls(Mitchell),51237,1730,59,37,37,133,0.076878613
Clarksburg-Weston,26253,3447,92,77,96,265,0.076878445
Indianapolis,46069,8468,264,195,192,651,0.076877657
Madison,53566,14894,410,349,386,1145,0.076876595
Sacramnto-Stkton-Modesto,95746,21502,726,568,359,1653,0.07687657
Traverse City-Cadillac,49405,1652,45,41,41,127,0.076876513
Tallahassee-Thomasville,39815,1626,55,40,30,125,0.076875769
Binghamton,13052,1613,45,44,35,124,0.076875387
Omaha,68355,4813,148,110,112,370,0.07687513
Denver,80215,20358,397,492,676,1565,0.076873956
Little Rock-Pine Bluff,72157,1561,48,40,32,120,0.076873799
Baltimore,21074,14921,429,374,344,1147,0.076871523
Miami-Ft. Lauderdale,33165,52634,1244,1406,1396,4046,0.076870464
Grand Rapids-Kalmzoo-B.Crk,49083,8222,268,195,169,632,0.076866942
Topeka,66839,4059,127,112,73,312,0.076866223
Birmingham (Ann and Tusc),35578,5165,143,132,122,397,0.076863504
Toledo,44836,2420,69,62,55,186,0.076859504
Green Bay-Appleton,54245,2407,65,62,58,185,0.076859161
Tampa-St. Pete (Sarasota),33629,26165,775,666,570,2011,0.076858399
Peoria-Bloomington,61533,2303,61,58,58,177,0.076856274
Baltimore,21090,11398,270,270,336,876,0.076855589
Davenport-R.Island-Moline,52742,7833,233,184,185,602,0.076854334
Macon,31071,1080,29,27,27,83,0.076851852
Norfolk-Portsmth-Newpt Nws,23662,12752,400,312,268,980,0.07685069
Sioux Falls(Mitchell),57328,1028,35,19,25,79,0.076848249
Toledo,43449,8198,245,211,174,630,0.076848012
Cincinnati,45171,6090,179,150,139,468,0.076847291
Joplin-Pittsburg,66753,1015,30,25,23,78,0.076847291
Hartford & New Haven,6403,6077,153,159,155,467,0.076847129
Buffalo,14085,8068,249,195,176,620,0.076846802
Wausau-Rhinelander,54494,27367,720,697,686,2103,0.076844375
Wilkes Barre-Scranton-Hztn,17970,2902,62,69,92,223,0.076843556
Raleigh-Durham (Fayetvlle),27856,16970,474,426,404,1304,0.076841485
Orlando-Daytona Bch-Melbrn,32776,12884,406,317,267,990,0.076839491
"Portland, OR",97845,2746,74,67,70,211,0.076839039
Omaha,51559,1822,65,28,47,140,0.076838639
Paducah-Cape Girard-Harsbg,63954,885,18,30,20,68,0.076836158
Tulsa,74301,11414,329,284,264,877,0.076835465
Charlotte,28006,859,24,22,20,66,0.076833527
Clarksburg-Weston,26269,846,23,23,19,65,0.076832151
Burlington-Plattsburgh,12972,5870,169,134,148,451,0.076831346
New York,6611,38344,1241,928,777,2946,0.076830795
Sioux City,68740,833,25,20,19,64,0.076830732
Sioux Falls(Mitchell),57030,3293,110,76,67,253,0.076829639
Columbia-Jefferson City,65231,3189,90,73,82,245,0.076826591
Philadelphia,18954,9554,285,264,185,734,0.07682646
New York,10578,794,22,20,19,61,0.076826196
Syracuse,13159,4738,150,114,100,364,0.076825665
Birmingham (Ann and Tusc),35953,7823,212,196,193,601,0.076824748
Elmira (Corning),14845,20072,526,492,524,1542,0.076823436
Chico-Redding,95943,768,21,21,17,59,0.076822917
Wilkes Barre-Scranton-Hztn,18433,6131,154,158,159,471,0.076822704
Burlington-Plattsburgh,3785,2252,53,55,65,173,0.076820604
Norfolk-Portsmth-Newpt Nws,23315,1497,47,35,33,115,0.076820307
Denver,81120,2239,76,59,37,172,0.076820009
Wilkes Barre-Scranton-Hztn,18332,2955,90,63,74,227,0.076818951
Hartford & New Haven,6776,26557,727,677,636,2040,0.076815905
Little Rock-Pine Bluff,71950,716,19,19,17,55,0.076815642
Burlington-Plattsburgh,12986,4999,133,130,121,384,0.076815363
Cheyenne-Scottsbluff,82053,1419,46,36,27,109,0.076814658
Peoria-Bloomington,61610,4908,113,129,135,377,0.076813366
Milwaukee,53189,28485,851,755,582,2188,0.076812357
Bismarck-Mnt-Dcknsn(Wlstn),58374,690,23,15,15,53,0.076811594
Champaign&Sprngfld-Decatur,61873,6002,210,145,106,461,0.076807731
Tulsa,74039,3984,119,95,92,306,0.076807229
Nashville,37064,70530,2192,1777,1448,5417,0.076804197
Charleston-Huntington,41216,1276,39,29,30,98,0.076802508
Omaha,68045,1901,62,46,38,146,0.076801683
Minneapolis-St. Paul,56358,3151,98,78,66,242,0.076801016
Omaha,51571,625,21,15,12,48,0.0768
"Washington, DC (Hagrstwn)",20861,1862,59,50,34,143,0.076799141
Fargo,56537,19167,578,440,454,1472,0.076798664
Wausau-Rhinelander,54556,1211,39,33,21,93,0.076796036
Ft. Wayne,46701,7761,215,190,191,596,0.076794228
Waco-Temple-Bryan,76539,9988,314,247,206,767,0.076792151
Miami-Ft. Lauderdale,33145,30694,631,739,987,2357,0.076790252
Orlando-Daytona Bch-Melbrn,32128,22321,629,571,514,1714,0.076788674
Memphis,38057,3907,106,95,99,300,0.076785257
Peoria-Bloomington,61705,13896,454,329,284,1067,0.076784686
Green Bay-Appleton,54137,1081,34,29,20,83,0.076780759
Austin,78662,2696,77,69,61,207,0.076780415
Panama City,32433,19237,526,492,459,1477,0.076779124
Pittsburgh,15479,2123,60,45,58,163,0.076778144
New York,7452,12087,442,294,192,928,0.076776702
Cincinnati,45152,16268,530,393,326,1249,0.076776494
Rochestr-Mason City-Austin,50616,9938,293,223,247,763,0.076776011
Columbia-Jefferson City,63352,1029,32,24,23,79,0.076773567
Raleigh-Durham (Fayetvlle),27574,14784,392,381,362,1135,0.076772186
Minneapolis-St. Paul,55110,38870,1037,1048,899,2984,0.076768716
Cincinnati,41034,990,27,27,22,76,0.076767677
Des Moines-Ames,50277,495,16,12,10,38,0.076767677
Ft. Smith-Fay-Sprngdl-Rgrs,72926,495,15,12,11,38,0.076767677
Champaign&Sprngfld-Decatur,62515,977,30,22,23,75,0.076765609
Minneapolis-St. Paul,56308,27565,760,646,710,2116,0.076764012
Bluefield-Beckley-Oak Hill,24941,482,19,8,10,37,0.076763485
Johnstown-Altoona-St Colge,16683,469,13,13,10,36,0.076759062
Minneapolis-St. Paul,55356,5589,192,159,78,429,0.076757917
San Francisco-Oak-San Jose,94536,74025,1892,1857,1933,5682,0.076757852
Louisville,40071,17132,509,448,358,1315,0.076756946
Charleston-Huntington,25063,925,27,26,18,71,0.076756757
Medford-Klamath Falls,97526,36311,932,921,934,2787,0.076753601
Rockford,61024,2723,77,72,60,209,0.076753581
Waco-Temple-Bryan,76642,6801,207,151,164,522,0.076753419
Louisville,47118,3153,93,85,64,242,0.076752299
Omaha,50022,7987,239,179,195,613,0.076749718
Charleston-Huntington,25030,443,14,11,9,34,0.076749436
Boston (Manchester),2188,15245,293,395,482,1170,0.076746474
Quincy-Hannibal-Keokuk,62363,5642,172,113,148,433,0.076745835
Memphis,38060,12535,306,321,335,962,0.076745114
Houston,78934,6906,184,166,180,530,0.07674486
Oklahoma City,73761,430,15,11,7,33,0.076744186
Wichita Falls & Lawton,76424,8470,248,221,181,650,0.07674144
Norfolk-Portsmth-Newpt Nws,27954,6750,192,163,163,518,0.076740741
Pittsburgh,15920,834,22,21,21,64,0.076738609
Charleston-Huntington,25521,808,18,24,20,62,0.076732673
Des Moines-Ames,50166,1616,59,37,28,124,0.076732673
Bluefield-Beckley-Oak Hill,25825,1590,51,38,33,122,0.07672956
Shreveport,71419,1981,57,51,44,152,0.076728925
Charleston-Huntington,26691,391,12,9,9,30,0.076726343
"Alexandria, LA",71323,1173,33,26,31,90,0.076726343
Oklahoma City,73660,391,10,11,9,30,0.076726343
Toledo,43416,2698,83,64,60,207,0.076723499
Los Angeles,92358,769,28,15,16,59,0.076723017
Joplin-Pittsburg,67342,756,26,12,20,58,0.076719577
Greensboro-H.Point-W.Salem,28669,2633,80,61,61,202,0.076718572
Hartford & New Haven,6043,4797,141,117,110,368,0.076714613
Terre Haute,62442,2203,69,50,50,169,0.076713572
"Lafayette, LA",71353,1460,58,31,23,112,0.076712329
Milwaukee,53132,36096,1049,918,802,2769,0.076712101
Marquette,49801,11667,336,292,267,895,0.076712094
Philadelphia,18040,18172,539,439,416,1394,0.076711424
Philadelphia,18067,19554,522,499,479,1500,0.076710647
Indianapolis,46076,1447,34,37,40,111,0.076710435
"Albany, GA",31783,1069,25,30,27,82,0.076707203
Raleigh-Durham (Fayetvlle),28315,14784,357,375,402,1134,0.076704545
Quincy-Hannibal-Keokuk,63438,352,13,7,7,27,0.076704545
Greenvll-Spart-Ashevll-And,28752,29803,858,737,691,2286,0.076703688
Indianapolis,47456,1395,38,36,33,107,0.076702509
Joplin-Pittsburg,65745,2438,73,60,54,187,0.076702215
Buffalo,16746,1043,27,24,29,80,0.076701822
Paducah-Cape Girard-Harsbg,62939,3090,85,80,72,237,0.076699029
Tucson (Sierra Vista),85748,19218,479,480,515,1474,0.076698928
Toledo,45814,2712,80,61,67,208,0.076696165
Omaha,51532,678,22,17,13,52,0.076696165
La Crosse-Eau Claire,54738,3729,120,98,68,286,0.076696165
Sioux Falls(Mitchell),57460,339,12,8,6,26,0.076696165
Tulsa,74056,4720,147,114,101,362,0.076694915
"Charleston, SC",29431,6050,176,142,146,464,0.076694215
Burlington-Plattsburgh,5455,1343,39,30,34,103,0.076693969
Boston (Manchester),3031,11944,427,287,202,916,0.076691226
"Springfield, MO",65617,1656,51,40,36,127,0.076690821
Wilkes Barre-Scranton-Hztn,17845,2647,78,59,66,203,0.076690593
"Albany, GA",31712,991,26,25,25,76,0.076690212
Louisville,40171,326,11,8,6,25,0.076687117
Gainesville,32618,7472,226,182,165,573,0.076686296
Savannah,31320,10667,304,252,262,818,0.076685104
Wilmington,28392,1278,35,32,31,98,0.076682316
Huntsville-Decatur (Flor),35613,26473,789,617,624,2030,0.076681902
Minneapolis-St. Paul,55115,8894,309,217,156,682,0.076680908
Dayton,45321,952,19,30,24,73,0.076680672
St. Louis,63957,3808,112,99,81,292,0.076680672
Oklahoma City,73077,6664,193,162,156,511,0.076680672
Johnstown-Altoona-St Colge,16680,313,9,9,6,24,0.076677316
Cleveland-Akron (Canton),43464,1252,29,33,34,96,0.076677316
San Angelo,76936,2178,70,55,42,167,0.076675849
Charlotte,28654,3404,90,82,89,261,0.076674501
Los Angeles,92692,45848,1137,1216,1162,3515,0.076666376
Champaign&Sprngfld-Decatur,62693,1774,54,48,34,136,0.076662909
Orlando-Daytona Bch-Melbrn,32904,41859,1067,1018,1124,3209,0.076662128
Kansas City,64490,2061,58,53,47,158,0.076661815
Green Bay-Appleton,54166,17036,466,415,425,1306,0.076661188
Chicago,60041,9966,264,243,257,764,0.076660646
Detroit,48302,17219,553,450,317,1320,0.076659504
"Portland, OR",98642,29743,974,709,597,2280,0.076656692
Hartford & New Haven,6517,15863,409,395,412,1216,0.07665637
Johnstown-Altoona-St Colge,17060,1148,27,36,25,88,0.076655052
Charleston-Huntington,25540,287,8,7,7,22,0.076655052
Wheeling-Steubenville,43906,8297,195,212,229,636,0.076654212
Eugene,97498,2283,100,50,25,175,0.076653526
Ft. Wayne,45827,2557,86,58,52,196,0.076652327
Portland-Auburn,4363,2531,69,64,61,194,0.076649546
Harrisburg-Lncstr-Leb-York,17050,46107,1343,1128,1063,3534,0.076647798
Harrisburg-Lncstr-Leb-York,17062,3901,108,105,86,299,0.076647014
Johnstown-Altoona-St Colge,15845,3053,84,71,79,234,0.076645922
Hartford & New Haven,6370,7163,192,185,172,549,0.076643864
Chicago,60548,11560,271,302,313,886,0.076643599
St. Louis,62036,274,8,7,6,21,0.076642336
Buffalo,16729,809,28,18,16,62,0.076637824
Syracuse,13158,1344,34,33,36,103,0.076636905
Utica,13309,5911,162,155,136,453,0.076636779
San Francisco-Oak-San Jose,94564,18608,435,482,509,1426,0.076633706
Boston (Manchester),2025,8495,300,224,127,651,0.076633314
Monroe-El Dorado,71371,2388,71,58,54,183,0.076633166
Huntsville-Decatur (Flor),35741,3667,101,87,93,281,0.076629397
Boston (Manchester),3070,6277,202,162,117,481,0.076628963
Wilkes Barre-Scranton-Hztn,18828,261,7,7,6,20,0.076628352
Pittsburgh,15401,32092,769,824,866,2459,0.076623458
"Washington, DC (Hagrstwn)",16689,509,12,16,11,39,0.076620825
Parkersburg,45714,9854,261,241,253,755,0.076618632
Detroit,48170,40552,1025,1052,1030,3107,0.076617676
Johnstown-Altoona-St Colge,16693,3772,107,86,96,289,0.076617179
New York,7039,31612,1052,825,545,2422,0.076616475
Roanoke-Lynchburg,24588,9189,238,234,232,704,0.076613342
Charleston-Huntington,25259,744,24,16,17,57,0.076612903
Chicago,60020,9346,239,252,225,716,0.076610315
Sacramnto-Stkton-Modesto,95957,731,24,19,13,56,0.076607387
Memphis,38643,1945,50,50,49,149,0.076606684
Butte-Bozeman,59752,5091,163,120,107,390,0.076605775
Kansas City,64722,483,12,13,12,37,0.076604555
New York,7481,16657,545,444,287,1276,0.076604431
Flint-Saginaw-Bay City,48877,2167,71,54,41,166,0.076603599
San Francisco-Oak-San Jose,94022,20430,705,528,332,1565,0.076603035
Joplin-Pittsburg,74343,3120,96,67,76,239,0.076602564
Baltimore,20794,17271,345,392,586,1323,0.076602397
Wheeling-Steubenville,43953,11514,279,301,302,882,0.076602397
San Francisco-Oak-San Jose,94507,15313,538,398,237,1173,0.07660158
Wichita-Hutchinson Plus,67546,2389,74,61,48,183,0.076601088
Little Rock-Pine Bluff,72104,23368,629,586,575,1790,0.076600479
Kansas City,64489,1906,44,47,55,146,0.07660021
Waco-Temple-Bryan,76524,2859,86,71,62,219,0.07660021
Dothan,36340,4974,141,134,106,381,0.076598311
Beaumont-Port Arthur,75956,7076,201,173,168,542,0.076596947
"Washington, DC (Hagrstwn)",20180,8721,307,218,143,668,0.076596721
New York,8820,40720,1299,1037,783,3119,0.076596267
Charleston-Huntington,45775,1410,43,37,28,108,0.076595745
St. Louis,62011,235,8,5,5,18,0.076595745
Kansas City,64040,6567,183,161,159,503,0.076595097
Johnstown-Altoona-St Colge,16870,7246,238,184,133,555,0.076593983
Birmingham (Ann and Tusc),35622,7233,198,178,178,554,0.076593391
Dothan,36323,8160,210,210,205,625,0.076593137
Baltimore,21042,45070,1549,1176,727,3452,0.076591968
Binghamton,13777,457,14,11,10,35,0.076586433
Elmira (Corning),14838,1828,53,46,41,140,0.076586433
Minneapolis-St. Paul,54003,914,26,24,20,70,0.076586433
"Columbus, OH",45761,1593,44,39,39,122,0.07658506
San Francisco-Oak-San Jose,95467,5902,190,145,117,452,0.076584209
Baltimore,21904,6346,173,164,149,486,0.076583675
Philadelphia,19446,58903,1461,1460,1590,4511,0.076583536
"Albany, GA",31744,2716,75,66,67,208,0.076583211
Nashville,37014,2716,96,69,43,208,0.076583211
Knoxville,37753,901,21,23,25,69,0.076581576
Wichita-Hutchinson Plus,67045,3134,99,74,67,240,0.076579451
"Washington, DC (Hagrstwn)",20838,444,11,12,11,34,0.076576577
San Francisco-Oak-San Jose,94803,25713,609,642,718,1969,0.076576051
Buffalo,14437,8854,255,236,187,678,0.076575559
Wilmington,28435,2429,67,61,58,186,0.076574722
Roanoke-Lynchburg,24090,4636,127,122,106,355,0.076574633
Little Rock-Pine Bluff,72027,1319,41,31,29,101,0.076573161
Philadelphia,8251,10957,286,248,305,839,0.076572054
Ft. Smith-Fay-Sprngdl-Rgrs,72732,5250,154,139,109,402,0.076571429
Hartford & New Haven,6067,20765,488,490,612,1590,0.076571153
Omaha,51601,5668,164,120,150,434,0.076570219
Charleston-Huntington,41262,1306,43,40,17,100,0.076569678
Gainesville,32693,13596,408,321,312,1041,0.076566637
Lincoln & Hastings-Krny,68460,862,29,15,22,66,0.076566125
Paducah-Cape Girard-Harsbg,62966,13557,370,330,338,1038,0.076565612
Wheeling-Steubenville,43917,3631,99,86,93,278,0.07656293
Memphis,38871,1920,58,52,37,147,0.0765625
Oklahoma City,73028,3174,78,91,74,243,0.076559546
Tulsa,74061,2103,68,52,41,161,0.076557299
Houston,77441,30461,1128,686,518,2332,0.076556909
Los Angeles,90403,24544,356,535,988,1879,0.076556389
"Washington, DC (Hagrstwn)",20714,3775,103,95,91,289,0.076556291
Bluefield-Beckley-Oak Hill,24873,1045,32,24,24,80,0.076555024
Cleveland-Akron (Canton),44643,3344,88,83,85,256,0.076555024
Springfield-Holyoke,1344,1659,38,51,38,127,0.07655214
Dallas-Ft. Worth,75752,7015,184,175,178,537,0.076550249
Greensboro-H.Point-W.Salem,27043,6375,188,163,137,488,0.07654902
Columbia-Jefferson City,65284,2443,79,58,50,187,0.076545231
Wheeling-Steubenville,26036,405,11,11,9,31,0.07654321
"Springfield, MO",65725,2417,78,60,47,185,0.076541167
Quincy-Hannibal-Keokuk,62343,601,19,16,11,46,0.076539101
Anchorage,99567,8767,275,204,192,671,0.076537014
Raleigh-Durham (Fayetvlle),28327,20487,648,492,428,1568,0.07653634
Harrisburg-Lncstr-Leb-York,17065,4155,103,105,110,318,0.076534296
Birmingham (Ann and Tusc),35593,1777,50,43,43,136,0.076533483
Ft. Smith-Fay-Sprngdl-Rgrs,74949,196,5,6,4,15,0.076530612
Sacramnto-Stkton-Modesto,95659,980,23,30,22,75,0.076530612
Wheeling-Steubenville,26034,4273,131,105,91,327,0.07652703
Lexington,40447,7370,198,195,171,564,0.076526459
Jacksonville,32266,6978,130,185,219,534,0.076526225
Peoria-Bloomington,61327,1163,29,37,23,89,0.076526225
Wheeling-Steubenville,43907,5227,139,136,125,400,0.076525732
"Tri-Cities, TN-VA",24236,3097,98,64,75,237,0.07652567
Sherman-Ada,73449,3280,93,79,79,251,0.07652439
Toledo,43511,771,25,20,14,59,0.076523995
Pittsburgh,15314,3463,89,77,99,265,0.076523246
Hartford & New Haven,6442,2692,82,75,49,206,0.076523031
"Jackson, TN",38310,6116,183,144,141,468,0.076520602
Detroit,48726,6103,166,159,142,467,0.076519744
Seattle-Tacoma,98010,8194,231,214,182,627,0.076519404
"Columbus, OH",43143,6077,198,125,142,465,0.076518019
Peoria-Bloomington,61369,1516,40,38,38,116,0.07651715
Columbia-Jefferson City,65274,1516,51,38,27,116,0.07651715
Atlanta,30290,9279,275,226,209,710,0.076516866
Philadelphia,18947,6378,190,163,135,488,0.076513013
Montgomery-Selma,36752,1686,43,45,41,129,0.076512456
Cleveland-Akron (Canton),44254,4836,132,115,123,370,0.076509512
Des Moines-Ames,50072,2967,97,76,54,227,0.076508257
Tallahassee-Thomasville,32347,7934,233,187,187,607,0.076506176
Boston (Manchester),2738,5346,177,134,98,409,0.076505799
Pittsburgh,15059,3869,105,89,102,296,0.076505557
Kansas City,64734,2026,56,54,45,155,0.076505429
Raleigh-Durham (Fayetvlle),27891,4418,109,115,114,338,0.076505206
Chattanooga,37347,8261,218,212,202,632,0.076504055
Hartford & New Haven,6231,3843,106,105,83,294,0.076502732
Harrisburg-Lncstr-Leb-York,17265,366,11,8,9,28,0.076502732
Wheeling-Steubenville,45789,183,5,4,5,14,0.076502732
Columbia-Jefferson City,65075,915,28,20,22,70,0.076502732
"Charleston, SC",29471,1451,37,37,37,111,0.076498966
Hartford & New Haven,6716,15896,443,366,407,1216,0.076497232
"Portland, OR",97371,902,28,22,19,69,0.076496674
Phoenix (Prescott),85173,2523,67,57,69,193,0.076496235
"Washington, DC (Hagrstwn)",21777,1791,57,46,34,137,0.076493579
Charlotte,28689,1778,51,47,38,136,0.076490439
Boston (Manchester),2054,9008,228,233,228,689,0.076487567
Paducah-Cape Girard-Harsbg,63821,706,18,16,20,54,0.076487252
Louisville,40031,26869,844,673,538,2055,0.076482191
Tampa-St. Pete (Sarasota),34221,59112,1730,1413,1378,4521,0.076481933
Sioux Falls(Mitchell),57002,1569,54,28,38,120,0.076481836
Cleveland-Akron (Canton),44048,2262,59,59,55,173,0.07648099
Binghamton,13460,4171,113,104,102,319,0.07648046
San Francisco-Oak-San Jose,94030,23980,668,610,556,1834,0.0764804
Johnstown-Altoona-St Colge,16656,1216,36,29,28,93,0.076480263
Rochestr-Mason City-Austin,55936,1909,73,43,30,146,0.076479832
Paducah-Cape Girard-Harsbg,63735,693,21,18,14,53,0.076479076
Sherman-Ada,74562,863,28,23,15,66,0.076477404
Salt Lake City,89835,2236,70,46,55,171,0.07647585
Syracuse,13219,15822,429,384,397,1210,0.076475793
Louisville,47177,1373,39,33,33,105,0.076474873
Wausau-Rhinelander,54451,11494,374,277,228,879,0.076474682
Burlington-Plattsburgh,3774,1883,46,50,48,144,0.076473712
Seattle-Tacoma,98038,38131,1402,887,627,2916,0.076473211
Minneapolis-St. Paul,55422,29305,684,717,840,2241,0.076471592
Cincinnati,45657,2720,87,67,54,208,0.076470588
Cedar Rapids-Wtrlo-IWC&Dub,52586,510,17,12,10,39,0.076470588
Minneapolis-St. Paul,54734,680,21,16,15,52,0.076470588
Rochestr-Mason City-Austin,55961,340,9,7,10,26,0.076470588
Peoria-Bloomington,62655,510,15,13,11,39,0.076470588
Paducah-Cape Girard-Harsbg,62940,340,10,9,7,26,0.076470588
Kansas City,64036,340,7,11,8,26,0.076470588
Kansas City,64477,3400,103,75,82,260,0.076470588
Amarillo,79019,1687,47,37,45,129,0.076467101
Bangor,4619,3034,82,78,72,232,0.076466711
Madison,53508,5885,175,149,126,450,0.07646559
Quincy-Hannibal-Keokuk,62341,3348,95,89,72,256,0.07646356
Greensboro-H.Point-W.Salem,27370,15393,436,397,344,1177,0.076463327
Great Falls,59230,4499,130,110,104,344,0.076461436
Seattle-Tacoma,98295,3322,94,72,88,254,0.076459964
Philadelphia,19116,35522,807,891,1018,2716,0.076459659
Indianapolis,46110,497,16,12,10,38,0.076458753
Topeka,66404,497,18,11,9,38,0.076458753
Baltimore,21903,6252,173,163,142,478,0.076455534
Milwaukee,53050,6893,192,159,176,527,0.076454374
"Alexandria, LA",71472,327,10,8,7,25,0.076452599
Flint-Saginaw-Bay City,49305,2276,69,54,51,174,0.076449912
St. Louis,62033,4670,125,112,120,357,0.076445396
Hartford & New Haven,6469,3218,79,77,90,246,0.076444997
New York,6468,18484,577,452,384,1413,0.076444493
Philadelphia,8223,4173,110,110,99,319,0.076443805
Minneapolis-St. Paul,56087,3048,86,70,77,233,0.07644357
"Columbus, OH",43112,5285,162,136,106,404,0.076442763
Boston (Manchester),2062,32182,706,782,972,2460,0.076440246
Chicago,60026,13501,401,374,257,1032,0.076438782
Chicago,60194,20317,533,498,522,1553,0.076438451
Minneapolis-St. Paul,55331,20946,735,531,335,1601,0.076434641
Elmira (Corning),16920,1884,53,47,44,144,0.076433121
Joplin-Pittsburg,66734,314,9,7,8,24,0.076433121
Lincoln & Hastings-Krny,69023,471,16,10,10,36,0.076433121
Greenville-N.Bern-Washngtn,28562,40062,1039,992,1031,3062,0.076431531
Harrisburg-Lncstr-Leb-York,17349,8858,295,198,184,677,0.076428088
Greensboro-H.Point-W.Salem,27046,1858,54,48,40,142,0.076426265
"Tri-Cities, TN-VA",37650,12051,285,318,318,921,0.076425193
"Washington, DC (Hagrstwn)",20187,19758,650,498,362,1510,0.076424739
Philadelphia,19506,7825,221,204,173,598,0.076421725
Omaha,68463,1531,44,36,37,117,0.07642064
Davenport-R.Island-Moline,61074,3952,105,96,101,302,0.076417004
Oklahoma City,74652,759,24,21,13,58,0.076416337
Dayton,45434,12864,426,325,232,983,0.076414801
Tulsa,74035,4227,123,114,86,323,0.076413532
Pittsburgh,16025,5130,149,123,120,392,0.076413255
Bangor,4649,1204,27,33,32,92,0.07641196
Joplin-Pittsburg,64741,301,12,6,5,23,0.07641196
Colorado Springs-Pueblo,81029,301,10,6,7,23,0.07641196
Detroit,48095,5680,180,145,109,434,0.076408451
Huntsville-Decatur (Flor),35760,5209,134,126,138,398,0.07640622
Birmingham (Ann and Tusc),36793,445,12,11,11,34,0.076404494
Detroit,48041,4149,113,102,102,317,0.076403953
Wilkes Barre-Scranton-Hztn,18630,2814,80,64,71,215,0.076403696
Sioux Falls(Mitchell),57445,1924,57,51,39,147,0.076403326
Chicago,46373,19358,596,478,405,1479,0.076402521
Phoenix (Prescott),85087,10432,351,261,185,797,0.07639954
Louisville,42753,733,23,19,14,56,0.076398363
Green Bay-Appleton,54904,23836,612,652,557,1821,0.076397046
Cleveland-Akron (Canton),44634,2042,53,56,47,156,0.07639569
Sherman-Ada,73432,1165,27,31,31,89,0.07639485
"Rochester, NY",14519,12069,365,278,279,922,0.076394067
Harrisburg-Lncstr-Leb-York,17516,4621,135,104,114,353,0.076390392
Little Rock-Pine Bluff,72134,288,8,7,7,22,0.076388889
Charleston-Huntington,25312,8339,243,213,181,637,0.076388056
Denver,80832,851,26,23,16,65,0.076380729
Green Bay-Appleton,54963,7358,235,181,146,562,0.076379451
Lexington,42629,5093,139,134,116,389,0.076379344
"Portland, OR",97018,1977,63,45,43,151,0.076378351
Pittsburgh,16049,3810,93,102,96,291,0.076377953
Lexington,41817,563,13,16,14,43,0.076376554
Toledo,45867,1126,32,22,32,86,0.076376554
Dallas-Ft. Worth,76272,5892,184,148,118,450,0.076374745
Twin Falls,83313,4177,144,104,71,319,0.076370601
Lansing,49073,4858,139,112,120,371,0.076368876
Louisville,47119,12610,403,314,246,963,0.076367962
Houston,77320,38996,920,1176,882,2978,0.076366807
Champaign&Sprngfld-Decatur,62473,1244,41,26,28,95,0.076366559
Greensboro-H.Point-W.Salem,27012,31441,991,743,667,2401,0.076365256
Des Moines-Ames,50214,825,31,20,12,63,0.076363636
Peoria-Bloomington,61431,275,9,6,6,21,0.076363636
Lincoln & Hastings-Krny,69029,275,9,6,6,21,0.076363636
Sacramnto-Stkton-Modesto,95662,32282,842,857,766,2465,0.076358342
Memphis,38339,681,22,16,14,52,0.076358297
Traverse City-Cadillac,49677,6941,196,173,161,530,0.076357874
Terre Haute,47854,812,27,19,16,62,0.07635468
Portland-Auburn,4330,26980,646,699,715,2060,0.076352854
San Francisco-Oak-San Jose,94526,32612,1105,867,518,2490,0.076352263
New York,12577,1886,55,42,47,144,0.076352068
New York,11772,44532,1023,1089,1288,3400,0.076349591
Minneapolis-St. Paul,55092,11133,336,272,242,850,0.076349591
Albany-Schenectady-Troy,1237,2279,67,56,51,174,0.076349276
Baltimore,21037,21559,639,527,480,1646,0.076348625
St. Louis,62640,3209,92,81,72,245,0.076347772
Lincoln & Hastings-Krny,68430,2266,88,51,34,173,0.076345984
Oklahoma City,73150,5331,154,153,100,407,0.076345901
New York,8826,5580,157,129,140,426,0.076344086
Eugene,97426,10885,295,268,268,831,0.076343592
Ft. Smith-Fay-Sprngdl-Rgrs,72738,2646,76,58,68,202,0.076341648
Raleigh-Durham (Fayetvlle),24529,1585,42,39,40,121,0.076340694
Boston (Manchester),3051,25898,672,659,646,1977,0.076337941
Bismarck-Mnt-Dcknsn(Wlstn),58353,131,4,3,3,10,0.076335878
Lincoln & Hastings-Krny,68452,131,5,3,2,10,0.076335878
Sherman-Ada,74760,393,10,10,10,30,0.076335878
Hartford & New Haven,6093,3118,96,74,68,238,0.076330981
"Rochester, NY",14432,5712,155,142,139,436,0.076330532
Sioux City,51245,1297,34,37,28,99,0.076329992
Orlando-Daytona Bch-Melbrn,34484,7062,226,178,135,539,0.076323988
South Bend-Elkhart,46366,5896,155,152,143,450,0.076322931
Harrisburg-Lncstr-Leb-York,17006,1153,31,31,26,88,0.076322637
Peoria-Bloomington,61536,2817,74,75,66,215,0.076322329
Nashville,37181,1533,43,40,34,117,0.076320939
St. Louis,62674,1402,30,44,33,107,0.076319544
Cedar Rapids-Wtrlo-IWC&Dub,52318,891,27,22,19,68,0.076318743
"Washington, DC (Hagrstwn)",17264,2280,65,54,55,174,0.076315789
Greenvll-Spart-Ashevll-And,29322,10627,309,250,252,811,0.076315047
Charlotte,29704,3905,108,102,88,298,0.07631242
Columbus-Tupelo-West Point,38862,2267,53,64,56,173,0.076312307
Lansing,49096,3132,92,80,67,239,0.076309068
Greenwood-Greenville,38730,1625,48,41,35,124,0.076307692
New York,10501,1494,42,41,31,114,0.076305221
Charleston-Huntington,25503,747,23,19,15,57,0.076305221
Terre Haute,62475,249,7,7,5,19,0.076305221
Pittsburgh,15767,14167,390,331,360,1081,0.076304087
Duluth-Superior,55736,1612,48,40,35,123,0.07630273
Birmingham (Ann and Tusc),35553,4325,109,113,108,330,0.076300578
Parkersburg,26104,15649,410,365,419,1194,0.076298805
"Rochester, NY",14564,15977,512,398,309,1219,0.076297177
St. Louis,63348,10433,350,226,220,796,0.076296367
Greenville-N.Bern-Washngtn,28555,5400,143,128,141,412,0.076296296
Milwaukee,53066,37879,1224,886,780,2890,0.076295573
Harrisonburg,24483,734,19,20,17,56,0.076294278
Clarksburg-Weston,26571,2202,62,55,51,168,0.076294278
Bismarck-Mnt-Dcknsn(Wlstn),59259,367,9,11,8,28,0.076294278
Harlingen-Wslco-Brnsvl-Mca,78588,367,9,13,6,28,0.076294278
New York,12581,2307,53,65,58,176,0.076289554
Minneapolis-St. Paul,56078,485,18,10,9,37,0.07628866
Sherman-Ada,74557,485,14,13,10,37,0.07628866
New York,8853,5453,155,136,125,416,0.076288282
Youngstown,44440,4483,120,107,115,342,0.0762882
New York,12547,2648,73,63,66,202,0.076283988
Fargo,58005,839,35,21,8,64,0.076281287
Columbia-Jefferson City,65047,957,28,25,20,73,0.076280042
Macon,31046,3461,91,99,74,264,0.076278532
San Francisco-Oak-San Jose,94610,31608,470,726,1215,2411,0.076278157
Columbus-Tupelo-West Point,39108,1665,47,39,41,127,0.076276276
Harrisburg-Lncstr-Leb-York,17202,32461,911,796,769,2476,0.076276147
Knoxville,37369,944,23,24,25,72,0.076271186
Minneapolis-St. Paul,55346,17346,522,405,396,1323,0.076271186
Kansas City,64636,236,6,7,5,18,0.076271186
Oklahoma City,73722,354,10,8,9,27,0.076271186
Pittsburgh,15084,9886,253,230,271,754,0.076269472
Springfield-Holyoke,1351,2465,44,74,70,188,0.076267748
Greenville-N.Bern-Washngtn,28582,2216,71,53,45,169,0.076263538
Topeka,66512,3265,102,80,67,249,0.0762634
Louisville,47126,4537,130,111,105,346,0.076261847
Norfolk-Portsmth-Newpt Nws,27926,1508,38,39,38,115,0.076259947
Wilkes Barre-Scranton-Hztn,18452,4970,120,116,143,379,0.076257545
Cleveland-Akron (Canton),43988,2426,73,62,50,185,0.076257214
Phoenix (Prescott),85250,16235,290,370,578,1238,0.076255005
Sioux Falls(Mitchell),57063,1036,32,23,24,79,0.076254826
Harrisonburg,22850,918,27,21,22,70,0.076252723
Bluefield-Beckley-Oak Hill,25843,1377,45,31,29,105,0.076252723
Lincoln & Hastings-Krny,68464,459,17,11,7,35,0.076252723
Huntsville-Decatur (Flor),35747,6400,178,154,156,488,0.07625
Spokane,99030,1141,40,30,17,87,0.076248904
Kansas City,64451,341,6,7,13,26,0.076246334
Medford-Klamath Falls,96038,682,19,14,19,52,0.076246334
Chicago,60515,29287,831,734,668,2233,0.076245433
Greenvll-Spart-Ashevll-And,29671,19516,481,500,507,1488,0.076245132
Panama City,32428,18126,499,458,425,1382,0.076244069
Lincoln & Hastings-Krny,68949,6545,193,159,147,499,0.076241406
Detroit,48152,30787,762,793,792,2347,0.076233475
Missoula,59831,446,13,13,8,34,0.076233184
Wichita-Hutchinson Plus,67154,1338,42,30,30,102,0.076233184
Ft. Smith-Fay-Sprngdl-Rgrs,72729,223,6,6,5,17,0.076233184
Honolulu,96756,6310,173,155,153,481,0.076228209
Quincy-Hannibal-Keokuk,62324,1325,40,28,33,101,0.076226415
Lincoln & Hastings-Krny,69169,551,22,11,9,42,0.076225045
Detroit,48138,10679,324,289,201,814,0.076224366
Buffalo,14227,22014,432,576,670,1678,0.076224221
Greensboro-H.Point-W.Salem,28670,2637,80,61,60,201,0.076222981
Pittsburgh,15228,17134,508,430,368,1306,0.076222715
New York,11955,3280,62,73,115,250,0.076219512
Knoxville,40845,328,9,9,7,25,0.076219512
Omaha,51537,6442,207,151,133,491,0.076218566
Greensboro-H.Point-W.Salem,24055,11730,326,303,265,894,0.076214834
Birmingham (Ann and Tusc),36279,2388,69,54,59,182,0.076214405
Peoria-Bloomington,61726,2388,64,61,57,182,0.076214405
Harrisburg-Lncstr-Leb-York,17241,11927,327,289,293,909,0.076213633
Nashville,37149,2808,84,69,61,214,0.076210826
Paducah-Cape Girard-Harsbg,42069,1076,30,24,28,82,0.076208178
Columbia-Jefferson City,65325,3333,93,86,75,254,0.076207621
Kansas City,64788,1286,40,32,26,98,0.076205288
Greenvll-Spart-Ashevll-And,28712,19146,543,517,399,1459,0.076203907
Bluefield-Beckley-Oak Hill,25958,748,23,15,19,57,0.076203209
Evansville,62821,6929,190,160,178,528,0.076201472
Harrisburg-Lncstr-Leb-York,17841,4462,134,112,94,340,0.076199014
New York,8050,26654,682,674,675,2031,0.076198694
Minneapolis-St. Paul,56636,4869,150,111,110,371,0.076196344
Watertown,13626,1903,60,41,44,145,0.076195481
Philadelphia,18014,11523,313,310,255,878,0.076195435
Salt Lake City,83128,2323,64,59,54,177,0.076194576
Orlando-Daytona Bch-Melbrn,33597,8531,257,195,198,650,0.076192709
Roanoke-Lynchburg,24464,105,2,3,3,8,0.076190476
Atlanta,36255,945,26,19,27,72,0.076190476
Nashville,38581,4515,125,115,104,344,0.076190476
"Columbus, OH",43150,2100,64,56,40,160,0.076190476
Sioux City,51053,1050,36,24,20,80,0.076190476
Ottumwa-Kirksville,52557,420,8,10,14,32,0.076190476
"Alexandria, LA",71466,420,13,10,9,32,0.076190476
Little Rock-Pine Bluff,71952,105,3,3,2,8,0.076190476
Peoria-Bloomington,61548,12456,399,327,223,949,0.076188182
Toledo,43569,2599,74,69,55,198,0.076183147
Augusta-Aiken,29129,2901,88,59,74,221,0.076180627
Burlington-Plattsburgh,5847,932,29,17,25,71,0.076180258
Pittsburgh,26537,5487,143,145,130,418,0.076180062
Dallas-Ft. Worth,75109,5369,174,125,110,409,0.076178059
Topeka,66401,2061,65,44,48,157,0.076176613
Quincy-Hannibal-Keokuk,63468,2363,72,48,60,180,0.076174355
Quincy-Hannibal-Keokuk,52627,12406,323,334,288,945,0.07617282
"Charleston, SC",29475,2665,73,68,62,203,0.076172608
New York,12477,19430,492,472,516,1480,0.07617087
Madison,53570,2757,88,61,61,210,0.07616975
Ft. Smith-Fay-Sprngdl-Rgrs,72855,5816,158,147,138,443,0.076169188
Detroit,48324,16306,449,413,380,1242,0.076168282
Cincinnati,47060,7234,218,183,150,551,0.076168095
Rochestr-Mason City-Austin,55982,407,17,9,5,31,0.076167076
Fargo,58441,407,16,7,8,31,0.076167076
Burlington-Plattsburgh,5450,5488,161,129,128,418,0.076166181
Atlanta,30731,2337,66,59,53,178,0.076166025
Providence-New Bedford,2852,24171,660,610,571,1841,0.076165653
Grand Rapids-Kalmzoo-B.Crk,49032,3046,81,74,77,232,0.076165463
Detroit,48085,26180,833,648,513,1994,0.076165011
Columbia-Jefferson City,65024,1116,33,24,28,85,0.076164875
Minneapolis-St. Paul,54082,1825,56,48,35,139,0.076164384
Burlington-Plattsburgh,5448,1418,41,33,34,108,0.076163611
Odessa-Midland,79852,709,15,21,18,54,0.076163611
Cheyenne-Scottsbluff,82009,36514,1064,923,794,2781,0.076162568
"Tri-Cities, TN-VA",24256,3033,75,75,81,231,0.076162216
Fargo,56540,1917,59,52,35,146,0.076160668
Austin,78738,34455,1220,828,576,2624,0.076157307
Tyler-Longview(Lfkn&Ncgd),75785,11043,337,257,247,841,0.076156841
Grand Rapids-Kalmzoo-B.Crk,48834,2508,74,57,60,191,0.0761563
Youngstown,44443,1904,47,49,49,145,0.076155462
St. Louis,62293,4701,133,107,118,358,0.07615401
Charleston-Huntington,41548,696,19,22,12,53,0.076149425
Harrisburg-Lncstr-Leb-York,17084,4373,106,105,122,333,0.076149097
Monterey-Salinas,95004,4163,91,99,127,317,0.076147009
"Tri-Cities, TN-VA",24370,5647,145,154,131,430,0.076146627
Buffalo,14224,39806,917,1018,1096,3031,0.0761443
Denver,80424,10953,209,265,360,834,0.076143522
Little Rock-Pine Bluff,72128,788,25,19,16,60,0.076142132
Amarillo,73932,1576,49,40,31,120,0.076142132
Chicago,60016,60272,1350,1494,1745,4589,0.076138174
Louisville,42733,1563,41,46,32,119,0.076135637
Minneapolis-St. Paul,55322,3612,117,84,74,275,0.076135105
Omaha,68044,683,24,13,15,52,0.0761347
Pittsburgh,15133,6108,154,151,160,465,0.076129666
Sioux Falls(Mitchell),56151,775,28,17,14,59,0.076129032
Wilkes Barre-Scranton-Hztn,18610,4545,136,109,101,346,0.076127613
Wausau-Rhinelander,54469,1642,53,37,35,125,0.076126675
Davenport-R.Island-Moline,61478,289,8,8,6,22,0.076124567
Pittsburgh,16117,16368,433,409,404,1246,0.076124145
Davenport-R.Island-Moline,52640,1248,35,35,25,95,0.076121795
Fargo,56567,3547,112,80,78,270,0.076120665
Utica,13413,14911,429,356,350,1135,0.076118302
Des Moines-Ames,52544,7357,178,193,189,560,0.076117983
Buffalo,14141,7344,177,198,184,559,0.076116558
Greenvll-Spart-Ashevll-And,29370,1143,34,27,26,87,0.076115486
Des Moines-Ames,50258,762,24,20,14,58,0.076115486
Ottumwa-Kirksville,52594,381,12,8,9,29,0.076115486
Sioux Falls(Mitchell),57365,381,15,8,6,29,0.076115486
Davenport-R.Island-Moline,61361,1143,30,29,28,87,0.076115486
Flint-Saginaw-Bay City,48614,1235,34,31,29,94,0.07611336
Madison,53572,10826,377,250,197,824,0.076113061
Burlington-Plattsburgh,5055,3508,109,91,67,267,0.076111745
St. Louis,63131,17606,620,444,276,1340,0.076110417
Pittsburgh,15333,1892,52,49,43,144,0.076109937
Shreveport,71222,2930,76,81,66,223,0.076109215
La Crosse-Eau Claire,54727,5387,169,125,116,410,0.076109152
Los Angeles,90502,18605,387,483,546,1416,0.076108573
Greenvll-Spart-Ashevll-And,28701,4533,118,106,121,345,0.076108537
Detroit,48039,7739,190,197,202,589,0.076108024
Pittsburgh,15234,13678,291,315,435,1041,0.076107618
Tampa-St. Pete (Sarasota),33850,10170,262,240,272,774,0.076106195
Cleveland-Akron (Canton),44217,3955,117,94,90,301,0.076106195
Little Rock-Pine Bluff,72040,2825,55,80,80,215,0.076106195
Sioux City,68781,1222,45,29,19,93,0.076104746
La Crosse-Eau Claire,54623,1879,59,36,48,143,0.076104311
Greensboro-H.Point-W.Salem,27040,13837,433,352,268,1053,0.076100311
Boston (Manchester),2459,19251,601,530,334,1465,0.076099943
"Tri-Cities, TN-VA",24225,1682,46,40,42,128,0.076099881
Lubbock,79241,1866,59,42,41,142,0.076098607
Minneapolis-St. Paul,55436,14179,404,408,267,1079,0.076098455
Los Angeles,90274,24403,796,673,388,1857,0.076097201
Phoenix (Prescott),85284,18976,528,467,449,1444,0.076096121
Syracuse,13108,5480,144,137,136,417,0.076094891
Greenville-N.Bern-Washngtn,27865,2221,54,60,55,169,0.076091851
Seattle-Tacoma,98816,7215,197,192,160,549,0.076091476
Binghamton,13811,4048,116,110,82,308,0.076086957
Charleston-Huntington,25111,552,17,14,11,42,0.076086957
Nashville,38560,1564,44,38,37,119,0.076086957
South Bend-Elkhart,46572,92,3,2,2,7,0.076086957
Cedar Rapids-Wtrlo-IWC&Dub,52044,92,3,3,1,7,0.076086957
Ottumwa-Kirksville,52588,184,4,5,5,14,0.076086957
Sioux Falls(Mitchell),56122,552,21,11,10,42,0.076086957
Wichita-Hutchinson Plus,67657,276,8,9,4,21,0.076086957
North Platte,69132,92,4,2,1,7,0.076086957
Paducah-Cape Girard-Harsbg,42041,4127,117,103,94,314,0.076084323
Richmond-Petersburg,23192,6585,182,151,168,501,0.076082005
Cedar Rapids-Wtrlo-IWC&Dub,52216,1538,44,37,36,117,0.076072822
Bangor,4461,3063,69,67,97,233,0.076069213
Flint-Saginaw-Bay City,48806,1801,59,40,38,137,0.076068851
Johnstown-Altoona-St Colge,15542,1078,29,27,26,82,0.07606679
Johnstown-Altoona-St Colge,15848,986,30,26,19,75,0.076064909
Bismarck-Mnt-Dcknsn(Wlstn),58835,986,28,21,26,75,0.076064909
Wilkes Barre-Scranton-Hztn,18210,8138,233,203,183,619,0.076062915
Bowling Green,42123,894,25,20,23,68,0.07606264
Mankato,56060,447,11,9,14,34,0.07606264
Charleston-Huntington,41129,9295,247,225,235,707,0.076062399
St. Louis,63089,5798,167,139,135,441,0.076060711
Pittsburgh,16051,2853,81,69,67,217,0.076060287
Buffalo,16745,355,12,8,7,27,0.076056338
Charleston-Huntington,41568,710,23,19,12,54,0.076056338
Sioux City,50528,355,10,8,9,27,0.076056338
New York,11563,23680,621,612,568,1801,0.076055743
Cincinnati,45167,3366,97,90,69,256,0.076054664
Grand Rapids-Kalmzoo-B.Crk,49347,1328,37,34,30,101,0.076054217
Denver,80611,881,24,22,21,67,0.076049943
Birmingham (Ann and Tusc),35580,3958,111,95,95,301,0.076048509
Abilene-Sweetwater,79562,5628,202,131,95,428,0.07604833
Greenvll-Spart-Ashevll-And,29667,263,6,7,7,20,0.076045627
Chicago,46321,23657,723,597,479,1799,0.076045145
"Lafayette, LA",70339,4984,137,121,121,379,0.076043339
"Columbus, OH",43341,960,24,25,24,73,0.076041667
New York,8736,12638,341,325,295,961,0.076040513
Terre Haute,62868,1815,44,41,53,138,0.076033058
Monterey-Salinas,93920,1210,29,27,36,92,0.076033058
Greensboro-H.Point-W.Salem,24165,1552,43,35,40,118,0.076030928
Mobile-Pensacola (Ft Walt),32577,5511,165,138,116,419,0.076029759
Monroe-El Dorado,71749,1894,57,46,41,144,0.076029567
Greenville-N.Bern-Washngtn,27925,3183,95,75,72,242,0.076028904
Jacksonville,32148,11680,338,291,259,888,0.076027397
La Crosse-Eau Claire,54644,1631,54,40,30,124,0.076026977
Phoenix (Prescott),86334,5235,141,140,117,398,0.076026743
Miami-Ft. Lauderdale,33304,21269,262,572,783,1617,0.076026141
Kansas City,66207,14824,417,360,350,1127,0.076025364
Minneapolis-St. Paul,55328,10615,367,257,183,807,0.076024494
Greenville-N.Bern-Washngtn,27824,1026,34,27,17,78,0.076023392
"Tri-Cities, TN-VA",40808,171,5,5,3,13,0.076023392
Des Moines-Ames,50154,513,15,13,11,39,0.076023392
Wichita-Hutchinson Plus,67863,171,5,3,5,13,0.076023392
Houston,77873,1710,53,42,35,130,0.076023392
Harrisburg-Lncstr-Leb-York,17314,6064,160,133,168,461,0.076022427
Shreveport,71023,3065,93,75,65,233,0.076019576
New York,11718,2894,78,81,61,220,0.07601935
Columbia-Jefferson City,65053,1447,39,36,35,110,0.07601935
"Columbus, GA (Opelika, AL)",39854,2210,64,56,48,168,0.0760181
St. Louis,63049,16536,478,387,392,1257,0.076015965
Sioux City,51232,763,27,18,13,58,0.076015727
Sioux City,57038,1947,60,46,42,148,0.076014381
Wilkes Barre-Scranton-Hztn,18235,19378,532,493,448,1473,0.076014037
Louisville,40077,592,19,14,12,45,0.076013514
Charlotte,28164,15892,433,401,374,1208,0.076013088
Atlanta,30293,2526,68,62,62,192,0.076009501
Panama City,32320,3789,114,91,83,288,0.076009501
Chicago,60550,1263,36,30,30,96,0.076009501
St. Louis,62006,842,26,21,17,64,0.076009501
Greensboro-H.Point-W.Salem,27357,9828,278,248,221,747,0.076007326
Green Bay-Appleton,54983,4447,130,103,105,338,0.076006296
Milwaukee,53551,8802,265,231,173,669,0.076005453
Philadelphia,19330,5697,163,151,119,433,0.076004915
Watertown,13669,14644,419,355,339,1113,0.076003824
Topeka,66535,3263,121,74,53,248,0.076003678
Pittsburgh,26405,1171,38,31,20,89,0.076003416
Indianapolis,47471,2592,72,51,74,197,0.076003086
Burlington-Plattsburgh,5651,1421,44,38,26,108,0.076002815
Pittsburgh,15019,1671,41,42,44,127,0.076002394
New York,12589,16947,413,423,452,1288,0.076001652
Boston (Manchester),3442,1500,42,31,41,114,0.076
Bismarck-Mnt-Dcknsn(Wlstn),59226,500,15,11,12,38,0.076
Shreveport,71034,250,7,5,7,19,0.076
Raleigh-Durham (Fayetvlle),28305,5316,116,137,151,404,0.07599699
Wichita-Hutchinson Plus,67448,1329,39,32,30,101,0.07599699
Boise,83655,5224,170,119,108,397,0.075995406
Cleveland-Akron (Canton),44216,9356,254,249,208,711,0.075994015
Chattanooga,37356,2566,73,61,61,195,0.075993765
Little Rock-Pine Bluff,72102,2566,81,55,59,195,0.075993765
Boston (Manchester),1913,17436,434,445,446,1325,0.0759922
Rochestr-Mason City-Austin,50659,5264,152,120,128,400,0.075987842
Davenport-R.Island-Moline,61320,658,21,15,14,50,0.075987842
"Springfield, MO",65702,329,15,2,8,25,0.075987842
Charlotte,28690,8712,222,211,229,662,0.075987144
Wilmington,28409,35757,1079,921,717,2717,0.075985122
Amarillo,79052,1066,33,26,22,81,0.075984991
La Crosse-Eau Claire,54731,737,23,18,15,56,0.075983718
Flint-Saginaw-Bay City,48735,816,20,23,19,62,0.075980392
Des Moines-Ames,50068,408,11,11,9,31,0.075980392
Kansas City,64098,3001,103,68,57,228,0.075974675
Green Bay-Appleton,54950,3080,96,70,68,234,0.075974026
Quincy-Hannibal-Keokuk,62367,1211,37,32,23,92,0.075970273
San Antonio,78123,2501,75,49,66,190,0.075969612
Johnstown-Altoona-St Colge,15963,10728,290,288,237,815,0.075969426
Marquette,49891,645,20,16,13,49,0.075968992
St. Louis,62054,803,19,21,21,61,0.075965131
Lansing,49201,46653,1283,1160,1101,3544,0.075965104
Nashville,42717,5858,166,149,130,445,0.075964493
New York,10509,19075,529,464,456,1449,0.075963303
Birmingham (Ann and Tusc),35572,961,17,28,28,73,0.075962539
Duluth-Superior,56649,8649,251,202,204,657,0.075962539
Charleston-Huntington,45682,2001,56,53,43,152,0.075962019
Albany-Schenectady-Troy,12151,1040,27,23,29,79,0.075961538
Fargo,56573,7280,206,181,166,553,0.075961538
Pittsburgh,15437,2317,57,54,65,176,0.075960293
Huntsville-Decatur (Flor),35763,23315,754,553,464,1771,0.075959683
Kansas City,64463,1356,41,34,28,103,0.075958702
New York,8731,22079,545,560,572,1677,0.075954527
Pittsburgh,15456,2212,44,67,57,168,0.075949367
Johnstown-Altoona-St Colge,15868,1501,40,36,38,114,0.075949367
Nashville,37079,2686,75,58,71,204,0.075949367
"Jackson, TN",38316,2765,88,58,64,210,0.075949367
Louisville,42743,9006,263,215,206,684,0.075949367
Milwaukee,53018,7347,223,171,164,558,0.075949367
Green Bay-Appleton,54948,316,10,8,6,24,0.075949367
Kansas City,64466,474,19,8,9,36,0.075949367
Lincoln & Hastings-Krny,68380,79,2,2,2,6,0.075949367
Little Rock-Pine Bluff,72130,395,11,11,8,30,0.075949367
Denver,82329,316,14,3,7,24,0.075949367
Reno,96132,158,7,1,4,12,0.075949367
New York,6906,9849,216,249,283,748,0.075946797
Santabarbra-Sanmar-Sanluob,93110,16525,406,412,437,1255,0.075945537
Spokane,99025,5267,155,130,115,400,0.07594456
"Tri-Cities, TN-VA",24283,2041,55,52,48,155,0.075943165
Billings,59079,3687,132,82,66,280,0.075942501
Greenvll-Spart-Ashevll-And,29661,6505,169,167,158,494,0.075941583
Minneapolis-St. Paul,56320,7901,252,190,158,600,0.075939754
Cleveland-Akron (Canton),44730,6018,159,146,152,457,0.07593885
Binghamton,13827,11233,301,266,286,853,0.075936971
Wilmington,28434,1014,27,27,23,77,0.075936884
Topeka,66865,935,33,21,17,71,0.075935829
Milwaukee,53098,11681,312,317,258,887,0.07593528
Richmond-Petersburg,23950,3503,104,88,74,266,0.075934913
Detroit,48329,23245,558,546,661,1765,0.075930308
Miami-Ft. Lauderdale,33155,45042,984,1112,1324,3420,0.075929133
Des Moines-Ames,50246,619,21,13,13,47,0.075928918
Burlington-Plattsburgh,12920,2239,71,53,46,170,0.075926753
Des Moines-Ames,50264,540,16,15,10,41,0.075925926
Los Angeles,92657,9615,292,242,196,730,0.075923037
Rochestr-Mason City-Austin,55953,922,25,28,17,70,0.075921909
Sioux Falls(Mitchell),57580,4452,124,111,103,338,0.075920934
Richmond-Petersburg,22942,9879,272,218,260,750,0.075918615
"Portland, OR",97022,4057,111,84,113,308,0.075918166
Grand Rapids-Kalmzoo-B.Crk,49456,20259,579,503,456,1538,0.075916876
"Washington, DC (Hagrstwn)",20692,764,21,19,18,58,0.07591623
Paducah-Cape Girard-Harsbg,38241,764,20,22,16,58,0.07591623
St. Louis,63015,2292,59,55,60,174,0.07591623
Elmira (Corning),14891,4426,130,104,102,336,0.075915047
Seattle-Tacoma,98586,1673,48,46,33,127,0.075911536
"Portland, OR",97035,26531,726,637,651,2014,0.075911198
"Washington, DC (Hagrstwn)",22039,18166,613,476,290,1379,0.075911043
Lexington,40370,3715,105,94,83,282,0.075908479
New York,7874,8616,214,199,241,654,0.075905292
Philadelphia,18049,18510,455,473,477,1405,0.075904916
Minneapolis-St. Paul,56362,5968,186,132,135,453,0.075904826
Salt Lake City,84738,10500,302,244,251,797,0.075904762
Orlando-Daytona Bch-Melbrn,32780,40406,977,1008,1082,3067,0.075904569
"Columbus, OH",43758,2793,74,62,76,212,0.075904046
Minneapolis-St. Paul,55354,2793,93,62,57,212,0.075904046
Houston,77059,18089,524,451,398,1373,0.075902482
Providence-New Bedford,2871,17707,485,496,363,1344,0.075902186
Los Angeles,93510,7378,179,191,190,560,0.075901328
"Washington, DC (Hagrstwn)",21757,2701,77,62,66,205,0.075897816
La Crosse-Eau Claire,54766,1647,48,45,32,125,0.075895568
Chattanooga,37362,3742,107,87,90,284,0.075895243
Cedar Rapids-Wtrlo-IWC&Dub,50173,672,21,19,11,51,0.075892857
Wichita-Hutchinson Plus,67625,224,7,6,4,17,0.075892857
Shreveport,74957,1265,37,25,34,96,0.075889328
Syracuse,13363,2227,59,47,63,169,0.075886843
"Columbus, OH",43135,4454,121,115,102,338,0.075886843
Little Rock-Pine Bluff,72039,2227,65,56,48,169,0.075886843
Wausau-Rhinelander,54452,18831,503,472,454,1429,0.075885508
Lincoln & Hastings-Krny,68836,1779,53,45,37,135,0.075885329
Peoria-Bloomington,61523,10437,283,275,234,792,0.075883875
Seattle-Tacoma,98831,3993,134,98,71,303,0.075882795
New York,18337,16025,452,407,357,1216,0.075881435
Louisville,42762,369,9,10,9,28,0.075880759
Chico-Redding,95939,369,15,3,10,28,0.075880759
Minneapolis-St. Paul,55360,3387,127,68,62,257,0.075878358
Louisville,47137,1397,43,37,26,106,0.075876879
Seattle-Tacoma,98591,4481,133,99,108,340,0.075875921
Pittsburgh,15732,1542,46,34,37,117,0.075875486
"Washington, DC (Hagrstwn)",20632,514,17,10,12,39,0.075875486
Salisbury,21829,514,14,12,13,39,0.075875486
Little Rock-Pine Bluff,72141,514,17,12,10,39,0.075875486
Elmira (Corning),14870,9753,254,259,227,740,0.07587409
"Columbus, OH",43074,17978,551,441,372,1364,0.075870508
Dayton,45862,1384,30,28,47,105,0.075867052
Providence-New Bedford,2898,1819,45,46,47,138,0.07586586
Charlotte,28163,5510,156,136,126,418,0.075862069
Greenwood-Greenville,38953,580,18,12,14,44,0.075862069
Terre Haute,47837,1160,36,25,27,88,0.075862069
Omaha,51552,290,11,6,5,22,0.075862069
Minneapolis-St. Paul,56274,145,4,4,3,11,0.075862069
Bismarck-Mnt-Dcknsn(Wlstn),59243,435,14,8,11,33,0.075862069
Springfield-Holyoke,1069,10282,237,255,288,780,0.075860727
Detroit,48390,25232,579,644,691,1914,0.075856056
Fargo,58054,3164,98,70,72,240,0.07585335
Seattle-Tacoma,98241,2228,56,55,58,169,0.075852783
Pittsburgh,15209,12063,260,301,354,915,0.075851778
Boston (Manchester),1923,28358,729,726,696,2151,0.075851612
Buffalo,14067,4654,124,119,110,353,0.075848732
Augusta-Aiken,30660,1002,24,28,24,76,0.075848303
Fargo,58036,356,15,9,3,27,0.075842697
Green Bay-Appleton,54942,10957,374,273,184,831,0.075841928
Chico-Redding,96055,4048,131,93,83,307,0.075839921
Charleston-Huntington,25125,778,22,21,16,59,0.075835476
Watertown,13642,9191,231,229,237,697,0.075835056
Davenport-R.Island-Moline,61241,6857,190,161,169,520,0.075834913
"Lafayette, LA",70581,989,27,26,22,75,0.075834176
Boston (Manchester),1430,6567,216,169,113,498,0.075833714
Memphis,38049,4378,135,101,96,332,0.075833714
Kansas City,64429,11789,320,303,271,894,0.075833404
Cedar Rapids-Wtrlo-IWC&Dub,52310,6488,187,158,147,492,0.075832306
Sioux City,50598,844,22,21,21,64,0.075829384
Peoria-Bloomington,61544,633,23,10,15,48,0.075829384
San Antonio,78066,844,26,19,19,64,0.075829384
Chicago,60558,13359,459,351,203,1013,0.075829029
Oklahoma City,73728,1820,65,35,38,138,0.075824176
New York,8750,3429,82,92,86,260,0.075823855
Bangor,4428,3073,76,78,79,233,0.075821673
South Bend-Elkhart,46511,4049,112,107,88,307,0.07582119
Ottumwa-Kirksville,63565,3627,98,87,90,275,0.075820237
Albany-Schenectady-Troy,12159,9338,240,228,240,708,0.075819233
Chicago,60193,39146,1078,932,958,2968,0.07581873
Shreveport,71845,1741,43,43,46,132,0.075818495
Davenport-R.Island-Moline,61252,5289,145,136,120,401,0.075817735
Portland-Auburn,4062,19323,525,434,506,1465,0.075816385
Greenwood-Greenville,38961,1042,33,21,25,79,0.075815739
Raleigh-Durham (Fayetvlle),27278,29322,877,732,614,2223,0.075813382
Ft. Wayne,46952,18572,471,469,468,1408,0.075813052
Nashville,37360,1939,55,44,48,147,0.075812274
Charleston-Huntington,41271,277,11,6,4,21,0.075812274
Sioux Falls(Mitchell),57424,277,10,6,5,21,0.075812274
Detroit,48357,7822,217,196,180,593,0.075811813
Boston (Manchester),2019,17412,460,405,455,1320,0.075809786
"Charleston, SC",29412,40971,858,867,1381,3106,0.075809719
Richmond-Petersburg,23113,28255,884,726,532,2142,0.075809591
Des Moines-Ames,50134,620,16,15,16,47,0.075806452
Miami-Ft. Lauderdale,33012,66790,1519,1791,1753,5063,0.075804761
Syracuse,13036,9551,248,244,232,724,0.075803581
New York,12524,14419,375,355,363,1093,0.07580276
La Crosse-Eau Claire,54420,1372,46,36,22,104,0.075801749
Idaho Fals-Pocatllo(Jcksn),83424,343,10,10,6,26,0.075801749
"Charleston, SC",29470,5211,144,129,122,395,0.07580119
Evansville,47720,17071,455,404,435,1294,0.075801066
Lincoln & Hastings-Krny,69210,2190,66,62,38,166,0.075799087
Johnstown-Altoona-St Colge,15958,2045,56,48,51,155,0.075794621
Quincy-Hannibal-Keokuk,62681,5040,143,116,123,382,0.075793651
Cincinnati,47018,4486,117,109,114,340,0.075791351
Utica,13456,3668,94,87,97,278,0.075790622
"Jackson, MS",39166,475,10,13,13,36,0.075789474
Honolulu,96725,4407,121,104,109,334,0.075788518
Norfolk-Portsmth-Newpt Nws,27916,1016,28,28,21,77,0.075787402
Raleigh-Durham (Fayetvlle),27876,1082,30,23,29,82,0.075785582
New York,6612,7640,254,192,133,579,0.07578534
Greenvll-Spart-Ashevll-And,29672,13578,322,446,261,1029,0.075784357
Boston (Manchester),3076,14726,421,367,328,1116,0.075784327
Little Rock-Pine Bluff,72106,5133,146,122,121,389,0.075784142
Jacksonville,31568,1148,35,27,25,87,0.075783972
Wheeling-Steubenville,26581,607,16,16,14,46,0.075782537
Des Moines-Ames,50075,805,19,19,23,61,0.075776398
Rochestr-Mason City-Austin,55970,871,26,21,19,66,0.075774971
"Washington, DC (Hagrstwn)",22301,14649,260,313,537,1110,0.07577309
Santabarbra-Sanmar-Sanluob,93111,18252,430,478,475,1383,0.075772518
"Portland, OR",98629,10558,330,267,203,800,0.075771927
Richmond-Petersburg,23833,2138,69,47,46,162,0.075771749
Rapid City,57702,34169,977,837,775,2589,0.075770435
Elmira (Corning),16930,1267,44,26,26,96,0.075769534
Lincoln & Hastings-Krny,68420,1267,34,28,34,96,0.075769534
San Diego,92091,1861,62,45,34,141,0.075765717
Wheeling-Steubenville,43793,4514,122,110,110,342,0.075764289
Philadelphia,8020,2772,81,65,64,210,0.075757576
Johnstown-Altoona-St Colge,15780,132,4,3,3,10,0.075757576
Johnstown-Altoona-St Colge,17213,528,14,14,12,40,0.075757576
Charleston-Huntington,25148,264,7,7,6,20,0.075757576
Charleston-Huntington,25699,132,3,4,3,10,0.075757576
Sioux Falls(Mitchell),57371,198,6,5,4,15,0.075757576
Billings,59077,66,2,2,1,5,0.075757576
Wichita-Hutchinson Plus,67073,264,10,6,4,20,0.075757576
Lincoln & Hastings-Krny,68517,528,17,14,9,40,0.075757576
Ft. Smith-Fay-Sprngdl-Rgrs,74577,198,5,6,4,15,0.075757576
Dallas-Ft. Worth,76652,1056,34,27,19,80,0.075757576
Yakima-Pasco-Rchlnd-Knnwck,98946,528,13,17,10,40,0.075757576
San Francisco-Oak-San Jose,95124,48749,1590,1182,921,3693,0.0757554
Clarksburg-Weston,26426,6719,177,182,150,509,0.075755321
West Palm Beach-Ft. Pierce,34984,19049,512,455,476,1443,0.075752008
"Washington, DC (Hagrstwn)",26711,2429,73,53,58,184,0.075751338
Boston (Manchester),1568,8594,244,232,175,651,0.075750524
Providence-New Bedford,2769,13070,395,307,288,990,0.075745983
Cincinnati,45242,24490,711,607,537,1855,0.075745202
Greensboro-H.Point-W.Salem,27045,9915,252,224,275,751,0.075743822
Minneapolis-St. Paul,56375,779,24,21,14,59,0.075738126
Philadelphia,19119,27437,613,651,814,2078,0.075737143
Pittsburgh,15061,11672,300,276,308,884,0.075736806
Columbia-Jefferson City,65040,1426,37,31,40,108,0.075736325
Boston (Manchester),2332,16201,536,448,243,1227,0.075736066
Evansville,42368,1360,43,32,28,103,0.075735294
"Columbus, OH",43338,10484,304,262,228,794,0.075734452
Detroit,49229,2971,81,74,70,225,0.075732077
Birmingham (Ann and Tusc),35976,18262,482,465,436,1383,0.075731026
Chattanooga,35765,3935,98,105,95,298,0.075730623
Columbia-Jefferson City,65279,1677,48,48,31,127,0.075730471
Bangor,4694,2126,50,56,55,161,0.075729069
Harrisburg-Lncstr-Leb-York,17320,7910,214,182,203,599,0.075726928
Cleveland-Akron (Canton),44847,3724,101,90,91,282,0.075725027
Evansville,42323,898,28,21,19,68,0.075723831
Tulsa,74083,898,28,21,19,68,0.075723831
Utica,13319,832,18,17,28,63,0.075721154
Wichita-Hutchinson Plus,67484,832,29,21,13,63,0.075721154
Sioux City,68643,832,22,15,26,63,0.075721154
Pittsburgh,16120,2047,54,50,51,155,0.075720567
Honolulu,96778,15544,454,366,357,1177,0.075720535
Houston,77316,38880,1266,941,737,2944,0.075720165
Sioux City,68779,2364,82,44,53,179,0.07571912
Knoxville,37714,4662,117,107,129,353,0.075718576
Cedar Rapids-Wtrlo-IWC&Dub,52065,766,18,20,20,58,0.075718016
Cleveland-Akron (Canton),44273,6815,177,164,175,516,0.075715334
Baltimore,21028,3117,94,75,67,236,0.075713827
Binghamton,13332,2285,70,56,47,173,0.07571116
Norfolk-Portsmth-Newpt Nws,23307,634,21,15,12,48,0.075709779
Green Bay-Appleton,54154,5706,146,144,142,432,0.075709779
Fargo,58038,317,13,8,3,24,0.075709779
Abilene-Sweetwater,79521,3606,103,84,86,273,0.075707155
"Columbus, GA (Opelika, AL)",31822,5429,140,136,135,411,0.07570455
"Tri-Cities, TN-VA",37694,1704,45,40,44,129,0.075704225
New Orleans,39572,1136,30,31,25,86,0.075704225
Indianapolis,47436,1387,37,35,33,105,0.075702956
Boston (Manchester),1469,6803,172,177,166,515,0.075701896
Sioux City,51466,1070,36,25,20,81,0.075700935
"Springfield, MO",65470,1070,33,22,26,81,0.075700935
Tampa-St. Pete (Sarasota),34654,24148,695,619,514,1828,0.075699851
Harrisburg-Lncstr-Leb-York,17049,3329,96,80,76,252,0.075698408
Charleston-Huntington,25053,4016,118,99,87,304,0.075697211
Bismarck-Mnt-Dcknsn(Wlstn),58760,251,8,6,5,19,0.075697211
Rochestr-Mason City-Austin,55967,938,33,20,18,71,0.075692964
Shreveport,71032,1876,46,48,48,142,0.075692964
Madison,53804,1374,44,34,26,104,0.075691412
Spokane,99006,14797,449,374,297,1120,0.075691018
Wilkes Barre-Scranton-Hztn,18434,4056,99,92,116,307,0.075690335
St. Louis,63109,26477,380,610,1014,2004,0.075688333
Fargo,56570,1308,45,34,20,99,0.075688073
Terre Haute,62433,872,30,15,21,66,0.075688073
Greenwood-Greenville,38917,3528,99,92,76,267,0.075680272
Providence-New Bedford,2885,11324,277,282,298,857,0.075679972
Hartford & New Haven,6098,10452,219,293,279,791,0.075679296
Davenport-R.Island-Moline,61417,185,5,5,4,14,0.075675676
Quincy-Hannibal-Keokuk,62380,370,10,10,8,28,0.075675676
Lincoln & Hastings-Krny,68876,1480,50,35,27,112,0.075675676
Sherman-Ada,74741,1229,29,31,33,93,0.075671277
Charlotte,28363,1044,33,24,22,79,0.075670498
Charleston-Huntington,25154,859,26,21,18,65,0.075669383
"Columbia, SC",29112,4295,118,101,106,325,0.075669383
Pittsburgh,15046,2445,63,64,58,185,0.075664622
Oklahoma City,73165,8247,272,219,133,624,0.075663878
New York,12765,793,19,17,24,60,0.075662043
Orlando-Daytona Bch-Melbrn,32129,23222,472,544,741,1757,0.075661011
Phoenix (Prescott),85208,38105,961,957,965,2883,0.075659362
Richmond-Petersburg,23129,304,13,7,3,23,0.075657895
"Columbia, SC",29175,304,8,8,7,23,0.075657895
Madison,53587,1216,34,30,28,92,0.075657895
Dayton,45865,5221,167,122,106,395,0.075656005
Greenvll-Spart-Ashevll-And,29682,4428,117,117,101,335,0.075654923
Minneapolis-St. Paul,55066,18968,533,421,481,1435,0.075653733
Youngstown,16121,3939,101,91,106,298,0.075653719
Jacksonville,32622,1454,37,37,36,110,0.07565337
Wheeling-Steubenville,43719,2181,63,56,46,165,0.07565337
Green Bay-Appleton,49896,1877,47,55,40,142,0.075652637
Omaha,68015,1150,45,26,16,87,0.075652174
Peoria-Bloomington,61517,3146,104,72,62,238,0.075651621
Seattle-Tacoma,98577,7865,247,182,166,595,0.075651621
Raleigh-Durham (Fayetvlle),27820,2419,57,49,77,183,0.075651095
Sioux Falls(Mitchell),57355,1269,39,29,28,96,0.075650118
Minneapolis-St. Paul,56438,3080,91,79,63,233,0.075649351
Watertown,13620,2710,87,58,60,205,0.075645756
Quincy-Hannibal-Keokuk,63531,542,15,14,12,41,0.075645756
Topeka,66540,542,16,14,11,41,0.075645756
Champaign&Sprngfld-Decatur,61925,661,22,16,12,50,0.075642965
St. Louis,63648,1322,44,30,26,100,0.075642965
Denver,69129,1322,46,34,20,100,0.075642965
"Columbus, OH",43320,1441,40,37,32,109,0.075641915
Tulsa,74330,2935,100,66,56,222,0.075638842
Rapid City,57761,1256,38,27,30,95,0.075636943
Norfolk-Portsmth-Newpt Nws,27981,1613,47,45,30,122,0.075635462
Augusta-Aiken,29848,714,20,17,17,54,0.075630252
Lexington,40982,238,8,3,7,18,0.075630252
Rochestr-Mason City-Austin,55924,1309,32,32,35,99,0.075630252
Wichita-Hutchinson Plus,67882,357,12,7,8,27,0.075630252
Denver,80622,119,3,3,3,9,0.075630252
Davenport-R.Island-Moline,61264,9798,248,237,256,741,0.075627679
Birmingham (Ann and Tusc),35014,4390,111,101,120,332,0.075626424
Buffalo,14052,17190,474,444,382,1300,0.075625364
Greenvll-Spart-Ashevll-And,28139,18962,515,457,462,1434,0.075624934
Philadelphia,18969,16172,456,398,369,1223,0.075624536
South Bend-Elkhart,46567,10103,273,250,241,764,0.075621103
Lincoln & Hastings-Krny,68941,767,25,18,15,58,0.075619296
Hartford & New Haven,6460,37279,758,912,1149,2819,0.075618981
Chattanooga,35771,3650,97,90,89,276,0.075616438
Detroit,49236,4867,132,123,113,368,0.07561126
San Francisco-Oak-San Jose,94402,27734,731,684,682,2097,0.075611163
Omaha,51555,5039,129,138,114,381,0.07561024
Denver,80649,410,11,10,10,31,0.075609756
Bluefield-Beckley-Oak Hill,25812,1521,48,36,31,115,0.075608153
Albany-Schenectady-Troy,12160,1111,28,26,30,84,0.075607561
Boston (Manchester),3819,4325,109,101,117,327,0.075606936
Atlanta,30105,2103,56,53,50,159,0.075606277
Tallahassee-Thomasville,39834,2103,57,52,50,159,0.075606277
Indianapolis,46133,701,21,18,14,53,0.075606277
Lincoln & Hastings-Krny,68827,701,19,22,12,53,0.075606277
Los Angeles,90021,6243,85,152,235,472,0.075604677
Cedar Rapids-Wtrlo-IWC&Dub,52301,4140,114,101,98,313,0.075603865
Joplin-Pittsburg,66712,1865,49,43,49,141,0.075603217
Bluefield-Beckley-Oak Hill,24377,291,8,8,6,22,0.075601375
Ottumwa-Kirksville,52585,873,24,22,20,66,0.075601375
Sioux Falls(Mitchell),57243,582,20,15,9,44,0.075601375
Denver,69367,291,10,7,5,22,0.075601375
Salt Lake City,82941,5119,166,125,96,387,0.075600703
Buffalo,14068,8783,242,223,199,664,0.075600592
San Francisco-Oak-San Jose,94523,34234,771,856,961,2588,0.075597359
Wheeling-Steubenville,26055,1508,34,36,44,114,0.075596817
Minneapolis-St. Paul,54740,2262,63,49,59,171,0.075596817
Fargo,56520,3942,112,97,89,298,0.075596144
Pittsburgh,15022,10107,268,220,276,764,0.075591174
Little Rock-Pine Bluff,71653,3982,123,90,88,301,0.075590156
"Washington, DC (Hagrstwn)",25425,13732,377,319,342,1038,0.075589863
Albuquerque-Santa Fe,87522,4088,115,96,98,309,0.075587084
"Tri-Cities, TN-VA",37873,4075,112,104,92,308,0.075582822
Charleston-Huntington,25075,1892,59,47,37,143,0.075581395
Evansville,47637,1376,39,36,29,104,0.075581395
St. Louis,65456,516,15,11,13,39,0.075581395
Dallas-Ft. Worth,76238,172,5,5,3,13,0.075581395
Dallas-Ft. Worth,76459,172,5,4,4,13,0.075581395
Albuquerque-Santa Fe,87018,344,9,8,9,26,0.075581395
Richmond-Petersburg,23842,7211,199,177,169,545,0.075578977
Pittsburgh,15241,22599,753,581,374,1708,0.075578565
Marquette,49870,3202,87,86,69,242,0.075577764
Cincinnati,45616,913,28,26,15,69,0.075575027
Chicago,60140,23090,706,538,501,1745,0.075573841
Burlington-Plattsburgh,5701,20179,452,513,560,1525,0.075573616
New Orleans,70437,8522,255,207,182,644,0.075569115
Des Moines-Ames,50151,794,22,16,22,60,0.075566751
St. Louis,62286,5558,145,127,148,420,0.075566751
Charlotte,28681,25117,687,632,579,1898,0.075566349
Charlotte,29726,1866,50,48,43,141,0.075562701
Birmingham (Ann and Tusc),35540,2488,57,66,65,188,0.075562701
Memphis,38034,3110,82,77,76,235,0.075562701
Detroit,48160,13962,403,342,310,1055,0.07556224
Boston (Manchester),3217,1919,41,37,67,145,0.075560188
San Francisco-Oak-San Jose,94553,49339,1165,1227,1336,3728,0.075558889
"Jackson, TN",38382,8907,242,222,209,673,0.075558549
Chicago,46390,2647,70,66,64,200,0.075557235
Tyler-Longview(Lfkn&Ncgd),75792,4222,103,112,104,319,0.075556608
Cedar Rapids-Wtrlo-IWC&Dub,52755,2131,65,52,44,161,0.075551384
Traverse City-Cadillac,49680,1906,60,43,41,144,0.075550892
"Washington, DC (Hagrstwn)",21756,3693,113,99,67,279,0.075548335
Albuquerque-Santa Fe,87535,1231,34,32,27,93,0.075548335
Greenvll-Spart-Ashevll-And,28713,8392,232,223,179,634,0.075548141
Greenvll-Spart-Ashevll-And,28771,7267,201,173,175,549,0.075546993
Green Bay-Appleton,54929,8776,223,212,228,663,0.075546946
Detroit,48380,7982,250,202,151,603,0.075544976
New York,11942,5295,146,125,129,400,0.075542965
Davenport-R.Island-Moline,61277,3177,91,72,77,240,0.075542965
Davenport-R.Island-Moline,61254,11305,361,284,209,854,0.075541796
"Columbus, OH",45732,4620,135,115,99,349,0.075541126
Charleston-Huntington,25529,834,29,19,15,63,0.075539568
Mankato,56120,1112,28,28,28,84,0.075539568
Milwaukee,53075,3164,86,80,73,239,0.075537295
Pittsburgh,15757,1443,43,33,33,109,0.075537076
Chicago,47963,2105,62,52,45,159,0.075534442
Portland-Auburn,4087,2436,70,52,62,184,0.075533662
Nashville,37150,5190,142,122,128,392,0.075529865
Minneapolis-St. Paul,54871,3257,98,82,66,246,0.075529628
Charleston-Huntington,41102,21025,613,498,477,1588,0.075529132
Sioux Falls(Mitchell),69211,331,11,7,7,25,0.075528701
"Springfield, MO",65648,5786,176,135,126,437,0.075527134
Indianapolis,46148,4621,116,102,131,349,0.075524778
Charleston-Huntington,41666,715,26,17,11,54,0.075524476
St. Louis,62013,715,20,18,16,54,0.075524476
Panama City,32443,2966,96,65,63,224,0.075522589
Lexington,41751,384,11,8,10,29,0.075520833
Ft. Wayne,46974,1589,52,27,41,120,0.075519194
Rochestr-Mason City-Austin,55951,1589,52,37,31,120,0.075519194
Milwaukee,53119,5588,155,142,125,422,0.075518969
Shreveport,71003,821,17,19,26,62,0.075517661
"Columbus, GA (Opelika, AL)",36862,5575,135,144,142,421,0.075515695
Dallas-Ft. Worth,76486,1311,36,30,33,99,0.075514874
Clarksburg-Weston,26287,2781,81,71,58,210,0.075512406
Champaign&Sprngfld-Decatur,60959,980,27,22,25,74,0.075510204
Oklahoma City,74643,490,18,9,10,37,0.075510204
Norfolk-Portsmth-Newpt Nws,27980,2013,54,52,46,152,0.07550919
Nashville,37057,1033,29,24,25,78,0.075508228
Bismarck-Mnt-Dcknsn(Wlstn),59215,1033,26,24,28,78,0.075508228
Nashville,37034,9827,296,233,213,742,0.075506258
"Washington, DC (Hagrstwn)",22660,1735,48,43,40,131,0.075504323
Providence-New Bedford,2864,36211,920,925,889,2734,0.075501919
Cleveland-Akron (Canton),44276,2000,51,55,45,151,0.0755
Springfield-Holyoke,1056,20610,490,510,556,1556,0.075497331
"Charleston, SC",29448,2212,61,56,50,167,0.075497288
Indianapolis,47429,7749,223,175,187,585,0.075493612
Philadelphia,8035,8014,206,204,195,605,0.075492887
New York,11050,31116,936,762,651,2349,0.075491708
Phoenix (Prescott),85123,9829,263,246,233,742,0.075490894
Pittsburgh,15425,17764,438,435,468,1341,0.075489755
Champaign&Sprngfld-Decatur,61870,1179,28,29,32,89,0.075487701
Wheeling-Steubenville,26062,20361,532,485,520,1537,0.075487452
"Rochester, NY",14506,1285,37,34,26,97,0.075486381
Kansas City,64735,13592,333,383,310,1026,0.07548558
Harrisburg-Lncstr-Leb-York,17520,5564,153,129,138,420,0.075485262
Grand Rapids-Kalmzoo-B.Crk,49408,10374,292,247,244,783,0.075477154
New York,12486,1590,33,43,44,120,0.075471698
Charlottesville,22433,159,4,4,4,12,0.075471698
Bluefield-Beckley-Oak Hill,24977,477,13,12,11,36,0.075471698
Charleston-Huntington,26617,212,6,5,5,16,0.075471698
Des Moines-Ames,50427,53,2,1,1,4,0.075471698
Minneapolis-St. Paul,56166,212,4,5,7,16,0.075471698
Fargo,56715,371,11,9,8,28,0.075471698
Sioux Falls(Mitchell),57322,212,6,5,5,16,0.075471698
Billings,59312,53,2,1,1,4,0.075471698
Paducah-Cape Girard-Harsbg,62964,1007,28,25,23,76,0.075471698
Sherman-Ada,73440,212,7,5,4,16,0.075471698
Oklahoma City,73756,53,2,1,1,4,0.075471698
Salt Lake City,84732,106,4,2,2,8,0.075471698
Sacramnto-Stkton-Modesto,95747,88092,2857,2089,1702,6648,0.075466558
Boston (Manchester),2461,6493,188,173,129,490,0.075465886
Boston (Manchester),3086,3896,97,94,103,294,0.075462012
Indianapolis,46105,1842,56,42,41,139,0.075461455
Topeka,66413,1789,48,48,39,135,0.075461151
Indianapolis,47460,11675,321,299,261,881,0.075460385
Monroe-El Dorado,71765,1577,48,37,34,119,0.075459734
Johnstown-Altoona-St Colge,16666,2783,83,71,56,210,0.075458139
Miami-Ft. Lauderdale,33134,37651,785,946,1110,2841,0.075456163
Hartford & New Haven,6249,7024,173,184,173,530,0.075455581
Birmingham (Ann and Tusc),35959,4864,128,113,126,367,0.075452303
Kansas City,64428,835,22,19,22,63,0.075449102
Minneapolis-St. Paul,56360,4122,128,105,78,311,0.075448811
Grand Junction-Montrose,81401,23594,658,587,535,1780,0.075442909
Philadelphia,19008,20625,526,532,498,1556,0.075442424
Kansas City,64723,623,20,14,13,47,0.075441413
Knoxville,37737,6641,189,168,144,501,0.075440446
Bangor,4418,1710,52,45,32,129,0.075438596
Binghamton,13730,2691,67,73,63,203,0.075436641
Presque Isle,4742,3155,97,71,70,238,0.075435816
"Columbia, SC",29038,2068,59,54,43,156,0.075435203
Wichita-Hutchinson Plus,67522,2068,69,46,41,156,0.075435203
Madison,53504,2015,56,52,44,152,0.075434243
Greensboro-H.Point-W.Salem,27018,7490,208,173,184,565,0.075433912
Spokane,83811,1498,42,40,31,113,0.075433912
Tulsa,74845,464,15,10,10,35,0.075431034
Savannah,31410,23094,574,606,562,1742,0.075430848
Rockford,61114,15525,397,396,378,1171,0.075426731
Birmingham (Ann and Tusc),35555,9095,231,238,217,686,0.075426058
Grand Rapids-Kalmzoo-B.Crk,49029,1644,50,35,39,124,0.075425791
Dallas-Ft. Worth,76670,1538,42,41,33,116,0.075422627
Albany-Schenectady-Troy,12838,358,9,10,8,27,0.075418994
Chattanooga,37361,1790,46,42,47,135,0.075418994
Terre Haute,47859,1074,27,29,25,81,0.075418994
New York,7974,13843,411,356,277,1044,0.075417178
Chicago,60143,10873,292,278,250,820,0.075416168
"Washington, DC (Hagrstwn)",20664,3010,105,60,62,227,0.075415282
Panama City,32427,1326,39,34,27,100,0.075414781
Boise,83327,968,38,20,15,73,0.075413223
St. Louis,62242,1273,40,30,26,96,0.075412412
Omaha,68064,4376,137,103,90,330,0.075411335
Raleigh-Durham (Fayetvlle),27866,610,17,14,15,46,0.075409836
Sioux Falls(Mitchell),57386,305,7,8,8,23,0.075409836
Rockford,61318,610,16,14,16,46,0.075409836
"Columbus, OH",43064,20661,757,465,336,1558,0.075407773
Wausau-Rhinelander,54411,4960,151,124,99,374,0.075403226
Kansas City,64424,4098,124,93,92,309,0.075402635
Lexington,41740,809,25,16,20,61,0.075401731
Atlanta,30576,2679,72,69,61,202,0.075401269
Lincoln & Hastings-Krny,68828,252,8,6,5,19,0.075396825
Roanoke-Lynchburg,24064,4987,148,116,112,376,0.07539603
Hartford & New Haven,6238,12030,330,277,300,907,0.075394846
Richmond-Petersburg,23830,1658,52,41,32,125,0.075392039
Sioux Falls(Mitchell),57014,1658,55,36,34,125,0.075392039
Panama City,32459,24764,684,592,591,1867,0.075391698
Detroit,48334,18225,426,472,476,1374,0.075390947
Denver,69153,5969,167,128,155,450,0.075389512
Greenvll-Spart-Ashevll-And,28772,1552,46,34,37,117,0.075386598
Charlotte,28166,12814,362,318,286,966,0.075386296
San Francisco-Oak-San Jose,94550,49850,1361,1211,1186,3758,0.075386158
Wilkes Barre-Scranton-Hztn,17823,1300,40,30,28,98,0.075384615
Las Vegas,89040,3290,107,67,74,248,0.075379939
Nashville,37220,7177,165,149,227,541,0.075379685
Binghamton,14889,1393,46,40,19,105,0.075376884
Charleston-Huntington,25009,995,28,25,22,75,0.075376884
Portland-Auburn,4530,11383,277,291,290,858,0.07537556
Richmond-Petersburg,23838,17579,554,444,327,1325,0.075374026
New York,12531,3277,90,78,79,247,0.075373818
Nashville,37046,7987,289,196,117,602,0.07537248
"Springfield, MO",72641,2083,51,62,44,157,0.07537206
Wichita-Hutchinson Plus,67853,743,24,17,15,56,0.075370121
Charleston-Huntington,25276,7072,187,180,166,533,0.075367647
"Columbus, OH",45654,1088,28,30,24,82,0.075367647
Phoenix (Prescott),85145,2720,90,59,56,205,0.075367647
Buffalo,14091,1035,30,25,23,78,0.075362319
New Orleans,70080,1380,41,31,32,104,0.075362319
Casper-Riverton,82516,345,11,9,6,26,0.075362319
Minneapolis-St. Paul,56265,7484,213,168,183,564,0.07536077
Clarksburg-Weston,26378,4180,110,110,95,315,0.075358852
La Crosse-Eau Claire,54770,2163,72,50,41,163,0.075358299
Mobile-Pensacola (Ft Walt),36483,491,15,12,10,37,0.075356415
Paducah-Cape Girard-Harsbg,62867,491,11,14,12,37,0.075356415
"Portland, OR",97106,4565,133,110,101,344,0.075355969
New York,7933,3039,75,90,64,229,0.075353735
Charleston-Huntington,41660,637,18,16,14,48,0.075353218
Cedar Rapids-Wtrlo-IWC&Dub,52003,14240,419,349,305,1073,0.075351124
Paducah-Cape Girard-Harsbg,38253,929,27,20,23,70,0.075349839
Evansville,47579,3079,102,75,55,232,0.075349139
Fargo,56714,1221,42,31,19,92,0.075348075
Davenport-R.Island-Moline,61281,2442,78,59,47,184,0.075348075
"Jackson, MS",39630,146,5,3,3,11,0.075342466
Green Bay-Appleton,54923,8760,250,214,196,660,0.075342466
Minneapolis-St. Paul,56727,730,20,20,15,55,0.075342466
Champaign&Sprngfld-Decatur,60918,730,21,17,17,55,0.075342466
Denver,82725,146,6,3,2,11,0.075342466
Macon,31052,8893,249,208,213,670,0.075340155
New York,8840,17295,484,412,407,1303,0.075339694
Hartford & New Haven,6001,19180,606,486,353,1445,0.075338895
Raleigh-Durham (Fayetvlle),27581,3929,116,94,86,296,0.075337236
Boston (Manchester),1590,9451,282,214,216,712,0.075335943
Harrisburg-Lncstr-Leb-York,17090,5177,149,124,117,390,0.075333205
Erie,16420,531,16,12,12,40,0.075329567
Topeka,66532,531,22,11,7,40,0.075329567
Omaha,68640,1593,56,31,33,120,0.075329567
St. Louis,62801,20032,551,481,477,1509,0.075329473
Madison,53811,3279,102,58,87,247,0.075327844
Lexington,41630,916,26,24,19,69,0.075327511
New York,7922,12917,419,331,223,973,0.075327088
Syracuse,13166,5297,159,122,118,399,0.075325656
Oklahoma City,74857,10382,326,241,215,782,0.075322674
Monroe-El Dorado,71219,1009,28,24,24,76,0.075322101
"Portland, OR",98649,1248,39,32,23,94,0.075320513
Kansas City,64770,863,25,23,17,65,0.075318656
Cleveland-Akron (Canton),44138,23169,628,565,552,1745,0.075316155
Norfolk-Portsmth-Newpt Nws,23898,2058,67,48,40,155,0.075315841
Raleigh-Durham (Fayetvlle),27830,4355,116,115,97,328,0.075315729
St. Louis,65560,13105,368,324,295,987,0.075314765
"Columbus, GA (Opelika, AL)",36850,2629,62,67,69,198,0.075313808
Milwaukee,53149,20262,607,527,392,1526,0.075313395
Quincy-Hannibal-Keokuk,63469,1142,29,25,32,86,0.07530648
Evansville,62476,1474,43,33,35,111,0.075305292
Baltimore,21035,8685,300,217,137,654,0.075302245
Wichita-Hutchinson Plus,66840,664,20,17,13,50,0.075301205
Boston (Manchester),3455,2085,59,55,43,157,0.07529976
Watertown,13661,1753,54,39,39,132,0.075299487
Seattle-Tacoma,98117,35910,777,866,1061,2704,0.07529936
Toledo,43549,1421,38,41,28,107,0.075299085
Fargo,56549,5113,169,119,97,385,0.075298259
Spokane,99036,1846,77,39,23,139,0.075297941
Bluefield-Beckley-Oak Hill,25119,425,13,11,8,32,0.075294118
"Columbus, OH",43787,2736,82,63,61,206,0.075292398
Grand Rapids-Kalmzoo-B.Crk,49461,9151,249,239,201,689,0.075292318
Boston (Manchester),1803,26683,632,681,696,2009,0.075291384
Chattanooga,35764,518,15,12,12,39,0.075289575
Kansas City,64688,518,16,11,12,39,0.075289575
Topeka,66550,518,16,14,9,39,0.075289575
Quincy-Hannibal-Keokuk,62347,2351,78,60,39,177,0.075287112
Pittsburgh,15215,12313,333,310,284,927,0.075286283
St. Louis,62830,1408,48,27,31,106,0.075284091
St. Louis,62271,2059,68,32,55,155,0.075279262
Cleveland-Akron (Canton),43986,1634,50,34,39,123,0.075275398
Louisville,47229,3361,102,75,76,253,0.075275216
New York,6484,41105,971,1018,1105,3094,0.075270648
Wilkes Barre-Scranton-Hztn,17964,651,24,11,14,49,0.075268817
Lexington,40940,558,18,10,14,42,0.075268817
Evansville,42339,837,23,20,20,63,0.075268817
"Columbus, OH",43720,1209,31,34,26,91,0.075268817
Grand Rapids-Kalmzoo-B.Crk,49011,2139,66,51,44,161,0.075268817
Champaign&Sprngfld-Decatur,60930,744,25,15,16,56,0.075268817
Little Rock-Pine Bluff,71960,1209,36,27,28,91,0.075268817
Chattanooga,37325,1993,45,56,49,150,0.075263422
Harrisburg-Lncstr-Leb-York,17543,48538,1343,1172,1138,3653,0.075260621
Milwaukee,53080,5594,127,147,147,421,0.075259206
Richmond-Petersburg,23086,3508,97,76,91,264,0.075256556
Burlington-Plattsburgh,5843,2538,76,58,57,191,0.075256107
Utica,13361,691,19,18,15,52,0.075253256
New York,6903,14232,437,381,253,1071,0.075252951
Ft. Wayne,46911,1289,38,34,25,97,0.075252133
Wheeling-Steubenville,26419,598,17,13,15,45,0.075250836
Corpus Christi,78389,1196,40,30,20,90,0.075250836
Seattle-Tacoma,98220,598,21,12,12,45,0.075250836
"Charleston, SC",29564,824,27,22,13,62,0.075242718
Fargo,56521,824,29,20,13,62,0.075242718
South Bend-Elkhart,49106,4851,130,128,107,365,0.075242218
Detroit,48323,18155,555,460,351,1366,0.07524098
Topeka,66618,10234,359,250,161,770,0.075239398
Fargo,58040,1050,36,24,19,79,0.075238095
New York,18328,8706,231,212,212,655,0.07523547
Albany-Schenectady-Troy,12169,319,9,6,9,24,0.07523511
Columbia-Jefferson City,63345,319,10,7,7,24,0.07523511
Jacksonville,32082,32778,913,891,662,2466,0.075233388
Columbia-Jefferson City,65017,1821,54,47,36,137,0.075233388
Augusta-Aiken,29819,1502,46,35,32,113,0.075233023
Tallahassee-Thomasville,32336,1502,45,38,30,113,0.075233023
New York,6482,11086,337,287,210,834,0.07523002
Terre Haute,62417,3044,93,77,59,229,0.075229961
Lexington,41759,545,18,14,9,41,0.075229358
"Tri-Cities, TN-VA",37881,2406,62,55,64,181,0.075228595
"Rochester, NY",14487,6128,172,145,144,461,0.07522846
"Tri-Cities, TN-VA",41858,7032,199,171,159,529,0.075227531
Davenport-R.Island-Moline,61454,771,19,19,20,58,0.075226978
Fargo,56762,2539,70,55,66,191,0.075226467
"Springfield, MO",65717,2446,90,49,45,184,0.075224857
Pittsburgh,16240,1675,44,45,37,126,0.075223881
Boise,83716,23450,720,572,472,1764,0.075223881
Elmira (Corning),14825,678,22,15,14,51,0.075221239
Charleston-Huntington,25141,226,7,6,4,17,0.075221239
Dayton,45341,3616,98,83,91,272,0.075221239
Sherman-Ada,73450,1130,32,25,28,85,0.075221239
Ft. Smith-Fay-Sprngdl-Rgrs,74962,4560,128,122,93,343,0.075219298
Boston (Manchester),1451,5145,176,136,75,387,0.075218659
New York,11577,11912,359,290,247,896,0.075218267
Chicago,60439,23957,627,621,554,1802,0.075218099
Hartford & New Haven,6096,12444,279,307,350,936,0.075216972
Johnstown-Altoona-St Colge,15840,1848,47,44,48,139,0.07521645
Norfolk-Portsmth-Newpt Nws,27922,811,24,22,15,61,0.075215783
"Columbus, OH",43153,811,29,17,15,61,0.075215783
New York,6851,28518,685,689,771,2145,0.075215653
Paducah-Cape Girard-Harsbg,42081,1928,59,43,43,145,0.075207469
Champaign&Sprngfld-Decatur,61937,1835,59,47,32,138,0.07520436
"Washington, DC (Hagrstwn)",22637,2101,65,52,41,158,0.075202285
Montgomery-Selma,36043,3351,92,81,79,252,0.075201432
San Francisco-Oak-San Jose,94521,42353,1082,1081,1022,3185,0.075201284
Detroit,48049,5718,170,125,135,430,0.075201119
"Tri-Cities, TN-VA",24226,1250,36,32,26,94,0.0752
Ottumwa-Kirksville,52551,625,16,17,14,47,0.0752
Atlanta,30648,3165,88,74,76,238,0.075197472
Minneapolis-St. Paul,55386,10386,417,244,120,781,0.075197381
Minneapolis-St. Paul,56019,891,32,19,16,67,0.075196409
Dallas-Ft. Worth,76034,25480,782,652,482,1916,0.075196232
Norfolk-Portsmth-Newpt Nws,23168,8684,269,220,164,653,0.075195762
Milwaukee,53104,5652,165,125,135,425,0.075194621
Philadelphia,8091,5772,119,140,175,434,0.075190575
Anchorage,99516,21466,720,526,368,1614,0.07518867
Albany-Schenectady-Troy,5152,532,14,15,11,40,0.07518797
Johnstown-Altoona-St Colge,15866,266,8,7,5,20,0.07518797
Bluefield-Beckley-Oak Hill,24860,266,6,8,6,20,0.07518797
Paducah-Cape Girard-Harsbg,38224,931,21,20,29,70,0.07518797
Indianapolis,46280,8246,176,175,269,620,0.07518797
Idaho Fals-Pocatllo(Jcksn),83285,266,10,6,4,20,0.07518797
Amarillo,88434,266,6,7,7,20,0.07518797
Albany-Schenectady-Troy,12083,3631,106,88,79,273,0.075185899
New York,7076,24699,764,588,505,1857,0.07518523
Harrisonburg,24482,4602,114,106,126,346,0.075184702
San Francisco-Oak-San Jose,94505,15376,450,371,335,1156,0.075182102
Johnstown-Altoona-St Colge,16874,1237,31,30,32,93,0.075181892
New York,10579,8739,246,225,186,657,0.075180227
Columbus-Tupelo-West Point,38852,9178,262,207,221,690,0.075179778
New York,10527,838,25,22,16,63,0.075178998
Norfolk-Portsmth-Newpt Nws,23837,4190,120,95,100,315,0.075178998
Paducah-Cape Girard-Harsbg,62934,838,25,20,18,63,0.075178998
San Antonio,78141,705,27,13,13,53,0.075177305
Wilmington,28429,9777,252,236,247,735,0.075176434
Boston (Manchester),1562,12065,266,294,347,907,0.075176129
New York,6470,16495,508,431,301,1240,0.075174295
Burlington-Plattsburgh,5048,2461,62,67,56,185,0.075172694
Dallas-Ft. Worth,76648,2461,74,63,48,185,0.075172694
Peoria-Bloomington,62644,4523,136,99,105,340,0.075171346
Rapid City,57620,439,16,10,7,33,0.075170843
Albany-Schenectady-Troy,12516,1623,43,41,38,122,0.075169439
Atlanta,30251,2368,56,51,71,178,0.075168919
Colorado Springs-Pueblo,80829,5215,116,124,152,392,0.075167785
Jacksonville,31562,2275,66,54,51,171,0.075164835
Traverse City-Cadillac,49639,2581,75,63,56,194,0.075164665
Hartford & New Haven,6479,11149,330,263,245,838,0.075163692
Augusta-Aiken,29849,306,8,9,6,23,0.075163399
Hartford & New Haven,6478,13451,425,330,256,1011,0.075161698
Detroit,48367,4497,125,111,102,338,0.075161219
"Springfield, MO",65612,1397,43,34,28,105,0.075161059
Oklahoma City,74651,785,25,20,14,59,0.075159236
Green Bay-Appleton,54170,3965,118,98,82,298,0.075157629
Omaha,68019,479,11,11,14,36,0.075156576
Cincinnati,41055,1783,53,40,41,134,0.075154234
Chico-Redding,96019,10259,291,235,245,771,0.075153524
Shreveport,71008,652,23,15,11,49,0.075153374
Denver,82225,1956,32,53,62,147,0.075153374
Sacramnto-Stkton-Modesto,95663,2781,87,67,55,209,0.075152823
Albany-Schenectady-Troy,12066,2129,56,58,46,160,0.075152654
Evansville,47619,1650,53,39,32,124,0.075151515
Milwaukee,53191,3513,92,95,77,264,0.075149445
Pittsburgh,21562,2688,71,68,63,202,0.07514881
Traverse City-Cadillac,48886,2036,49,51,53,153,0.075147348
New York,11355,88256,1817,2219,2596,6632,0.075145033
Johnstown-Altoona-St Colge,16840,346,8,7,11,26,0.075144509
Pittsburgh,21539,2422,57,59,66,182,0.075144509
Clarksburg-Weston,26586,346,12,8,6,26,0.075144509
Kansas City,64431,346,8,8,10,26,0.075144509
Milwaukee,53183,2981,99,73,52,224,0.07514257
Eugene,97459,14732,413,371,323,1107,0.075142547
Tampa-St. Pete (Sarasota),33884,37702,1012,885,936,2833,0.075141902
Clarksburg-Weston,26386,2156,67,51,44,162,0.075139147
Clarksburg-Weston,26452,10035,272,220,262,754,0.07513702
Phoenix (Prescott),85925,4685,146,108,98,352,0.075133404
Indianapolis,46167,7693,246,168,164,578,0.075133238
Ft. Smith-Fay-Sprngdl-Rgrs,72934,945,28,25,18,71,0.075132275
Knoxville,37337,1544,43,40,33,116,0.075129534
Cincinnati,45052,3687,96,97,84,277,0.075128831
Flint-Saginaw-Bay City,48414,2356,60,60,57,177,0.075127334
Lincoln & Hastings-Krny,68423,985,32,27,15,74,0.075126904
Dallas-Ft. Worth,75432,3554,87,93,87,267,0.075126618
Pittsburgh,16061,2609,74,65,57,196,0.075124569
Cedar Rapids-Wtrlo-IWC&Dub,52172,5884,141,130,171,442,0.075118967
Hartford & New Haven,6076,12021,313,282,308,903,0.075118543
Albany-Schenectady-Troy,12176,213,6,5,5,16,0.075117371
Evansville,47550,852,27,21,16,64,0.075117371
San Antonio,78057,1278,37,32,27,96,0.075117371
Watertown,13634,3914,108,105,81,294,0.075114972
Green Bay-Appleton,53065,1997,63,48,39,150,0.075112669
St. Louis,62075,3142,92,75,69,236,0.075111394
Boston (Manchester),2762,9892,251,224,268,743,0.075111201
Detroit,48063,4287,113,99,110,322,0.0751108
Sacramnto-Stkton-Modesto,95682,30089,838,760,662,2260,0.075110506
Honolulu,96761,15471,363,371,428,1162,0.075108267
Eugene,97420,27534,674,722,672,2068,0.07510714
Norfolk-Portsmth-Newpt Nws,27937,3462,96,88,76,260,0.075101098
Wheeling-Steubenville,26175,3036,80,74,74,228,0.075098814
"Washington, DC (Hagrstwn)",26731,253,8,5,6,19,0.075098814
Louisville,42788,253,8,6,5,19,0.075098814
Champaign&Sprngfld-Decatur,62666,506,17,10,11,38,0.075098814
Lincoln & Hastings-Krny,69217,506,15,14,9,38,0.075098814
Oklahoma City,73042,759,21,16,20,57,0.075098814
Pittsburgh,16153,2357,69,57,51,177,0.07509546
Pittsburgh,15478,5260,137,134,124,395,0.075095057
Toledo,49268,1052,33,26,20,79,0.075095057
Cedar Rapids-Wtrlo-IWC&Dub,52341,1052,35,26,18,79,0.075095057
San Diego,92011,23810,725,590,473,1788,0.075094498
Binghamton,13862,4075,117,96,93,306,0.075092025
Davenport-R.Island-Moline,52637,2517,74,66,49,189,0.075089392
Lincoln & Hastings-Krny,68967,1132,41,19,25,85,0.075088339
Minneapolis-St. Paul,56477,2850,95,59,60,214,0.075087719
Cincinnati,45236,24000,548,562,692,1802,0.075083333
"Washington, DC (Hagrstwn)",25419,13905,415,325,304,1044,0.075080906
Flint-Saginaw-Bay City,48432,626,19,16,12,47,0.075079872
Baltimore,21102,12507,345,319,275,939,0.075077956
Little Rock-Pine Bluff,72064,2251,63,49,57,169,0.075077743
Paducah-Cape Girard-Harsbg,63750,333,11,8,6,25,0.075075075
Atlanta,30523,14346,396,356,325,1077,0.075073191
Baltimore,21918,4196,112,106,97,315,0.075071497
St. Louis,62443,1412,38,38,30,106,0.075070822
Los Angeles,90732,20821,486,538,539,1563,0.075068441
Wilkes Barre-Scranton-Hztn,18333,373,8,10,10,28,0.075067024
Minneapolis-St. Paul,56384,373,12,9,7,28,0.075067024
Harrisburg-Lncstr-Leb-York,17327,7900,206,198,189,593,0.075063291
Albuquerque-Santa Fe,88022,1199,36,31,23,90,0.075062552
Baltimore,21085,17359,415,423,465,1303,0.075061928
Albany-Schenectady-Troy,12309,31441,843,763,754,2360,0.075061226
Bluefield-Beckley-Oak Hill,24602,826,25,20,17,62,0.075060533
Indianapolis,47917,413,15,9,7,31,0.075060533
Bangor,4655,866,19,17,29,65,0.075057737
Omaha,51564,453,13,12,9,34,0.075055188
Providence-New Bedford,2915,17414,349,420,538,1307,0.075054554
Paducah-Cape Girard-Harsbg,63945,1399,41,35,29,105,0.07505361
Seattle-Tacoma,98572,946,22,22,27,71,0.075052854
Columbus-Tupelo-West Point,39346,1932,50,48,47,145,0.07505176
New York,12546,2958,75,76,71,222,0.07505071
Charleston-Huntington,26202,493,16,14,7,37,0.07505071
Cincinnati,41007,3984,128,85,86,299,0.075050201
Pittsburgh,15065,10940,254,262,305,821,0.075045704
"Washington, DC (Hagrstwn)",17267,2745,75,67,64,206,0.075045537
Ft. Smith-Fay-Sprngdl-Rgrs,72821,1719,49,43,37,129,0.07504363
Sioux Falls(Mitchell),57238,653,19,15,15,49,0.075038285
Albuquerque-Santa Fe,87722,653,22,13,14,49,0.075038285
Mobile-Pensacola (Ft Walt),36474,2692,74,69,59,202,0.075037147
Lexington,41839,693,18,19,15,52,0.075036075
New York,8721,23044,665,539,525,1729,0.075030377
Omaha,51566,6624,176,179,142,497,0.075030193
Fargo,58051,1706,62,39,27,128,0.075029308
Orlando-Daytona Bch-Melbrn,32763,25244,645,600,649,1894,0.075027729
New York,7762,8477,204,219,213,636,0.075026542
Minneapolis-St. Paul,54026,1906,60,52,31,143,0.075026233
New York,7650,20633,371,488,689,1548,0.075025445
Savannah,31331,5958,146,142,159,447,0.075025176
Nashville,42236,1053,29,20,30,79,0.075023742
Jacksonville,32223,25952,655,684,608,1947,0.07502312
Amarillo,79201,6785,183,175,151,509,0.075018423
Louisville,40003,1653,53,40,31,124,0.075015124
West Palm Beach-Ft. Pierce,33433,46778,1258,1195,1056,3509,0.075013895
Honolulu,96754,4466,121,105,109,335,0.075011196
"Springfield, MO",65608,8279,236,200,185,621,0.075009059
Traverse City-Cadillac,49668,3733,95,95,90,280,0.075006697
Seattle-Tacoma,98034,55570,1168,1326,1674,4168,0.075004499
Binghamton,13124,120,4,3,2,9,0.075
Johnstown-Altoona-St Colge,15770,120,4,3,2,9,0.075
Johnstown-Altoona-St Colge,15776,40,1,1,1,3,0.075
Pittsburgh,16210,800,21,17,22,60,0.075
Johnstown-Altoona-St Colge,16655,1400,32,35,38,105,0.075
Johnstown-Altoona-St Colge,16829,680,17,17,17,51,0.075
Norfolk-Portsmth-Newpt Nws,23303,680,19,15,17,51,0.075
"Columbus, GA (Opelika, AL)",31801,2800,85,65,60,210,0.075
Baton Rouge,39657,1840,52,44,42,138,0.075
Evansville,42338,120,3,3,3,9,0.075
Indianapolis,46998,80,3,2,1,6,0.075
Louisville,47123,120,4,3,2,9,0.075
Des Moines-Ames,50165,40,1,1,1,3,0.075
Billings,59002,280,8,8,5,21,0.075
St. Louis,62215,1880,59,41,41,141,0.075
Kansas City,64167,440,15,10,8,33,0.075
Ottumwa-Kirksville,64655,200,5,6,4,15,0.075
Lincoln & Hastings-Krny,68964,120,4,2,3,9,0.075
Oklahoma City,73571,40,1,1,1,3,0.075
Amarillo,73931,520,17,12,10,39,0.075
Denver,80802,240,7,5,6,18,0.075
Denver,82051,40,1,1,1,3,0.075
Salt Lake City,84031,80,3,2,1,6,0.075
Knoxville,37708,6947,197,176,148,521,0.074996401
Harrisburg-Lncstr-Leb-York,17502,3027,87,77,63,227,0.074991741
Roanoke-Lynchburg,24589,2027,58,46,48,152,0.074987667
Philadelphia,8310,1627,42,41,39,122,0.074984634
Myrtle Beach-Florence,29588,55145,1447,1293,1395,4135,0.074984133
Hartford & New Haven,6281,6975,216,179,128,523,0.074982079
Dallas-Ft. Worth,76457,3961,113,91,93,297,0.074981065
New York,7848,4628,132,101,114,347,0.074978392
Wichita Falls & Lawton,76366,2054,66,52,36,154,0.074975657
Los Angeles,90056,7696,154,198,225,577,0.074974012
"Jackson, TN",38332,947,27,23,21,71,0.074973601
Jacksonville,32044,1814,59,41,36,136,0.074972437
Parkersburg,26134,867,23,16,26,65,0.074971165
Mobile-Pensacola (Ft Walt),36482,867,21,25,19,65,0.074971165
Reno,96109,867,24,23,18,65,0.074971165
Rockford,61087,1534,45,38,32,115,0.074967405
Youngstown,16114,707,22,13,18,53,0.074964639
Wilmington,28438,1414,47,36,23,106,0.074964639
Minneapolis-St. Paul,54805,1374,39,35,29,103,0.07496361
"Springfield, MO",65020,14287,451,326,294,1071,0.074963253
Seattle-Tacoma,98028,24533,603,596,640,1839,0.074960258
Philadelphia,8319,1254,40,24,30,94,0.074960128
Ft. Smith-Fay-Sprngdl-Rgrs,72854,587,19,13,12,44,0.074957411
"Springfield, MO",65662,1134,40,22,23,85,0.074955908
St. Louis,62047,1054,30,26,23,79,0.074952562
Cleveland-Akron (Canton),44117,10767,281,285,241,807,0.07495124
Sioux City,51062,507,15,14,9,38,0.07495069
Bangor,4496,3896,104,88,100,292,0.074948665
Hartford & New Haven,6026,5177,148,126,114,388,0.07494688
Greensboro-H.Point-W.Salem,27052,9487,235,228,248,711,0.074944661
Knoxville,37872,2135,51,58,51,160,0.074941452
Marquette,49946,3803,110,101,74,285,0.074940836
San Francisco-Oak-San Jose,94038,2949,85,76,60,221,0.074940658
New York,12578,2095,63,51,43,157,0.074940334
Seattle-Tacoma,98266,4190,99,99,116,314,0.074940334
Traverse City-Cadillac,49781,4070,86,116,103,305,0.074938575
Austin,78959,1628,43,44,35,122,0.074938575
Charlottesville,22727,5845,163,133,142,438,0.074935843
Memphis,72372,1548,53,39,24,116,0.074935401
Nashville,37191,4217,113,92,111,316,0.074934788
Des Moines-Ames,50216,2669,90,65,45,200,0.074934432
Los Angeles,92284,25890,736,619,585,1940,0.074932406
San Francisco-Oak-San Jose,95464,2549,55,61,75,191,0.074931346
Cedar Rapids-Wtrlo-IWC&Dub,52212,347,9,10,7,26,0.074927954
Wilkes Barre-Scranton-Hztn,18411,22542,639,589,461,1689,0.074926803
Little Rock-Pine Bluff,72857,1001,26,25,24,75,0.074925075
Nashville,37143,3964,103,105,89,297,0.074924319
Seattle-Tacoma,98296,28683,886,726,537,2149,0.074922428
Charleston-Huntington,41653,10598,278,258,258,794,0.074919796
Sioux City,68757,614,20,14,12,46,0.074918567
Shreveport,71826,921,23,25,21,69,0.074918567
Charleston-Huntington,25632,881,22,23,21,66,0.074914869
Macon,31020,1762,44,42,46,132,0.074914869
Buffalo,16735,6127,164,154,141,459,0.074914314
Raleigh-Durham (Fayetvlle),27562,6181,224,141,98,463,0.074906973
Albany-Schenectady-Troy,12837,801,22,18,20,60,0.074906367
"Columbus, GA (Opelika, AL)",36858,534,14,15,11,40,0.074906367
"Springfield, MO",64756,801,29,13,18,60,0.074906367
Little Rock-Pine Bluff,72079,534,16,11,13,40,0.074906367
Oklahoma City,73093,3164,98,84,55,237,0.074905183
Grand Rapids-Kalmzoo-B.Crk,49038,8878,234,223,208,665,0.074904258
Toledo,45868,761,22,20,15,57,0.074901445
Cedar Rapids-Wtrlo-IWC&Dub,52329,761,24,17,16,57,0.074901445
Sioux City,51046,1482,46,27,38,111,0.074898785
Bismarck-Mnt-Dcknsn(Wlstn),58750,494,16,11,10,37,0.074898785
Boston (Manchester),1431,3151,85,80,71,236,0.074896858
Johnstown-Altoona-St Colge,15853,6262,171,151,147,469,0.074896199
Lansing,49021,6262,192,146,131,469,0.074896199
Boston (Manchester),3827,3338,91,87,72,250,0.074895147
"Springfield, MO",65637,908,34,19,15,68,0.074889868
Little Rock-Pine Bluff,72573,454,13,11,10,34,0.074889868
Nashville,38568,2230,69,52,46,167,0.074887892
Great Falls,59538,3098,94,66,72,232,0.074887024
Lima,45806,11030,320,259,247,826,0.074886673
Sacramnto-Stkton-Modesto,96161,19764,541,491,448,1480,0.074883627
Memphis,72324,1923,59,45,40,144,0.074882995
Providence-New Bedford,2830,6971,187,172,163,522,0.074881653
"Tri-Cities, TN-VA",37818,5422,147,133,126,406,0.074880118
San Francisco-Oak-San Jose,95485,2711,66,66,71,203,0.074880118
Pittsburgh,15377,601,19,12,14,45,0.074875208
Ottumwa-Kirksville,52576,601,17,15,13,45,0.074875208
Boston (Manchester),1746,14945,478,378,263,1119,0.07487454
New York,11948,1389,35,35,34,104,0.07487401
Minneapolis-St. Paul,55355,9830,262,242,232,736,0.074872838
Knoxville,37861,9069,257,212,210,679,0.074870438
Pittsburgh,15380,561,17,12,13,42,0.07486631
Mobile-Pensacola (Ft Walt),36432,2057,52,48,54,154,0.07486631
Flint-Saginaw-Bay City,48649,1683,49,45,32,126,0.07486631
Sioux City,50531,187,5,5,4,14,0.07486631
Fargo,56510,2244,66,53,49,168,0.07486631
Little Rock-Pine Bluff,72001,561,16,14,12,42,0.07486631
Abilene-Sweetwater,79535,187,7,4,3,14,0.07486631
Hartford & New Haven,6385,15815,429,402,353,1184,0.074865634
Youngstown,44473,3767,95,84,103,282,0.074860632
Los Angeles,90405,26810,476,635,896,2007,0.074860127
"Jackson, MS",39194,19784,531,462,488,1481,0.074858471
Bangor,4444,9498,294,240,177,711,0.074857865
Harrisburg-Lncstr-Leb-York,17112,37498,1022,877,908,2807,0.074857326
Johnstown-Altoona-St Colge,15534,855,23,22,19,64,0.074853801
Ft. Wayne,46784,2565,62,54,76,192,0.074853801
Wausau-Rhinelander,54473,2565,84,64,44,192,0.074853801
Paducah-Cape Girard-Harsbg,63785,855,27,19,18,64,0.074853801
Traverse City-Cadillac,49795,2004,54,55,41,150,0.074850299
Sioux City,51572,334,10,5,10,25,0.074850299
Sioux City,68642,1670,42,32,51,125,0.074850299
Buffalo,16749,4155,113,98,100,311,0.074849579
Fargo,56569,1483,45,36,30,111,0.074848281
Birmingham (Ann and Tusc),35234,4930,99,123,147,369,0.07484787
Knoxville,37710,1149,33,28,25,86,0.074847694
Bangor,4438,1296,39,27,31,97,0.074845679
Toledo,43442,962,28,18,26,72,0.074844075
Paducah-Cape Girard-Harsbg,62810,962,34,19,19,72,0.074844075
"Washington, DC (Hagrstwn)",20895,20189,606,532,373,1511,0.074842736
Des Moines-Ames,50208,21045,553,477,545,1575,0.074839629
Norfolk-Portsmth-Newpt Nws,23457,4316,128,98,97,323,0.074837813
Birmingham (Ann and Tusc),35905,6748,160,172,173,505,0.074836989
Philadelphia,18055,12347,328,317,279,924,0.074835993
Pittsburgh,15359,147,4,4,3,11,0.074829932
Philadelphia,18053,2352,68,60,48,176,0.074829932
Clarksburg-Weston,26278,441,15,8,10,33,0.074829932
Charleston-Huntington,41607,294,8,7,7,22,0.074829932
St. Louis,65461,147,4,4,3,11,0.074829932
Sioux City,68785,294,9,7,6,22,0.074829932
Las Vegas,89020,1323,35,35,29,99,0.074829932
Tucson (Sierra Vista),85715,18135,359,437,561,1357,0.074827681
Sioux City,51445,2713,83,57,63,203,0.074824917
Indianapolis,46056,2419,72,64,45,181,0.074824308
Flint-Saginaw-Bay City,48722,3114,89,75,69,233,0.074823378
Philadelphia,19115,35230,870,828,938,2636,0.074822594
Atlanta,30746,1684,50,42,34,126,0.074821853
Augusta-Aiken,30802,6950,209,161,150,520,0.074820144
Pittsburgh,15627,6509,185,144,158,487,0.074819481
Sioux City,51358,1243,39,29,25,93,0.074818986
Des Moines-Ames,50256,548,18,13,10,41,0.074817518
Minneapolis-St. Paul,55357,3288,99,86,61,246,0.074817518
Atlanta,30218,1898,51,42,49,142,0.074815595
"Springfield, MO",65669,2700,78,61,63,202,0.074814815
Cincinnati,45121,8501,232,190,214,636,0.074814728
Boston (Manchester),3079,30890,727,786,798,2311,0.074813856
Milwaukee,53058,3355,82,90,79,251,0.074813711
Rochestr-Mason City-Austin,50440,401,10,8,12,30,0.074812968
New York,8848,8702,231,239,181,651,0.074810388
Indianapolis,46938,2767,80,64,63,207,0.074810264
"Washington, DC (Hagrstwn)",22310,28782,679,694,780,2153,0.074803697
Wausau-Rhinelander,54442,1016,39,23,14,76,0.07480315
Minneapolis-St. Paul,55340,10775,386,251,169,806,0.074802784
Dallas-Ft. Worth,75758,10775,284,261,261,806,0.074802784
Madison,54634,4532,137,105,97,339,0.074801412
Syracuse,13212,19612,474,454,539,1467,0.074801142
Monterey-Salinas,95065,8369,210,205,211,626,0.074799857
Charlotte,28637,1484,40,33,38,111,0.074797844
Idaho Fals-Pocatllo(Jcksn),83428,615,20,13,13,46,0.074796748
Chicago,60004,50632,1429,1226,1132,3787,0.074794596
Philadelphia,18915,1444,36,36,36,108,0.074792244
Des Moines-Ames,50148,361,11,6,10,27,0.074792244
Rochestr-Mason City-Austin,50448,722,20,21,13,54,0.074792244
Detroit,48116,27864,725,707,652,2084,0.074791846
Shreveport,71861,2273,58,55,57,170,0.074791025
"Washington, DC (Hagrstwn)",15533,1190,28,32,29,89,0.074789916
Des Moines-Ames,50108,468,13,12,10,35,0.074786325
Spokane,99402,1872,60,40,40,140,0.074786325
St. Louis,63037,3383,93,74,86,253,0.074785693
Buffalo,16927,575,16,15,12,43,0.074782609
Portland-Auburn,4042,5015,135,128,112,375,0.074775673
Baltimore,21657,1110,36,26,21,83,0.074774775
Pittsburgh,16159,4360,133,96,97,326,0.074770642
Bangor,4950,4574,112,111,119,342,0.074770442
"Portland, OR",97213,31069,656,737,930,2323,0.074769062
Albany-Schenectady-Troy,12534,17347,401,422,474,1297,0.074767971
Philadelphia,18927,107,3,3,2,8,0.074766355
Charleston-Huntington,26631,214,7,4,5,16,0.074766355
Greenvll-Spart-Ashevll-And,29353,3531,85,86,93,264,0.074766355
"Jackson, TN",38328,856,23,22,19,64,0.074766355
"Jackson, MS",39054,214,6,6,4,16,0.074766355
Minneapolis-St. Paul,56227,214,7,5,4,16,0.074766355
Peoria-Bloomington,61545,535,16,12,12,40,0.074766355
Kansas City,64432,107,3,3,2,8,0.074766355
"Springfield, MO",65744,107,3,3,2,8,0.074766355
Wichita-Hutchinson Plus,67659,107,3,3,2,8,0.074766355
Indianapolis,46986,1779,52,48,33,133,0.074761102
Fargo,56501,18085,506,423,423,1352,0.074758087
Minneapolis-St. Paul,56044,2167,61,42,59,162,0.07475773
Great Falls,59523,2167,51,48,63,162,0.07475773
Terre Haute,62474,816,29,14,18,61,0.074754902
"Rochester, NY",14580,53724,1458,1293,1265,4016,0.074752438
Syracuse,13078,9806,289,257,187,733,0.074750153
Meridian,36904,4000,98,93,108,299,0.07475
Salisbury,21874,2194,57,54,53,164,0.074749316
Wilkes Barre-Scranton-Hztn,18657,10596,270,268,254,792,0.074745187
Baton Rouge,70449,3920,113,87,93,293,0.074744898
San Francisco-Oak-San Jose,94518,27655,615,713,739,2067,0.074742361
Lexington,41317,388,10,10,9,29,0.074742268
Columbia-Jefferson City,65001,388,13,11,5,29,0.074742268
Lansing,49266,2890,81,69,66,216,0.074740484
Roanoke-Lynchburg,24558,5807,149,139,146,434,0.074737386
Watertown,13660,1900,51,43,48,142,0.074736842
Raleigh-Durham (Fayetvlle),27608,12350,335,284,304,923,0.074736842
Pittsburgh,15771,843,25,20,18,63,0.074733096
Billings,82401,6918,228,165,124,517,0.074732582
Miami-Ft. Lauderdale,33173,33856,794,842,894,2530,0.074728261
Shreveport,71825,736,23,18,14,55,0.074728261
"Washington, DC (Hagrstwn)",20637,6343,162,175,137,474,0.074728047
Pittsburgh,21541,1365,37,39,26,102,0.074725275
Champaign&Sprngfld-Decatur,61882,629,17,17,13,47,0.074721781
Oklahoma City,73730,629,21,16,10,47,0.074721781
Los Angeles,90039,27221,488,665,881,2034,0.074721722
South Bend-Elkhart,49085,23541,573,576,610,1759,0.0747207
Austin,78028,41917,1093,1063,976,3132,0.074719088
Chicago,60461,4604,117,116,111,344,0.074717637
Ft. Wayne,45844,3694,107,89,80,276,0.074715755
Presque Isle,4766,348,10,11,5,26,0.074712644
Harrisonburg,22831,696,19,15,18,52,0.074712644
Charleston-Huntington,41234,522,18,12,9,39,0.074712644
Topeka,67420,4176,130,92,90,312,0.074712644
Denver,80757,174,5,4,4,13,0.074712644
Charleston-Huntington,25071,9945,279,241,223,743,0.07471091
Terre Haute,62448,5595,155,138,125,418,0.074709562
Paducah-Cape Girard-Harsbg,42023,2396,79,54,46,179,0.074707846
Charleston-Huntington,41564,763,20,19,18,57,0.074705111
Bowling Green,42159,1526,44,33,37,114,0.074705111
Pittsburgh,16052,2356,64,54,58,176,0.074702886
Quincy-Hannibal-Keokuk,63452,1178,34,33,21,88,0.074702886
Boise,97910,589,16,18,10,44,0.074702886
Los Angeles,91364,26385,659,655,657,1971,0.074701535
Philadelphia,18923,1004,36,22,17,75,0.074701195
Evansville,42413,3012,94,73,58,225,0.074701195
Gainesville,32619,5328,142,138,118,398,0.0746997
Topeka,66549,1660,53,35,36,124,0.074698795
Albany-Schenectady-Troy,12123,5221,121,138,131,390,0.074698334
Greenvll-Spart-Ashevll-And,28805,18796,387,441,576,1404,0.074696744
Presque Isle,4758,1312,42,32,24,98,0.074695122
Sioux Falls(Mitchell),57314,656,17,14,18,49,0.074695122
Billings,59019,4177,163,77,72,312,0.074694757
Minneapolis-St. Paul,56276,241,8,5,5,18,0.074688797
Tulsa,74452,241,7,6,5,18,0.074688797
Evansville,62895,1754,50,37,44,131,0.074686431
Richmond-Petersburg,23944,3575,107,72,88,267,0.074685315
Nashville,38486,1031,28,27,22,77,0.074684772
Indianapolis,47991,1031,24,25,28,77,0.074684772
New York,7825,9587,257,238,221,716,0.074684469
Johnstown-Altoona-St Colge,16650,1580,40,40,38,118,0.074683544
Traverse City-Cadillac,49655,3160,97,64,75,236,0.074683544
Oklahoma City,73724,857,23,21,20,64,0.074679113
New York,7950,22028,588,544,513,1645,0.074677683
Sioux Falls(Mitchell),57258,308,9,7,7,23,0.074675325
Chicago,60481,11530,269,276,316,861,0.074674761
Santabarbra-Sanmar-Sanluob,93465,10392,341,250,185,776,0.074672825
Minneapolis-St. Paul,56373,3348,109,75,66,250,0.074671446
Eugene,97404,35355,899,868,873,2640,0.074671192
Bluefield-Beckley-Oak Hill,25979,683,27,12,12,51,0.074670571
Panama City,32567,5223,148,116,126,390,0.07466973
"Washington, DC (Hagrstwn)",22713,1433,43,36,28,107,0.074668528
Birmingham (Ann and Tusc),35542,1125,32,26,26,84,0.074666667
Oklahoma City,73842,375,11,7,10,28,0.074666667
Los Angeles,90275,41250,1259,1103,718,3080,0.074666667
Spokane,83805,9671,292,215,215,722,0.074656189
Paducah-Cape Girard-Harsbg,42049,1594,35,41,43,119,0.074654956
Davenport-R.Island-Moline,61356,10837,316,242,251,809,0.074651656
Boston (Manchester),1460,10261,311,249,206,766,0.074651593
Tulsa,74470,1286,34,33,29,96,0.074650078
Albany-Schenectady-Troy,12060,1353,37,35,29,101,0.074648928
Detroit,48150,25292,579,588,721,1888,0.07464811
Boise,83650,710,23,16,14,53,0.074647887
Greenvll-Spart-Ashevll-And,28711,15446,432,391,330,1153,0.074647158
Charlotte,28347,1554,45,41,30,116,0.074646075
Traverse City-Cadillac,49716,844,23,19,21,63,0.07464455
Denver,82721,3376,101,78,73,252,0.07464455
Oklahoma City,73002,978,28,22,23,73,0.074642127
Charlotte,29031,1045,39,15,24,78,0.074641148
San Antonio,78263,5225,141,131,118,390,0.074641148
St. Louis,62458,2224,58,53,55,166,0.074640288
Evansville,47634,2291,58,53,60,171,0.074639895
Richmond-Petersburg,23102,3470,93,79,87,259,0.074639769
Charleston-Huntington,25621,2492,63,65,58,186,0.074638844
Kansas City,64019,2693,74,63,64,201,0.07463795
Corpus Christi,78379,1514,45,43,25,113,0.074636724
Odessa-Midland,79758,2921,83,67,68,218,0.074631975
Philadelphia,19053,28098,730,703,664,2097,0.074631646
"Washington, DC (Hagrstwn)",22737,3390,90,83,80,253,0.074631268
Roanoke-Lynchburg,24054,5735,156,134,138,428,0.074629468
Boston (Manchester),2081,21627,642,528,444,1614,0.074628936
Memphis,38028,7276,207,181,155,543,0.074628917
Charlottesville,22731,134,4,3,3,10,0.074626866
Lexington,41632,469,14,11,10,35,0.074626866
Sioux City,51051,67,3,1,1,5,0.074626866
Mankato,56181,1072,30,21,29,80,0.074626866
Great Falls,59537,134,3,3,4,10,0.074626866
Champaign&Sprngfld-Decatur,60966,1340,43,36,21,100,0.074626866
Dallas-Ft. Worth,75415,201,5,5,5,15,0.074626866
Amarillo,88113,67,2,1,2,5,0.074626866
Boston (Manchester),3244,8429,212,183,234,629,0.074623324
Tyler-Longview(Lfkn&Ncgd),75603,5883,175,159,105,439,0.074621792
"Columbia, SC",29044,5280,141,115,138,394,0.074621212
Greensboro-H.Point-W.Salem,27326,3739,106,88,85,279,0.074618882
Minneapolis-St. Paul,55390,3605,109,76,84,269,0.074618585
Albany-Schenectady-Troy,12168,1769,48,34,50,132,0.074618428
Bangor,4986,1568,48,32,37,117,0.074617347
"Tri-Cities, TN-VA",24639,3002,74,74,76,224,0.074616922
New York,7661,11660,355,279,236,870,0.074614065
New York,7094,22463,426,537,713,1676,0.074611583
Green Bay-Appleton,49812,898,27,21,19,67,0.074610245
Milwaukee,53579,1796,60,39,35,134,0.074610245
Hartford & New Haven,6002,22102,489,531,629,1649,0.074608633
Nashville,38585,4517,129,109,99,337,0.07460704
Charlotte,28071,2922,90,64,64,218,0.074606434
Philadelphia,18064,28376,789,692,636,2117,0.0746053
Shreveport,75567,3981,121,89,87,297,0.074604371
Oklahoma City,74839,563,20,12,10,42,0.074600355
Syracuse,13041,11488,319,249,289,857,0.074599582
Louisville,40104,1059,34,25,20,79,0.074598678
Spokane,99033,925,33,22,14,69,0.074594595
Oklahoma City,74644,429,14,11,7,32,0.074592075
Boston (Manchester),2562,3298,96,77,73,246,0.074590661
Des Moines-Ames,50063,3298,112,75,59,246,0.074590661
Boston (Manchester),3844,2373,65,60,52,177,0.074589128
Tallahassee-Thomasville,31649,724,25,18,11,54,0.074585635
Lexington,40464,1086,32,29,20,81,0.074585635
Knoxville,40902,724,22,18,14,54,0.074585635
Charleston-Huntington,26624,2400,59,54,66,179,0.074583333
Madison,53573,2990,92,61,70,223,0.07458194
St. Louis,62253,657,25,17,7,49,0.074581431
New York,7066,15634,402,385,379,1166,0.074581041
Burlington-Plattsburgh,12941,1247,33,33,27,93,0.07457899
Peoria-Bloomington,61570,1542,40,41,34,115,0.07457847
Dothan,36453,2132,65,46,48,159,0.074577861
Quincy-Hannibal-Keokuk,63434,590,16,14,14,44,0.074576271
Wichita-Hutchinson Plus,67410,9668,296,219,206,721,0.074575921
Champaign&Sprngfld-Decatur,62411,4358,124,95,106,325,0.074575493
Louisville,47161,3701,110,89,77,276,0.074574439
Helena,59602,31338,940,764,633,2337,0.074574
New York,7044,14040,404,351,292,1047,0.07457265
Harrisburg-Lncstr-Leb-York,17024,1864,51,43,45,139,0.074570815
Louisville,40059,21966,786,565,287,1638,0.07456979
Chicago,60961,523,16,12,11,39,0.07456979
Topeka,66066,2615,80,66,49,195,0.07456979
New York,6890,4533,142,126,70,338,0.074564306
Bangor,4928,2280,65,55,50,170,0.074561404
Tallahassee-Thomasville,32350,1368,40,32,30,102,0.074561404
Paducah-Cape Girard-Harsbg,42085,684,18,17,16,51,0.074561404
Sioux Falls(Mitchell),57370,912,28,21,19,68,0.074561404
Topeka,66416,456,13,12,9,34,0.074561404
Charleston-Huntington,25043,1529,44,34,36,114,0.074558535
Kansas City,66023,1073,30,29,21,80,0.074557316
Pittsburgh,15086,1918,55,47,41,143,0.07455683
Detroit,48165,9979,297,239,208,744,0.074556569
Austin,78945,11012,333,263,225,821,0.074555031
Cleveland-Akron (Canton),43903,1851,45,43,50,138,0.074554295
"Washington, DC (Hagrstwn)",26753,5902,171,149,120,440,0.074551
Houston,77831,3729,100,85,93,278,0.074550818
Tampa-St. Pete (Sarasota),34232,35159,828,861,932,2621,0.074547058
Memphis,72358,1489,41,34,36,111,0.074546676
Binghamton,13732,7244,205,161,174,540,0.074544451
Flint-Saginaw-Bay City,48767,1972,61,50,36,147,0.074543611
Grand Rapids-Kalmzoo-B.Crk,49045,5460,149,122,136,407,0.074542125
Albuquerque-Santa Fe,81303,8076,186,189,227,602,0.074541852
Bluefield-Beckley-Oak Hill,25823,1744,51,46,33,130,0.074541284
Joplin-Pittsburg,74363,2777,83,63,61,207,0.074540871
Boston (Manchester),2767,15294,416,388,336,1140,0.074539035
Cleveland-Akron (Canton),44889,6936,202,149,166,517,0.074538639
Pittsburgh,15661,322,11,5,8,24,0.074534161
Pittsburgh,21523,322,11,7,6,24,0.074534161
Richmond-Petersburg,23889,483,10,15,11,36,0.074534161
"Tri-Cities, TN-VA",24282,483,13,13,10,36,0.074534161
Lexington,40997,161,4,5,3,12,0.074534161
Cedar Rapids-Wtrlo-IWC&Dub,50632,966,29,23,20,72,0.074534161
Amarillo,88430,161,4,4,4,12,0.074534161
West Palm Beach-Ft. Pierce,33417,34616,799,865,916,2580,0.074532008
New York,18326,5179,125,127,134,386,0.074531763
Peoria-Bloomington,61326,2187,48,55,60,163,0.074531321
"Rochester, NY",14612,34993,796,860,952,2608,0.074529192
Detroit,48744,4401,125,101,102,328,0.074528516
Quincy-Hannibal-Keokuk,62379,1637,50,37,35,122,0.074526573
Dayton,45309,11714,320,283,270,873,0.074526208
Bluefield-Beckley-Oak Hill,25981,926,26,19,24,69,0.074514039
Flint-Saginaw-Bay City,48893,5516,168,134,109,411,0.074510515
Bismarck-Mnt-Dcknsn(Wlstn),58762,255,8,6,5,19,0.074509804
Ottumwa-Kirksville,64672,255,6,8,5,19,0.074509804
Wichita-Hutchinson Plus,67457,765,24,16,17,57,0.074509804
Detroit,48446,30748,765,768,758,2291,0.074508911
Savannah,29940,4107,129,100,77,306,0.074506939
San Antonio,77954,11530,343,278,238,859,0.074501301
Raleigh-Durham (Fayetvlle),27559,2443,73,62,47,182,0.074498567
Pittsburgh,15057,17209,551,394,337,1282,0.074495903
Salt Lake City,89822,2027,50,44,57,151,0.074494327
Fresno-Visalia,93265,4940,141,121,106,368,0.074493927
New York,10594,4014,109,96,94,299,0.074489287
Billings,59085,537,18,13,9,40,0.074487896
"Springfield, MO",65682,1705,52,37,38,127,0.074486804
Sioux City,68743,631,21,17,9,47,0.074484945
Buffalo,14591,1732,42,44,43,129,0.07448037
Greensboro-H.Point-W.Salem,28683,1732,49,46,34,129,0.07448037
Tulsa,74038,1920,55,45,43,143,0.074479167
Greenvll-Spart-Ashevll-And,28756,4310,120,104,97,321,0.074477958
Bismarck-Mnt-Dcknsn(Wlstn),59218,1101,38,18,26,82,0.074477748
Columbia-Jefferson City,65261,1101,29,28,25,82,0.074477748
Dallas-Ft. Worth,76273,10970,314,263,240,817,0.074475843
Wausau-Rhinelander,54412,1947,59,49,37,145,0.074473549
Pittsburgh,15656,10205,266,237,257,760,0.074473297
Hartford & New Haven,6111,29984,737,704,792,2233,0.074473052
Boston (Manchester),1760,36940,922,903,926,2751,0.074472117
Birmingham (Ann and Tusc),35576,2981,76,75,71,222,0.074471654
Topeka,66542,3075,91,72,66,229,0.074471545
Grand Junction-Montrose,81503,16396,417,394,410,1221,0.074469383
Elmira (Corning),14824,470,16,10,9,35,0.074468085
Wilkes Barre-Scranton-Hztn,17867,94,3,2,2,7,0.074468085
Charleston-Huntington,26684,188,6,4,4,14,0.074468085
Charlotte,28338,3854,118,78,91,287,0.074468085
Fargo,58439,376,9,9,10,28,0.074468085
Missoula,59863,94,3,2,2,7,0.074468085
St. Louis,62426,940,27,25,18,70,0.074468085
Denver,80446,4042,102,108,91,301,0.074468085
"Portland, OR",97736,94,3,2,2,7,0.074468085
"Portland, OR",97904,188,6,4,4,14,0.074468085
Springfield-Holyoke,1007,15188,434,361,336,1131,0.074466684
Bangor,4953,3035,75,78,73,226,0.07446458
"Tri-Cities, TN-VA",24230,7225,211,188,139,538,0.074463668
Indianapolis,46130,2592,76,64,53,193,0.074459877
Monterey-Salinas,93908,14142,427,338,288,1053,0.074459058
Toledo,43566,9052,279,207,188,674,0.074458683
Lexington,40771,779,21,19,18,58,0.074454429
Oklahoma City,73843,779,25,20,13,58,0.074454429
Madison,54655,1773,59,46,27,132,0.074450085
Denver,80003,32411,815,761,837,2413,0.074450032
Boston (Manchester),1862,11391,233,279,336,848,0.074444737
Charleston-Huntington,41555,900,24,18,25,67,0.074444444
Philadelphia,18091,6515,169,170,146,485,0.074443592
Portland-Auburn,4983,1706,48,41,38,127,0.074443142
Harrisburg-Lncstr-Leb-York,17058,1706,41,44,42,127,0.074443142
Wichita-Hutchinson Plus,67547,1706,53,37,37,127,0.074443142
Traverse City-Cadillac,49765,3815,100,97,87,284,0.074442988
Bismarck-Mnt-Dcknsn(Wlstn),58544,403,14,9,7,30,0.074441687
Springfield-Holyoke,1062,10062,263,270,216,749,0.074438481
Billings,59337,712,24,18,11,53,0.074438202
Wichita-Hutchinson Plus,67022,1424,39,26,41,106,0.074438202
Salt Lake City,83101,3560,125,74,66,265,0.074438202
Baltimore,21078,20984,537,500,525,1562,0.074437667
Savannah,29934,1236,31,34,27,92,0.074433657
Macon,31070,618,14,17,15,46,0.074433657
Lubbock,79229,309,11,8,4,23,0.074433657
Des Moines-Ames,50841,2593,82,59,52,193,0.074431161
Philadelphia,18940,30928,921,757,624,2302,0.074430936
Pittsburgh,15469,2190,59,49,55,163,0.074429224
"Rochester, NY",14534,32595,1022,831,573,2426,0.074428593
Watertown,13489,524,14,14,11,39,0.074427481
Louisville,40006,4958,141,117,111,369,0.074425171
Pittsburgh,15961,954,25,27,19,71,0.07442348
Toledo,43535,645,19,14,15,48,0.074418605
Omaha,68033,430,13,10,9,32,0.074418605
Charleston-Huntington,41635,2701,80,58,63,201,0.074416883
Little Rock-Pine Bluff,72129,1411,45,33,27,105,0.074415308
Burlington-Plattsburgh,5764,2943,79,62,78,219,0.074413863
Elmira (Corning),16947,4690,121,108,120,349,0.074413646
Harrisburg-Lncstr-Leb-York,17243,1317,35,30,33,98,0.074411541
Richmond-Petersburg,23039,1317,38,31,29,98,0.074411541
Lexington,40419,4502,136,101,98,335,0.074411373
Minneapolis-St. Paul,56522,551,16,14,11,41,0.074410163
Minneapolis-St. Paul,55447,20871,543,519,491,1553,0.074409468
Philadelphia,19508,16396,458,391,371,1220,0.074408392
Harrisonburg,22834,1223,34,26,31,91,0.074407195
Burlington-Plattsburgh,12960,1008,30,22,23,75,0.074404762
Cedar Rapids-Wtrlo-IWC&Dub,52255,1129,36,32,16,84,0.074402126
Charleston-Huntington,25560,9180,247,215,221,683,0.074400871
New York,11414,26317,589,687,682,1958,0.074400578
Denver,81641,3750,127,88,64,279,0.0744
Paducah-Cape Girard-Harsbg,42025,19839,537,480,459,1476,0.074398911
Wilkes Barre-Scranton-Hztn,17968,457,15,8,11,34,0.074398249
Macon,30678,1035,30,25,22,77,0.074396135
Rockford,61018,1035,29,27,21,77,0.074396135
Milwaukee,53563,11466,336,280,237,853,0.07439386
Butte-Bozeman,59632,2097,62,39,55,156,0.074391989
"Columbus, OH",43003,2917,84,74,59,217,0.074391498
Albany-Schenectady-Troy,5255,4678,122,126,100,348,0.074390765
Joplin-Pittsburg,64744,7958,209,197,186,592,0.07439055
"Washington, DC (Hagrstwn)",20617,820,24,20,17,61,0.074390244
Philadelphia,19462,16212,392,394,420,1206,0.074389341
"Rochester, NY",14477,1425,35,36,35,106,0.074385965
Oklahoma City,73121,2971,89,68,64,221,0.074385729
South Bend-Elkhart,49111,3213,95,73,71,239,0.07438531
"Tri-Cities, TN-VA",24248,2030,54,45,52,151,0.074384236
Sioux City,51001,2635,83,60,53,196,0.074383302
Monroe-El Dorado,71260,2635,69,69,58,196,0.074383302
San Francisco-Oak-San Jose,94515,6480,171,147,164,482,0.074382716
Elmira (Corning),14864,1089,33,28,20,81,0.074380165
Bluefield-Beckley-Oak Hill,25846,121,3,3,3,9,0.074380165
"Jackson, MS",39140,1331,43,25,31,99,0.074380165
Madison,53806,1573,45,42,30,117,0.074380165
Billings,59037,2178,76,39,47,162,0.074380165
Oklahoma City,73043,121,4,2,3,9,0.074380165
Roanoke-Lynchburg,24554,3953,110,95,89,294,0.074373893
Boston (Manchester),1901,4464,92,108,132,332,0.07437276
St. Louis,63623,995,29,21,24,74,0.074371859
Wilmington,28443,29608,975,690,537,2202,0.074371791
Milwaukee,53070,4854,156,109,96,361,0.074371652
Madison,53528,6602,193,170,128,491,0.074371403
Toledo,49233,2743,80,65,59,204,0.074371127
Terre Haute,47928,1748,51,43,36,130,0.074370709
New York,11715,4249,100,111,105,316,0.07437044
Madison,53803,1264,43,27,24,94,0.074367089
Flint-Saginaw-Bay City,48618,5083,137,122,119,378,0.074365532
Savannah,29922,1022,25,28,23,76,0.074363992
Indianapolis,47272,1802,54,38,42,134,0.07436182
Green Bay-Appleton,54128,1802,53,40,41,134,0.07436182
Spokane,99027,6697,191,162,145,498,0.074361654
Montgomery-Selma,36748,2972,80,66,75,221,0.0743607
Pittsburgh,15698,780,18,19,21,58,0.074358974
Jonesboro,72478,390,7,13,9,29,0.074358974
Rochestr-Mason City-Austin,55929,1318,42,32,24,98,0.074355083
Wheeling-Steubenville,43912,6227,162,161,140,463,0.074353621
Montgomery-Selma,36040,3322,91,80,76,247,0.0743528
Raleigh-Durham (Fayetvlle),28394,6012,179,134,134,447,0.074351297
Lincoln & Hastings-Krny,68869,2273,59,61,49,169,0.074351078
Bluefield-Beckley-Oak Hill,26680,269,9,7,4,20,0.074349442
Los Angeles,89049,2690,75,56,69,200,0.074349442
Evansville,42372,1641,47,42,33,122,0.074344912
Seattle-Tacoma,98843,2112,68,49,40,157,0.074337121
Boston (Manchester),3835,6901,155,166,192,513,0.074337053
Greensboro-H.Point-W.Salem,24082,565,15,14,13,42,0.074336283
Champaign&Sprngfld-Decatur,61749,565,13,13,16,42,0.074336283
Dallas-Ft. Worth,75447,1278,42,30,23,95,0.074334898
Honolulu,96712,8260,203,189,222,614,0.07433414
"Rochester, NY",14423,4426,109,110,110,329,0.074333484
Boston (Manchester),1463,11583,303,272,286,861,0.074333074
Kansas City,64077,1601,44,37,38,119,0.074328545
Tampa-St. Pete (Sarasota),34653,33810,768,826,919,2513,0.074327122
Bangor,4413,148,4,4,3,11,0.074324324
Richmond-Petersburg,23937,1776,44,47,41,132,0.074324324
Sioux City,51014,444,14,8,11,33,0.074324324
Bismarck-Mnt-Dcknsn(Wlstn),57641,296,6,7,9,22,0.074324324
Bismarck-Mnt-Dcknsn(Wlstn),58549,148,5,3,3,11,0.074324324
Chicago,60010,45288,1457,1138,771,3366,0.074324324
Peoria-Bloomington,61547,3310,109,73,64,246,0.074320242
Bluefield-Beckley-Oak Hill,24874,2422,59,70,51,180,0.074318745
Pittsburgh,15236,32011,725,806,848,2379,0.074318203
Los Angeles,90013,15945,104,409,672,1185,0.074317968
Milwaukee,53021,4723,124,125,102,351,0.074317171
San Francisco-Oak-San Jose,95125,53985,1348,1280,1384,4012,0.07431694
Charlottesville,22937,1238,38,27,27,92,0.074313409
Milwaukee,53004,3714,96,88,92,276,0.074313409
"Jackson, TN",38342,1265,33,26,35,94,0.0743083
Madison,53565,5060,158,102,116,376,0.0743083
Charleston-Huntington,41553,2059,74,45,34,153,0.074307916
Omaha,51560,2059,63,45,45,153,0.074307916
Detroit,48412,5706,158,136,130,424,0.074307746
Charleston-Huntington,41554,794,25,21,13,59,0.074307305
Baltimore,21784,41477,1194,1006,882,3082,0.074306242
Portland-Auburn,3561,6231,138,166,159,463,0.07430589
Evansville,47576,323,10,9,5,24,0.074303406
Ottumwa-Kirksville,63559,1292,44,29,23,96,0.074303406
Albany-Schenectady-Troy,12831,17631,510,416,384,1310,0.074300947
Los Angeles,92320,12046,339,294,262,895,0.074298522
Omaha,51461,996,31,29,14,74,0.074297189
Sioux Falls(Mitchell),57481,498,18,11,8,37,0.074297189
Wilkes Barre-Scranton-Hztn,18831,1346,34,31,35,100,0.074294205
Portland-Auburn,4963,7578,205,184,174,563,0.074294009
Charlottesville,22973,6811,193,174,139,506,0.074291587
Charleston-Huntington,41174,1023,29,23,24,76,0.0742913
Champaign&Sprngfld-Decatur,60960,1023,33,17,26,76,0.0742913
Binghamton,13411,3244,87,73,81,241,0.074290999
Detroit,48301,14686,504,354,233,1091,0.074288438
Minneapolis-St. Paul,56382,1400,45,28,31,104,0.074285714
Amarillo,79261,350,7,12,7,26,0.074285714
Atlanta,36280,3904,111,85,94,290,0.074282787
Champaign&Sprngfld-Decatur,62565,7162,185,167,180,532,0.074280927
Grand Rapids-Kalmzoo-B.Crk,49087,6462,200,151,129,480,0.074280409
Atlanta,36266,5762,148,133,147,428,0.074279764
"Jackson, TN",38317,2531,71,58,59,188,0.074278941
Little Rock-Pine Bluff,72136,2006,56,50,43,149,0.074277168
Seattle-Tacoma,98563,8630,245,205,191,641,0.074275782
Sherman-Ada,74553,1104,35,28,19,82,0.074275362
Binghamton,13856,5978,165,140,139,444,0.074272332
Boston (Manchester),1507,13639,383,330,300,1013,0.074272307
Chicago,46311,23791,671,565,531,1767,0.074271783
Springfield-Holyoke,1360,2814,81,66,62,209,0.0742715
Sioux Falls(Mitchell),51345,377,13,8,7,28,0.074270557
Johnstown-Altoona-St Colge,15537,7998,204,205,185,594,0.074268567
Portland-Auburn,4009,5561,150,136,127,413,0.074267218
San Antonio,78159,781,21,18,19,58,0.074263764
Pittsburgh,15275,808,18,21,21,60,0.074257426
Rapid City,57791,202,6,4,5,15,0.074257426
Topeka,66428,404,12,10,8,30,0.074257426
Lincoln & Hastings-Krny,66959,202,8,3,4,15,0.074257426
Wichita-Hutchinson Plus,67512,202,7,5,3,15,0.074257426
Little Rock-Pine Bluff,72005,202,4,5,6,15,0.074257426
Amarillo,73938,606,18,16,11,45,0.074257426
Chicago,60554,11770,361,273,240,874,0.074256585
Cedar Rapids-Wtrlo-IWC&Dub,50674,3515,100,87,74,261,0.074253201
Harrisburg-Lncstr-Leb-York,17582,2276,62,54,53,169,0.074253076
Albuquerque-Santa Fe,87742,431,10,12,10,32,0.07424594
Tampa-St. Pete (Sarasota),34685,17375,522,459,309,1290,0.074244604
Roanoke-Lynchburg,24069,1778,54,37,41,132,0.07424072
Birmingham (Ann and Tusc),35987,2667,77,66,55,198,0.07424072
Boston (Manchester),3071,5361,151,122,125,398,0.074239881
"Jackson, MS",39179,1118,35,26,22,83,0.074239714
Cedar Rapids-Wtrlo-IWC&Dub,50682,1576,51,34,32,117,0.074238579
Pittsburgh,15026,4095,115,96,93,304,0.074236874
Missoula,59828,6897,209,175,128,512,0.074235175
Richmond-Petersburg,23002,10656,284,266,241,791,0.07423048
San Francisco-Oak-San Jose,94087,59383,1526,1361,1521,4408,0.074229998
Philadelphia,19056,12906,340,295,323,958,0.074229041
Portland-Auburn,4250,5281,126,121,145,392,0.074228366
Cedar Rapids-Wtrlo-IWC&Dub,52214,3139,80,80,73,233,0.074227461
Jacksonville,32643,13782,401,326,296,1023,0.074227253
Johnstown-Altoona-St Colge,15927,970,33,22,17,72,0.074226804
Philadelphia,19034,7154,203,187,141,531,0.07422421
Boston (Manchester),1474,2223,50,56,59,165,0.074224022
"Columbus, OH",43084,741,21,15,19,55,0.074224022
Savannah,30453,8502,242,191,198,631,0.074217831
Indianapolis,46121,5511,153,128,128,409,0.074215206
"Rochester, NY",14589,7182,192,172,169,533,0.074213311
Madison,53805,5390,152,133,115,400,0.074211503
Binghamton,13864,822,21,21,19,61,0.074209246
"Springfield, MO",65732,822,23,22,16,61,0.074209246
Orlando-Daytona Bch-Melbrn,32767,3059,89,76,62,227,0.074207257
Tyler-Longview(Lfkn&Ncgd),75480,1671,50,41,33,124,0.074207062
Pittsburgh,15144,3908,77,98,115,290,0.074206755
Youngstown,44442,3908,98,90,102,290,0.074206755
Pittsburgh,15317,43797,1174,1055,1021,3250,0.074205996
Burlington-Plattsburgh,5042,566,18,12,12,42,0.074204947
Burlington-Plattsburgh,12987,283,8,7,6,21,0.074204947
Lincoln & Hastings-Krny,68624,1132,37,28,19,84,0.074204947
Watertown,13684,876,23,19,23,65,0.074200913
Boston (Manchester),3868,6186,151,141,167,459,0.074199806
Milwaukee,53185,18949,555,491,360,1406,0.074199166
Wichita-Hutchinson Plus,67127,593,22,11,11,44,0.074198988
Roanoke-Lynchburg,24523,19206,490,459,476,1425,0.074195564
Orlando-Daytona Bch-Melbrn,32927,28762,766,680,688,2134,0.074195119
"Tri-Cities, TN-VA",24219,10405,253,268,251,772,0.074195099
Lexington,41712,310,9,8,6,23,0.074193548
Champaign&Sprngfld-Decatur,62544,1860,60,33,45,138,0.074193548
Wichita-Hutchinson Plus,67111,310,10,8,5,23,0.074193548
Providence-New Bedford,2816,33507,848,821,817,2486,0.074193452
New York,7031,16053,361,376,454,1191,0.07419174
Spokane,99181,2224,74,52,39,165,0.074190647
Panama City,32462,3518,102,81,78,261,0.074189881
Pittsburgh,15147,15744,353,394,421,1168,0.074186992
Bluefield-Beckley-Oak Hill,24726,984,26,23,24,73,0.074186992
Hartford & New Haven,6794,1321,35,31,32,98,0.074186223
Cincinnati,45650,337,10,7,8,25,0.074183976
Minneapolis-St. Paul,54737,337,9,8,8,25,0.074183976
Pittsburgh,16050,1375,40,31,31,102,0.074181818
Greensboro-H.Point-W.Salem,27239,9113,240,220,216,676,0.074179743
Charleston-Huntington,25512,1065,32,29,18,79,0.074178404
New York,8730,5069,144,139,93,376,0.074176366
"Columbus, OH",43772,1847,56,39,42,137,0.074174337
Cedar Rapids-Wtrlo-IWC&Dub,52738,3330,87,83,77,247,0.074174174
Austin,78957,10894,311,259,238,808,0.074169267
Wilkes Barre-Scranton-Hztn,17886,782,18,22,18,58,0.074168798
Spokane,83869,5865,178,141,116,435,0.074168798
Cedar Rapids-Wtrlo-IWC&Dub,52039,1200,40,29,20,89,0.074166667
Greenwood-Greenville,39192,1618,49,40,31,120,0.074165637
Milwaukee,53153,2454,77,49,56,182,0.074164629
Detroit,48140,3290,91,80,73,244,0.074164134
"Washington, DC (Hagrstwn)",21750,3708,105,79,91,275,0.07416397
Providence-New Bedford,2825,5488,146,131,130,407,0.074161808
Hattiesburg-Laurel,39478,1699,58,36,32,126,0.074161271
Pittsburgh,21550,13282,325,335,325,985,0.074160518
New York,7735,18893,467,412,522,1401,0.074154449
Shreveport,71833,1861,55,42,41,138,0.074153681
Tampa-St. Pete (Sarasota),33565,18691,538,459,389,1386,0.074153336
Elmira (Corning),14858,1416,43,35,27,105,0.074152542
Elmira (Corning),14894,1497,30,37,44,111,0.074148297
Johnstown-Altoona-St Colge,16832,499,16,11,10,37,0.074148297
Paducah-Cape Girard-Harsbg,63732,1052,30,24,24,78,0.074144487
Boston (Manchester),2494,10601,337,247,202,786,0.074143949
Tampa-St. Pete (Sarasota),34289,4316,101,118,101,320,0.074142725
New York,11937,20717,538,523,475,1536,0.074142009
Greenville-N.Bern-Washngtn,28478,4438,129,104,96,329,0.074132492
Indianapolis,46124,8269,226,182,205,613,0.074132301
Bismarck-Mnt-Dcknsn(Wlstn),59313,2563,77,55,58,190,0.074131877
"Washington, DC (Hagrstwn)",22205,18157,541,416,389,1346,0.074131189
Topeka,66050,1956,59,38,48,145,0.074130879
"Portland, OR",97365,11143,306,270,250,826,0.074127255
Cedar Rapids-Wtrlo-IWC&Dub,52721,715,24,15,14,53,0.074125874
Macon,31016,1673,45,43,36,124,0.07411835
Phoenix (Prescott),85534,2523,69,63,55,187,0.074118113
Charlotte,28091,1727,42,42,44,128,0.074116966
Fresno-Visalia,93667,2240,67,54,45,166,0.074107143
Orlando-Daytona Bch-Melbrn,32696,13643,391,301,319,1011,0.074103936
Minneapolis-St. Paul,56223,1390,32,35,36,103,0.074100719
Paducah-Cape Girard-Harsbg,62920,2861,81,76,55,212,0.074099965
Boston (Manchester),2364,14494,411,363,300,1074,0.074099627
Rochestr-Mason City-Austin,56097,3590,119,88,59,266,0.074094708
Sacramnto-Stkton-Modesto,95977,1795,36,53,44,133,0.074094708
Tulsa,74637,1822,59,43,33,135,0.074094402
Wilkes Barre-Scranton-Hztn,18058,10042,262,234,248,744,0.074088827
"Washington, DC (Hagrstwn)",26757,6182,152,152,154,458,0.074086056
Baton Rouge,70730,3469,89,86,82,257,0.074084751
Cleveland-Akron (Canton),44136,25201,599,605,663,1867,0.074084362
Boston (Manchester),1740,5683,217,138,66,421,0.074080591
Philadelphia,19350,11029,357,272,188,817,0.074077432
Baltimore,21208,34343,870,824,850,2544,0.074076231
Hartford & New Haven,6489,32481,887,782,737,2406,0.074074074
Richmond-Petersburg,23004,837,23,18,21,62,0.074074074
Norfolk-Portsmth-Newpt Nws,23045,162,4,4,4,12,0.074074074
Norfolk-Portsmth-Newpt Nws,23358,108,3,3,2,8,0.074074074
Clarksburg-Weston,26591,1458,39,37,32,108,0.074074074
Nashville,38552,297,8,7,7,22,0.074074074
Columbus-Tupelo-West Point,39755,810,18,23,19,60,0.074074074
Lexington,41834,378,10,7,11,28,0.074074074
Toledo,45889,1539,53,34,27,114,0.074074074
Cedar Rapids-Wtrlo-IWC&Dub,52133,513,14,13,11,38,0.074074074
Des Moines-Ames,52543,216,7,5,4,16,0.074074074
Wausau-Rhinelander,54447,567,12,14,16,42,0.074074074
Minneapolis-St. Paul,56033,297,9,6,7,22,0.074074074
Fargo,58239,54,1,1,2,4,0.074074074
Quincy-Hannibal-Keokuk,62639,243,7,6,5,18,0.074074074
Wichita-Hutchinson Plus,67109,270,10,6,4,20,0.074074074
Wichita-Hutchinson Plus,67764,351,8,9,9,26,0.074074074
Sioux City,68047,1728,48,44,36,128,0.074074074
Lincoln & Hastings-Krny,68309,108,3,3,2,8,0.074074074
Denver,69351,81,2,2,2,6,0.074074074
Memphis,72421,567,14,17,11,42,0.074074074
Dallas-Ft. Worth,76538,972,29,24,19,72,0.074074074
Denver,80722,378,9,10,9,28,0.074074074
Denver,80727,351,12,6,8,26,0.074074074
Colorado Springs-Pueblo,81084,108,4,2,2,8,0.074074074
Amarillo,88411,81,2,2,2,6,0.074074074
Sacramnto-Stkton-Modesto,95258,3645,111,82,77,270,0.074074074
Sacramnto-Stkton-Modesto,95668,675,17,19,14,50,0.074074074
San Francisco-Oak-San Jose,94947,23424,622,600,513,1735,0.074069331
Louisville,47432,4469,113,112,106,331,0.074065787
Minneapolis-St. Paul,54005,3038,103,65,57,225,0.074061883
Grand Rapids-Kalmzoo-B.Crk,48818,2444,66,56,59,181,0.07405892
Grand Rapids-Kalmzoo-B.Crk,49090,13449,373,328,295,996,0.074057551
Augusta-Aiken,29803,41090,1037,948,1058,3043,0.074056948
Oklahoma City,73057,2120,55,54,48,157,0.074056604
Nashville,38449,3430,99,84,71,254,0.074052478
La Crosse-Eau Claire,54433,1661,53,37,33,123,0.074051776
Boston (Manchester),1754,11033,273,256,288,817,0.074050576
Meridian,39337,1553,37,39,39,115,0.074050225
Milwaukee,53150,25726,810,648,447,1905,0.0740496
Wilkes Barre-Scranton-Hztn,18643,12073,291,280,323,894,0.074049532
Panama City,32455,4524,130,106,99,335,0.074049514
Tampa-St. Pete (Sarasota),34690,14504,344,378,352,1074,0.074048538
Boston (Manchester),3884,4335,143,83,95,321,0.074048443
Burlington-Plattsburgh,12944,4146,114,80,113,307,0.074047274
Erie,16443,1229,40,27,24,91,0.074043938
Traverse City-Cadillac,49707,21893,523,514,584,1621,0.074041931
Sioux City,51238,1148,39,20,26,85,0.074041812
Champaign&Sprngfld-Decatur,61912,1094,28,23,30,81,0.074040219
Chicago,60516,27904,726,664,676,2066,0.074039564
Boston (Manchester),2026,25473,572,629,685,1886,0.074039179
Detroit,48002,3120,79,79,73,231,0.074038462
Elmira (Corning),14805,986,29,24,20,73,0.074036511
Miami-Ft. Lauderdale,33129,14912,273,351,480,1104,0.074034335
"Jackson, TN",38320,10171,269,245,239,753,0.074034018
Wilkes Barre-Scranton-Hztn,18707,15682,455,391,315,1161,0.074033924
Bluefield-Beckley-Oak Hill,24613,851,22,21,20,63,0.074030552
Sioux City,51030,1702,56,44,26,126,0.074030552
Orlando-Daytona Bch-Melbrn,32955,42335,1185,1022,927,3134,0.074028582
Portland-Auburn,4294,3985,113,93,89,295,0.074027604
Buffalo,14127,30787,857,749,673,2279,0.074024751
San Antonio,78164,3472,111,71,75,257,0.074020737
Terre Haute,62451,1986,49,47,51,147,0.074018127
Seattle-Tacoma,98506,19442,426,514,499,1439,0.074015019
Raleigh-Durham (Fayetvlle),27563,4364,113,93,117,323,0.074014665
Seattle-Tacoma,98582,608,18,13,14,45,0.074013158
"Washington, DC (Hagrstwn)",22842,5391,148,125,126,399,0.074012243
Champaign&Sprngfld-Decatur,61814,1081,35,25,20,80,0.07400555
Denver,80513,19526,568,469,408,1445,0.074003892
Cedar Rapids-Wtrlo-IWC&Dub,52208,2635,63,75,57,195,0.074003795
Seattle-Tacoma,98589,8324,217,211,188,616,0.074002883
Charleston-Huntington,25244,500,14,11,12,37,0.074
Johnstown-Altoona-St Colge,16830,13419,314,310,369,993,0.073999553
Traverse City-Cadillac,49712,8122,229,182,190,601,0.073996553
Greenvll-Spart-Ashevll-And,28783,1392,28,36,39,103,0.073994253
Green Bay-Appleton,54129,3568,115,83,66,264,0.073991031
Columbia-Jefferson City,65077,446,11,13,9,33,0.073991031
"Springfield, MO",65770,3095,89,69,71,229,0.073990307
Evansville,42330,9515,242,221,241,704,0.073988439
Raleigh-Durham (Fayetvlle),27809,4271,121,101,94,316,0.073987357
Wilkes Barre-Scranton-Hztn,18822,2987,72,73,76,221,0.073987278
Traverse City-Cadillac,49632,1257,32,30,31,93,0.07398568
Omaha,51455,2095,59,47,49,155,0.07398568
Minneapolis-St. Paul,54001,8245,221,227,162,610,0.073984233
Ft. Smith-Fay-Sprngdl-Rgrs,72842,1203,30,32,27,89,0.073981712
"Springfield, MO",65644,2798,74,63,70,207,0.073981415
New York,8825,4704,120,109,119,348,0.073979592
Buffalo,14139,2352,69,50,55,174,0.073979592
Springfield-Holyoke,1342,1460,46,32,30,108,0.073972603
New Orleans,70397,1095,35,28,18,81,0.073972603
Boston (Manchester),1880,27322,598,675,748,2021,0.073969695
Greenwood-Greenville,38922,3434,98,91,65,254,0.07396622
Chattanooga,37317,3015,68,78,77,223,0.073963516
Roanoke-Lynchburg,24089,2312,51,64,56,171,0.073961938
Elmira (Corning),14812,2961,84,64,71,219,0.073961499
Peoria-Bloomington,61561,2569,70,61,59,190,0.073958739
"Washington, DC (Hagrstwn)",20777,3448,113,102,40,255,0.073955916
Charleston-Huntington,26619,311,9,7,7,23,0.073954984
Nashville,37095,2177,61,51,49,161,0.073954984
Greenvll-Spart-Ashevll-And,29696,5233,153,125,109,387,0.073953755
Duluth-Superior,55733,5206,175,116,94,385,0.073953131
"Tri-Cities, TN-VA",24266,8384,218,202,200,620,0.073950382
Memphis,38067,1190,33,30,25,88,0.07394958
"Columbus, OH",43013,1190,38,25,25,88,0.07394958
Burlington-Plattsburgh,3771,879,24,21,20,65,0.073947668
Charleston-Huntington,25651,879,27,19,19,65,0.073947668
Dayton,45459,29291,745,699,722,2166,0.073947629
Wheeling-Steubenville,43747,1163,33,29,24,86,0.07394669
Albany-Schenectady-Troy,12517,568,14,15,13,42,0.073943662
Lexington,41464,284,9,7,5,21,0.073943662
Rochestr-Mason City-Austin,55973,284,8,6,7,21,0.073943662
Sioux Falls(Mitchell),56168,852,26,17,20,63,0.073943662
Cedar Rapids-Wtrlo-IWC&Dub,52333,7939,283,191,113,587,0.073938783
Grand Rapids-Kalmzoo-B.Crk,49099,5667,135,144,140,419,0.073936827
Louisville,40051,4815,104,122,130,356,0.073935618
Milwaukee,53037,10239,279,239,239,757,0.073933001
Greensboro-H.Point-W.Salem,27313,6993,193,160,164,517,0.073931074
Providence-New Bedford,2892,5681,161,140,119,420,0.073930646
Fargo,56574,257,10,5,4,19,0.073929961
"Springfield, MO",65555,1028,32,25,19,76,0.073929961
Cedar Rapids-Wtrlo-IWC&Dub,52253,3314,111,71,63,245,0.073928787
Chicago,60656,28650,659,669,790,2118,0.073926702
Odessa-Midland,79843,2259,62,62,43,167,0.073926516
Tampa-St. Pete (Sarasota),34203,39987,1097,1001,858,2956,0.073924025
Charleston-Huntington,41149,487,16,9,11,36,0.073921971
Charleston-Huntington,41513,487,15,10,11,36,0.073921971
Johnstown-Altoona-St Colge,15946,6507,172,157,152,481,0.073920393
Honolulu,96768,18750,513,438,435,1386,0.07392
Cedar Rapids-Wtrlo-IWC&Dub,50655,717,25,18,10,53,0.073919107
Boston (Manchester),1519,7373,215,179,151,545,0.073918351
Davenport-R.Island-Moline,61234,1177,28,34,25,87,0.073916737
Lubbock,79250,1177,44,19,24,87,0.073916737
Harrisburg-Lncstr-Leb-York,17581,690,16,15,20,51,0.073913043
Ottumwa-Kirksville,52620,920,26,24,18,68,0.073913043
Spokane,99129,663,17,18,14,49,0.073906486
Minneapolis-St. Paul,56312,2395,62,57,58,177,0.073903967
"Columbus, OH",43310,3261,92,74,75,241,0.073903711
New York,12411,433,12,7,13,32,0.073903002
Des Moines-Ames,50212,3153,93,73,67,233,0.073897875
Spokane,98846,1245,41,16,35,92,0.073895582
New York,8525,4520,123,103,108,334,0.073893805
Austin,76825,6320,171,150,146,467,0.073892405
Philadelphia,18955,1218,32,31,27,90,0.073891626
Youngstown,43930,812,28,18,14,60,0.073891626
Wilkes Barre-Scranton-Hztn,18518,8567,198,217,218,633,0.073888176
Baltimore,20764,4331,100,111,109,320,0.073885939
Austin,78739,21859,891,487,237,1615,0.073882611
Minneapolis-St. Paul,56150,2707,81,70,49,200,0.073882527
Minneapolis-St. Paul,56475,1543,43,34,37,114,0.073882048
San Francisco-Oak-San Jose,95140,379,9,9,10,28,0.073878628
Mobile-Pensacola (Ft Walt),32579,10788,272,252,273,797,0.073878383
Myrtle Beach-Florence,29577,37427,847,933,985,2765,0.073877148
Louisville,40176,1313,37,32,28,97,0.073876618
Ft. Smith-Fay-Sprngdl-Rgrs,72947,4264,127,102,86,315,0.073874296
Minneapolis-St. Paul,55338,1110,33,26,23,82,0.073873874
San Diego,92119,23906,558,559,649,1766,0.073872668
Tulsa,74552,1462,51,31,26,108,0.073871409
Birmingham (Ann and Tusc),35571,907,21,30,16,67,0.073869901
Huntsville-Decatur (Flor),35643,3019,80,74,69,223,0.073865518
Erie,16430,176,5,3,5,13,0.073863636
Myrtle Beach-Florence,29596,2288,67,55,47,169,0.073863636
St. Louis,63637,1056,30,27,21,78,0.073863636
Sioux City,68751,176,6,4,3,13,0.073863636
Oklahoma City,73661,176,5,4,4,13,0.073863636
Wichita Falls & Lawton,76364,176,6,4,3,13,0.073863636
Yakima-Pasco-Rchlnd-Knnwck,97868,1760,40,43,47,130,0.073863636
Seattle-Tacoma,98576,5632,171,126,119,416,0.073863636
Los Angeles,91361,19753,532,488,439,1459,0.073862198
Philadelphia,18045,29528,765,753,663,2181,0.073862097
Little Rock-Pine Bluff,72070,1733,50,41,37,128,0.073860358
Parkersburg,45729,1557,45,38,32,115,0.073859987
Terre Haute,47581,3615,91,79,97,267,0.073858921
Dallas-Ft. Worth,75468,853,25,17,21,63,0.073856975
Nashville,38485,6445,177,154,145,476,0.073855702
Fresno-Visalia,93651,1354,36,35,29,100,0.073855244
Hartford & New Haven,6335,6594,186,156,145,487,0.07385502
Los Angeles,92649,33255,706,858,892,2456,0.073853556
Ft. Wayne,45874,2180,52,48,61,161,0.073853211
Duluth-Superior,55768,3006,83,74,65,222,0.073852295
Burlington-Plattsburgh,5855,6987,178,182,156,516,0.073851438
"Washington, DC (Hagrstwn)",20618,1151,33,27,25,85,0.073848827
New York,10921,4550,112,114,110,336,0.073846154
Minneapolis-St. Paul,56663,325,9,9,6,24,0.073846154
Salt Lake City,84311,650,23,11,14,48,0.073846154
Greensboro-H.Point-W.Salem,24317,3697,106,86,81,273,0.073843657
"Tri-Cities, TN-VA",24620,1923,63,48,31,142,0.073842954
Cleveland-Akron (Canton),44626,2844,70,70,70,210,0.073839662
West Palm Beach-Ft. Pierce,33436,44705,1025,1036,1240,3301,0.073839615
Phoenix (Prescott),85936,3765,132,80,66,278,0.073837981
Burlington-Plattsburgh,5824,1097,33,27,21,81,0.073837739
Houston,77830,3115,86,75,69,230,0.073836276
"Portland, OR",97009,8099,252,193,153,598,0.073836276
St. Louis,63055,2316,73,52,46,171,0.073834197
Paducah-Cape Girard-Harsbg,63867,921,25,23,20,68,0.07383279
Madison,53583,5675,144,141,134,419,0.073832599
St. Louis,62216,3034,79,71,74,224,0.073829927
Los Angeles,92651,23717,618,641,492,1751,0.073828899
Pittsburgh,15665,1490,38,36,36,110,0.073825503
"Washington, DC (Hagrstwn)",20677,2682,73,66,59,198,0.073825503
"Washington, DC (Hagrstwn)",21718,149,5,3,3,11,0.073825503
Bismarck-Mnt-Dcknsn(Wlstn),58477,149,4,3,4,11,0.073825503
Houston,75856,149,5,3,3,11,0.073825503
New York,10502,6529,219,151,112,482,0.073824475
Nashville,37138,24992,656,598,591,1845,0.073823624
Shreveport,71834,1463,45,33,30,108,0.073820916
Memphis,72479,1165,36,33,17,86,0.073819742
Charleston-Huntington,25625,1287,31,31,33,95,0.073815074
Wichita-Hutchinson Plus,67054,1138,37,15,32,84,0.073813708
Missoula,59860,12708,324,320,294,938,0.073811772
New Orleans,70723,1409,42,30,32,104,0.073811214
Salt Lake City,84741,6747,207,156,135,498,0.073810582
Watertown,13316,6598,193,149,145,487,0.073810246
Hartford & New Haven,6379,8820,201,213,237,651,0.073809524
Houston,77318,21244,578,521,469,1568,0.073809076
Wausau-Rhinelander,54480,1111,33,26,23,82,0.073807381
Paducah-Cape Girard-Harsbg,42211,13278,401,303,276,980,0.073806296
Peoria-Bloomington,61734,2588,78,67,46,191,0.073802164
Mobile-Pensacola (Ft Walt),36523,2859,76,71,64,211,0.073802029
Macon,31081,271,6,7,7,20,0.073800738
"Tri-Cities, TN-VA",41714,271,7,7,6,20,0.073800738
Joplin-Pittsburg,66732,271,8,5,7,20,0.073800738
Sioux Falls(Mitchell),57363,935,23,23,23,69,0.073796791
Minneapolis-St. Paul,56464,4797,165,106,83,354,0.073796123
Richmond-Petersburg,22454,1992,49,40,58,147,0.073795181
New York,7750,3171,79,91,64,234,0.073793756
Champaign&Sprngfld-Decatur,62521,32713,820,780,814,2414,0.073793293
Rockford,61063,3957,104,103,85,292,0.073793278
New York,7456,11993,329,293,263,885,0.073793046
Kansas City,66076,2236,70,56,39,165,0.073792487
Nashville,37189,3537,83,82,96,261,0.073791349
New York,7410,35113,967,823,801,2591,0.073790334
Louisville,40144,1694,45,40,40,125,0.073789847
Erie,16365,16751,393,421,422,1236,0.07378664
"Springfield, MO",65689,4242,127,103,83,313,0.07378595
St. Louis,62263,4947,138,115,112,365,0.07378209
Kansas City,66052,2155,67,50,42,159,0.073781903
Boston (Manchester),3873,6831,197,162,145,504,0.073781291
Watertown,13473,759,21,14,21,56,0.073781291
Wilkes Barre-Scranton-Hztn,17878,1518,39,35,38,112,0.073781291
Mobile-Pensacola (Ft Walt),36574,1640,44,37,40,121,0.073780488
Boston (Manchester),1945,20901,649,530,363,1542,0.073776374
Harrisburg-Lncstr-Leb-York,17301,4446,118,107,103,328,0.073774179
Tulsa,74880,1952,53,58,33,144,0.073770492
Idaho Fals-Pocatllo(Jcksn),83011,244,3,7,8,18,0.073770492
Hartford & New Haven,6472,6263,155,158,149,462,0.073766566
West Palm Beach-Ft. Pierce,33445,32102,555,838,975,2368,0.073764874
Madison,53502,2630,75,60,59,194,0.073764259
Roanoke-Lynchburg,24530,1071,27,29,23,79,0.073762838
Norfolk-Portsmth-Newpt Nws,27948,12486,335,287,299,921,0.073762614
Wilkes Barre-Scranton-Hztn,18446,2942,79,69,69,217,0.073759347
Chattanooga,37341,13178,367,282,323,972,0.073759296
Macon,31007,705,18,21,13,52,0.073758865
Bangor,4949,922,27,18,23,68,0.073752711
Greenvll-Spart-Ashevll-And,28721,10603,280,253,249,782,0.073752711
Burlington-Plattsburgh,5491,5939,138,142,158,438,0.07374979
Honolulu,96741,6495,180,166,133,479,0.073749038
Milwaukee,53181,8041,237,169,187,593,0.073747046
Grand Rapids-Kalmzoo-B.Crk,49033,1912,59,39,43,141,0.07374477
"Washington, DC (Hagrstwn)",21770,8950,279,214,167,660,0.073743017
Charleston-Huntington,25502,1112,33,29,20,82,0.073741007
Santabarbra-Sanmar-Sanluob,93422,32682,849,779,782,2410,0.073740897
Roanoke-Lynchburg,24563,4760,134,104,113,351,0.073739496
Portland-Auburn,4344,2970,76,71,72,219,0.073737374
Louisville,42741,434,12,10,10,32,0.073732719
Paducah-Cape Girard-Harsbg,62950,217,6,6,4,16,0.073732719
St. Louis,63030,217,6,5,5,16,0.073732719
Traverse City-Cadillac,49642,963,26,29,16,71,0.073727934
Little Rock-Pine Bluff,71935,746,22,18,15,55,0.073726542
Lubbock,79313,1275,48,20,26,94,0.07372549
Portland-Auburn,4083,4666,106,115,123,344,0.073724818
Orlando-Daytona Bch-Melbrn,32736,12506,349,301,272,922,0.073724612
Des Moines-Ames,50146,529,15,13,11,39,0.073724008
Lincoln & Hastings-Krny,68422,529,19,11,9,39,0.073724008
Harrisburg-Lncstr-Leb-York,17009,1872,44,44,50,138,0.073717949
Evansville,42324,1248,34,30,28,92,0.073717949
Quincy-Hannibal-Keokuk,62349,624,18,18,10,46,0.073717949
Boston (Manchester),2330,12087,316,287,288,891,0.073715562
Binghamton,13778,4979,118,127,122,367,0.07370958
Portland-Auburn,4224,2727,85,58,58,201,0.073707371
Norfolk-Portsmth-Newpt Nws,23410,2822,76,72,60,208,0.073706591
"Columbus, OH",45644,4233,112,101,99,312,0.073706591
St. Louis,62262,1411,47,38,19,104,0.073706591
Montgomery-Selma,36442,3609,87,104,75,266,0.073704627
Rochestr-Mason City-Austin,50475,1601,41,41,36,118,0.073703935
Tyler-Longview(Lfkn&Ncgd),75972,5780,164,125,137,426,0.073702422
Pittsburgh,16105,15142,396,382,338,1116,0.073702285
Syracuse,13063,1791,54,43,35,132,0.073701843
Indianapolis,47923,3582,98,79,87,264,0.073701843
Wichita-Hutchinson Plus,66869,597,19,14,11,44,0.073701843
Minneapolis-St. Paul,55080,2863,90,70,51,211,0.073698917
Orlando-Daytona Bch-Melbrn,34420,19702,550,449,453,1452,0.073698102
Grand Rapids-Kalmzoo-B.Crk,48888,6391,170,160,141,471,0.073697387
Boston (Manchester),3825,9648,292,229,190,711,0.07369403
Terre Haute,47424,8549,232,215,183,630,0.07369283
Birmingham (Ann and Tusc),35146,13475,398,321,274,993,0.073692022
Dallas-Ft. Worth,76458,6473,199,154,124,477,0.073690715
"Portland, OR",97221,13150,352,317,300,969,0.073688213
Greensboro-H.Point-W.Salem,24343,8509,240,200,187,627,0.073686685
La Crosse-Eau Claire,54848,5822,176,132,121,429,0.073686019
Boston (Manchester),1983,6582,209,157,119,485,0.07368581
Richmond-Petersburg,23177,570,14,15,13,42,0.073684211
Panama City,32437,475,15,10,10,35,0.073684211
"Columbus, OH",44887,855,25,23,15,63,0.073684211
Madison,53553,570,14,13,15,42,0.073684211
Bismarck-Mnt-Dcknsn(Wlstn),58566,190,7,4,3,14,0.073684211
Chicago,60111,285,8,6,7,21,0.073684211
Tulsa,74117,95,3,2,2,7,0.073684211
Reno,96114,2945,95,73,49,217,0.073684211
Spokane,99401,190,6,4,4,14,0.073684211
Richmond-Petersburg,23924,5361,125,138,132,395,0.073680284
Quincy-Hannibal-Keokuk,62305,18241,526,433,385,1344,0.073680171
Wheeling-Steubenville,26035,2158,64,48,47,159,0.073679333
"Albany, GA",31796,1588,28,44,45,117,0.073677582
Duluth-Superior,55709,4669,138,109,97,344,0.073677447
Hartford & New Haven,6232,3081,70,80,77,227,0.073677377
Minneapolis-St. Paul,56316,1493,43,36,31,110,0.07367716
Milwaukee,53146,8008,215,213,162,590,0.073676324
San Francisco-Oak-San Jose,94062,28069,724,679,665,2068,0.073675585
Wilmington,28470,12691,346,299,290,935,0.073674257
Macon,31017,1846,50,44,42,136,0.073672806
Traverse City-Cadillac,49646,8918,237,217,203,657,0.073671227
Davenport-R.Island-Moline,61273,3122,97,80,53,230,0.073670724
Spokane,99203,20931,557,479,506,1542,0.073670632
Denver,82727,1466,50,31,27,108,0.07366985
Tallahassee-Thomasville,32317,14796,413,363,314,1090,0.073668559
Paducah-Cape Girard-Harsbg,62959,27393,721,657,640,2018,0.073668455
New York,10510,9828,299,245,180,724,0.073667074
New York,7876,10453,255,276,239,770,0.073663063
Albany-Schenectady-Troy,12057,1439,46,32,28,106,0.073662265
Orlando-Daytona Bch-Melbrn,32164,55578,1515,1331,1248,4094,0.07366224
Lexington,41774,2688,80,66,52,198,0.073660714
Duluth-Superior,55702,448,15,9,9,33,0.073660714
Boston (Manchester),1824,27017,733,636,621,1990,0.073657327
Wausau-Rhinelander,54448,4168,134,97,76,307,0.07365643
Philadelphia,8505,22415,577,525,549,1651,0.073656034
Portland-Auburn,4345,12640,336,304,291,931,0.073655063
Minneapolis-St. Paul,56650,706,24,14,14,52,0.073654391
"Columbus, GA (Opelika, AL)",36875,4494,118,106,107,331,0.073653761
New York,6896,8445,284,200,138,622,0.073653049
New York,11978,3951,99,99,93,291,0.07365224
Nashville,38543,611,17,11,17,45,0.073649755
Milwaukee,53006,1833,41,42,52,135,0.073649755
Shreveport,71846,2444,77,48,55,180,0.073649755
"Tri-Cities, TN-VA",41777,869,26,20,18,64,0.073647871
Raleigh-Durham (Fayetvlle),27823,6246,175,142,143,460,0.073647134
Charleston-Huntington,26151,516,14,9,15,38,0.073643411
Lexington,41364,258,7,6,6,19,0.073643411
Davenport-R.Island-Moline,61414,774,24,17,16,57,0.073643411
"Washington, DC (Hagrstwn)",20611,937,30,18,21,69,0.073639274
Burlington-Plattsburgh,12980,1358,38,32,30,100,0.073637703
Burlington-Plattsburgh,5001,9995,210,236,290,736,0.073636818
Greensboro-H.Point-W.Salem,27235,5242,148,124,114,386,0.073636017
New York,10990,19325,563,466,394,1423,0.073635188
New York,7730,17682,458,417,427,1302,0.073634204
Fargo,56518,421,16,9,6,31,0.073634204
Watertown,13697,2268,70,47,50,167,0.073633157
"Washington, DC (Hagrstwn)",22508,16365,456,361,388,1205,0.073632753
Greenville-N.Bern-Washngtn,28570,22300,600,556,486,1642,0.073632287
Boston (Manchester),2050,27312,776,682,553,2011,0.073630639
Roanoke-Lynchburg,24127,3898,95,98,94,287,0.073627501
Buffalo,14718,1820,39,50,45,134,0.073626374
Detroit,48304,17168,474,451,339,1264,0.073625349
Reno,89508,13732,410,280,321,1011,0.073623653
Minneapolis-St. Paul,56472,8829,268,211,171,650,0.073621022
Austin,78737,25550,943,585,353,1881,0.073620352
"Portland, OR",97141,14602,397,359,319,1075,0.073620052
"Jackson, TN",38044,815,18,21,21,60,0.073619632
Topeka,66838,163,4,4,4,12,0.073619632
New York,12414,9957,245,238,250,733,0.073616551
Honolulu,96701,43387,962,1063,1169,3194,0.073616521
Des Moines-Ames,50060,2581,76,52,62,190,0.073614878
Chicago,46349,3206,93,69,74,236,0.073611978
Charlottesville,22963,17144,486,410,366,1262,0.073611759
Paducah-Cape Girard-Harsbg,63967,1997,50,56,41,147,0.073610416
Binghamton,13464,1277,32,32,30,94,0.073610023
Sioux Falls(Mitchell),57319,1114,33,24,25,82,0.073608618
Syracuse,13478,2853,73,69,68,210,0.07360673
Providence-New Bedford,2771,15665,409,391,353,1153,0.073603575
Atlanta,36273,2962,66,71,81,218,0.07359892
Sioux Falls(Mitchell),57220,856,27,20,16,63,0.073598131
Mobile-Pensacola (Ft Walt),36532,40708,1262,985,749,2996,0.073597327
Memphis,38621,1318,30,32,35,97,0.073596358
Dayton,45312,1318,43,30,24,97,0.073596358
Fargo,56543,231,7,6,4,17,0.073593074
"Springfield, MO",65557,231,7,5,5,17,0.073593074
Amarillo,88418,231,9,3,5,17,0.073593074
Eureka,95569,231,6,6,5,17,0.073593074
Los Angeles,91316,27870,555,667,829,2051,0.073591676
Philadelphia,19565,9118,257,205,209,671,0.0735907
Duluth-Superior,55804,15369,454,363,314,1131,0.073589694
Youngstown,44672,4430,106,101,119,326,0.073589165
Reno,89519,9594,236,233,237,706,0.073587659
Monterey-Salinas,95066,15220,423,363,334,1120,0.073587385
New Orleans,70344,4838,143,127,86,356,0.073584126
Charlotte,28612,12775,332,309,299,940,0.073581213
Erie,16417,7964,225,172,189,586,0.073581115
Hartford & New Haven,6070,16499,499,424,291,1214,0.073580217
Indianapolis,47459,3289,97,77,68,242,0.073578595
Lincoln & Hastings-Krny,68948,299,7,7,8,22,0.073578595
Cincinnati,45335,7244,188,183,162,533,0.073578134
Marquette,49802,5817,132,144,152,428,0.073577445
Wilkes Barre-Scranton-Hztn,17813,2161,69,43,47,159,0.073577048
La Crosse-Eau Claire,54615,11077,313,253,249,815,0.073575878
Philadelphia,8221,6755,205,157,135,497,0.07357513
"Rochester, NY",14507,1332,37,32,29,98,0.073573574
Madison,53556,2732,82,63,56,201,0.073572474
Lexington,40460,1033,30,29,17,76,0.07357212
Philadelphia,17087,2800,64,68,74,206,0.073571429
Little Rock-Pine Bluff,71858,1400,35,35,33,103,0.073571429
Wheeling-Steubenville,43976,1536,50,32,31,113,0.073567708
Mobile-Pensacola (Ft Walt),36425,802,21,20,18,59,0.073566085
Burlington-Plattsburgh,5468,13118,383,299,283,965,0.073563043
Des Moines-Ames,50261,3249,116,69,54,239,0.073561096
La Crosse-Eau Claire,55921,4731,139,103,106,348,0.073557387
Detroit,48322,32629,839,770,791,2400,0.0735542
Memphis,38069,2420,69,55,54,178,0.073553719
Seattle-Tacoma,98580,12100,344,259,287,890,0.073553719
Des Moines-Ames,50233,1278,32,35,27,94,0.073552426
Pittsburgh,15001,32631,827,771,802,2400,0.073549692
Eureka,95531,23060,614,558,524,1696,0.073547268
Lincoln & Hastings-Krny,68959,4147,134,90,81,305,0.073547143
Wilmington,28447,979,29,23,20,72,0.073544433
Green Bay-Appleton,54205,2026,63,43,43,149,0.073543929
Boston (Manchester),3304,8308,263,214,134,611,0.073543572
New York,10598,29291,810,729,615,2154,0.073537947
Evansville,47586,11206,305,276,243,824,0.073532036
Madison,53558,13654,401,333,270,1004,0.073531566
La Crosse-Eau Claire,54724,7711,232,165,170,567,0.073531319
Pittsburgh,15021,6664,161,161,168,490,0.073529412
Bluefield-Beckley-Oak Hill,25908,136,3,4,3,10,0.073529412
Charleston-Huntington,26138,136,3,4,3,10,0.073529412
Pittsburgh,26541,3332,85,78,82,245,0.073529412
Omaha,51638,1224,29,33,28,90,0.073529412
Davenport-R.Island-Moline,61490,1088,31,29,20,80,0.073529412
Kansas City,66016,544,17,12,11,40,0.073529412
Lincoln & Hastings-Krny,68856,544,14,13,13,40,0.073529412
Oklahoma City,73011,408,12,9,9,30,0.073529412
Oklahoma City,73646,68,2,2,1,5,0.073529412
Tulsa,74528,136,4,3,3,10,0.073529412
Lubbock,79243,68,2,2,1,5,0.073529412
Lubbock,79324,68,2,2,1,5,0.073529412
Spokane,83824,340,11,7,7,25,0.073529412
Pittsburgh,15068,37484,931,930,895,2756,0.073524704
New York,11354,62119,1129,1517,1921,4567,0.073520179
Tampa-St. Pete (Sarasota),33777,17356,447,428,401,1276,0.073519244
Omaha,68073,2394,72,49,55,176,0.073517126
Omaha,51577,1061,31,25,22,78,0.073515551
Panama City,32334,1850,58,41,37,136,0.073513514
"Jackson, MS",39078,857,19,24,20,63,0.073512252
Peoria-Bloomington,61489,857,24,19,20,63,0.073512252
Ft. Smith-Fay-Sprngdl-Rgrs,72776,789,24,19,15,58,0.073510773
Evansville,42441,1442,37,36,33,106,0.073509015
Denver,80004,35302,846,855,894,2595,0.073508583
Duluth-Superior,55744,20311,551,510,432,1493,0.073506967
Wilkes Barre-Scranton-Hztn,18507,5442,128,142,130,400,0.073502389
Shreveport,71862,517,15,13,10,38,0.073500967
"Washington, DC (Hagrstwn)",26833,2000,53,49,45,147,0.0735
Tampa-St. Pete (Sarasota),34683,33457,968,814,677,2459,0.073497325
"Tri-Cities, TN-VA",41826,830,24,18,19,61,0.073493976
Detroit,48145,3320,99,73,72,244,0.073493976
La Crosse-Eau Claire,54665,8926,273,204,179,656,0.073493166
Springfield-Holyoke,1027,17648,383,412,502,1297,0.073492747
Bluefield-Beckley-Oak Hill,24651,5783,142,132,151,425,0.073491268
Bowling Green,42156,381,10,8,10,28,0.073490814
Rochestr-Mason City-Austin,56026,1905,62,43,35,140,0.073490814
Lexington,40444,14900,434,352,309,1095,0.073489933
Traverse City-Cadillac,49706,5511,149,121,135,405,0.073489385
San Francisco-Oak-San Jose,94517,12410,403,311,198,912,0.073489122
Omaha,68633,1007,32,19,23,74,0.073485601
Bluefield-Beckley-Oak Hill,24872,1633,48,36,36,120,0.073484385
"Tri-Cities, TN-VA",37692,4763,110,103,137,350,0.073483099
Tulsa,67360,313,10,7,6,23,0.073482428
Shreveport,71827,626,15,14,17,46,0.073482428
Minneapolis-St. Paul,55368,2368,68,54,52,174,0.07347973
Greenwood-Greenville,38725,803,19,18,22,59,0.073474471
"Columbus, OH",45648,12658,355,297,278,930,0.073471322
Burlington-Plattsburgh,5444,1892,50,51,38,139,0.07346723
Portland-Auburn,3904,8412,187,178,253,618,0.073466476
Wilkes Barre-Scranton-Hztn,18709,2804,54,74,78,206,0.073466476
Salt Lake City,89301,6765,206,149,142,497,0.073466371
"Washington, DC (Hagrstwn)",22853,4628,101,118,121,340,0.07346586
St. Louis,63126,15654,456,371,323,1150,0.073463651
Charlotte,29055,4002,105,87,102,294,0.073463268
Dallas-Ft. Worth,75411,1266,33,28,32,93,0.073459716
Rockford,61330,1443,39,36,31,106,0.073458073
Presque Isle,4772,599,19,12,13,44,0.07345576
San Francisco-Oak-San Jose,95130,13764,387,335,289,1011,0.073452485
Philadelphia,19522,14227,354,339,352,1045,0.073451887
Seattle-Tacoma,98290,38924,1071,963,825,2859,0.073450827
Boston (Manchester),1742,17876,603,443,267,1313,0.073450436
Wilkes Barre-Scranton-Hztn,17847,11818,290,283,295,868,0.073447284
Boston (Manchester),1949,9912,251,285,192,728,0.073446328
Pittsburgh,15678,531,11,11,17,39,0.073446328
Johnstown-Altoona-St Colge,15821,177,4,4,5,13,0.073446328
"Columbia, SC",29135,7965,216,180,189,585,0.073446328
"Jackson, TN",38258,1593,41,42,34,117,0.073446328
Sioux City,51545,354,10,9,7,26,0.073446328
Fargo,58480,354,12,9,5,26,0.073446328
"Springfield, MO",65731,354,8,7,11,26,0.073446328
Little Rock-Pine Bluff,72827,177,5,4,4,13,0.073446328
Shreveport,75555,1947,61,48,34,143,0.073446328
Pittsburgh,15135,4711,115,114,117,346,0.073445128
New York,7010,26159,539,610,772,1921,0.073435529
Portland-Auburn,3584,3418,90,82,79,251,0.073434757
Charleston-Huntington,41519,926,23,23,22,68,0.073434125
Harrisonburg,24477,11507,296,263,286,845,0.073433562
"Portland, OR",97056,13169,375,331,261,967,0.073430025
Lincoln & Hastings-Krny,68331,1035,37,21,18,76,0.073429952
Albany-Schenectady-Troy,12009,8498,234,198,192,624,0.073429042
New York,7843,11495,258,260,326,844,0.073423227
"Columbus, GA (Opelika, AL)",31804,6061,187,157,101,445,0.073420228
Chicago,60007,32171,807,746,809,2362,0.073420161
Flint-Saginaw-Bay City,49340,3160,93,72,67,232,0.073417722
Minneapolis-St. Paul,55005,4345,125,105,89,319,0.073417722
Burlington-Plattsburgh,5739,1294,31,35,29,95,0.073415765
Los Angeles,92860,25485,626,656,589,1871,0.073415735
Boston (Manchester),3837,1512,45,37,29,111,0.073412698
Madison,53582,1008,27,17,30,74,0.073412698
Wilkes Barre-Scranton-Hztn,18444,13717,373,328,306,1007,0.073412554
Wilkes Barre-Scranton-Hztn,17821,18976,494,426,473,1393,0.073408516
Seattle-Tacoma,98579,13786,363,338,311,1012,0.073407805
Omaha,68034,1049,34,23,20,77,0.073403241
New York,11565,8501,212,210,202,624,0.073403129
Joplin-Pittsburg,66757,3079,86,80,60,226,0.073400455
"Tri-Cities, TN-VA",41775,109,3,3,2,8,0.073394495
Topeka,66054,2725,80,68,52,200,0.073394495
Wichita-Hutchinson Plus,67018,109,3,3,2,8,0.073394495
Sherman-Ada,74560,545,16,12,12,40,0.073394495
Salt Lake City,84082,872,27,16,21,64,0.073394495
Reno,89420,109,3,2,3,8,0.073394495
Tyler-Longview(Lfkn&Ncgd),75930,1894,53,46,40,139,0.073389652
Minneapolis-St. Paul,56101,6050,148,148,148,444,0.07338843
Charlotte,27281,3393,98,81,70,249,0.073386384
Terre Haute,47832,1022,25,26,24,75,0.073385519
Johnstown-Altoona-St Colge,16679,913,22,21,24,67,0.073384447
Birmingham (Ann and Tusc),35587,913,20,23,24,67,0.073384447
San Diego,91935,8694,222,218,198,638,0.073383943
San Diego,92003,5042,131,113,126,370,0.073383578
Buffalo,14416,3693,83,88,100,271,0.073382074
Fargo,58060,1390,34,33,35,102,0.073381295
St. Louis,62069,3039,79,80,64,223,0.073379401
Portland-Auburn,4847,1758,53,46,30,129,0.07337884
Buffalo,14741,1758,54,40,35,129,0.07337884
Topeka,66429,586,18,13,12,43,0.07337884
Pittsburgh,15025,17199,472,380,410,1262,0.073376359
Jacksonville,32009,3448,87,85,81,253,0.07337587
New York,7981,9172,224,236,213,673,0.073375491
Milwaukee,53406,26400,699,612,626,1937,0.073371212
St. Louis,62280,368,10,9,8,27,0.073369565
Denver,80805,368,11,8,8,27,0.073369565
Cheyenne-Scottsbluff,82050,368,12,9,6,27,0.073369565
Buffalo,14030,1513,41,28,42,111,0.073364177
Nashville,42122,5916,162,144,128,434,0.073360379
Pittsburgh,15642,46336,1251,1103,1045,3399,0.07335549
Wheeling-Steubenville,26047,5794,158,148,119,425,0.073351743
New York,8889,9734,264,248,202,714,0.07335114
St. Louis,62050,409,13,9,8,30,0.073349633
Minneapolis-St. Paul,56676,1677,50,38,35,123,0.073345259
Rochestr-Mason City-Austin,56042,709,18,16,18,52,0.073342736
Buffalo,14743,1718,56,41,29,126,0.073341094
Reno,89510,2168,70,43,46,159,0.073339483
Augusta-Aiken,29628,2468,64,57,60,181,0.073338736
Milwaukee,53156,3368,88,84,75,247,0.073337292
San Francisco-Oak-San Jose,94952,33394,872,812,765,2449,0.073336528
Charleston-Huntington,26180,2209,63,50,49,162,0.073336351
Norfolk-Portsmth-Newpt Nws,27919,1200,39,29,20,88,0.073333333
Duluth-Superior,55758,150,5,4,2,11,0.073333333
Rapid City,57767,150,4,3,4,11,0.073333333
Bismarck-Mnt-Dcknsn(Wlstn),58535,600,20,14,10,44,0.073333333
Salt Lake City,84086,450,13,13,7,33,0.073333333
Boise,83617,19364,544,430,446,1420,0.073331956
Phoenix (Prescott),85050,34160,1034,814,657,2505,0.073331382
Minneapolis-St. Paul,55045,8005,234,183,170,587,0.073329169
Pittsburgh,15044,30125,945,724,540,2209,0.073327801
Detroit,48154,36836,927,878,896,2701,0.073325008
Eugene,97452,1582,56,31,29,116,0.073324905
Houston,78962,4596,131,103,103,337,0.07332463
"Washington, DC (Hagrstwn)",22443,9683,237,233,240,710,0.073324383
Chicago,47922,1432,38,33,34,105,0.073324022
Oklahoma City,73079,641,20,14,13,47,0.073322933
Colorado Springs-Pueblo,81082,11320,292,279,259,830,0.073321555
Roanoke-Lynchburg,24112,31302,789,740,766,2295,0.073317999
Boston (Manchester),3258,2728,69,74,57,200,0.073313783
Providence-New Bedford,2896,11676,298,258,300,856,0.073312778
San Antonio,78013,6220,174,139,143,456,0.073311897
Madison,53516,2087,55,54,44,153,0.073310973
"Portland, OR",97374,5961,149,152,136,437,0.073309847
Des Moines-Ames,50065,532,14,13,12,39,0.073308271
Des Moines-Ames,50452,723,23,16,14,53,0.073305671
Minneapolis-St. Paul,55079,8676,258,203,175,636,0.073305671
Indianapolis,47360,1637,47,41,32,120,0.073304826
Harrisburg-Lncstr-Leb-York,17063,3315,84,81,78,243,0.073303167
Denver,80117,2783,90,63,51,204,0.073302192
Davenport-R.Island-Moline,61475,191,5,6,3,14,0.073298429
Memphis,72355,2101,63,49,42,154,0.073298429
"Washington, DC (Hagrstwn)",21773,5389,162,126,107,395,0.073297458
Boston (Manchester),2093,12702,354,323,254,931,0.073295544
New York,7607,9919,249,231,247,727,0.073293679
Davenport-R.Island-Moline,61231,4980,155,109,101,365,0.073293173
Charleston-Huntington,41522,4598,120,112,105,337,0.073292736
"Rochester, NY",14617,22922,637,537,506,1680,0.073292034
Harrisburg-Lncstr-Leb-York,17362,13685,377,318,308,1003,0.073291925
"Charleston, SC",29435,3834,110,87,84,281,0.073291601
Minneapolis-St. Paul,55369,41438,1080,952,1005,3037,0.073290217
Johnstown-Altoona-St Colge,17260,1228,31,30,29,90,0.073289902
Fargo,56545,614,19,15,11,45,0.073289902
Detroit,48006,3725,113,88,72,273,0.073288591
Phoenix (Prescott),85396,47853,1495,1016,996,3507,0.073286941
Memphis,72394,423,9,11,11,31,0.073286052
Nashville,38472,2770,65,73,65,203,0.073285199
Dallas-Ft. Worth,76627,1501,46,33,31,110,0.073284477
Hartford & New Haven,6357,11585,256,267,326,849,0.07328442
Indianapolis,47383,2388,65,63,47,175,0.073283082
Tallahassee-Thomasville,32066,6209,180,148,127,455,0.073280722
Peoria-Bloomington,61520,15707,377,395,379,1151,0.07327943
Boston (Manchester),1535,4940,120,116,126,362,0.073279352
Portland-Auburn,4097,4599,142,118,77,337,0.073276799
Boston (Manchester),1730,14302,424,362,262,1048,0.073276465
Knoxville,37715,928,28,20,20,68,0.073275862
Bismarck-Mnt-Dcknsn(Wlstn),57644,232,8,5,4,17,0.073275862
Wichita-Hutchinson Plus,67650,232,7,6,4,17,0.073275862
"Washington, DC (Hagrstwn)",21545,1706,45,36,44,125,0.073270809
Evansville,42343,1706,48,43,34,125,0.073270809
Boston (Manchester),1921,8339,289,195,127,611,0.073270176
Albany-Schenectady-Troy,12302,27433,705,660,645,2010,0.07326942
Kansas City,66027,6715,185,188,119,492,0.073268801
Hartford & New Haven,6019,10332,286,248,223,757,0.073267518
Wheeling-Steubenville,26059,3112,83,75,70,228,0.073264781
Paducah-Cape Girard-Harsbg,62992,778,19,21,17,57,0.073264781
Quincy-Hannibal-Keokuk,63456,4436,118,109,98,325,0.073264202
Minneapolis-St. Paul,55342,1829,51,41,42,134,0.073264079
Birmingham (Ann and Tusc),35548,1597,34,33,50,117,0.073262367
Pittsburgh,15056,1092,31,28,21,80,0.073260073
Milwaukee,53010,7303,230,164,141,535,0.073257565
"Tri-Cities, TN-VA",37657,860,19,22,22,63,0.073255814
Boston (Manchester),1611,2307,58,49,62,169,0.07325531
Tyler-Longview(Lfkn&Ncgd),75944,1215,32,30,27,89,0.073251029
Cleveland-Akron (Canton),44262,4942,119,111,132,362,0.073249696
Topeka,67487,1256,34,30,28,92,0.073248408
La Crosse-Eau Claire,54742,4956,152,112,99,363,0.073244552
St. Louis,63633,669,20,17,12,49,0.073243647
Sherman-Ada,74536,1338,34,30,34,98,0.073243647
Albany-Schenectady-Troy,12405,710,18,18,16,52,0.073239437
Huntsville-Decatur (Flor),35677,1775,50,46,34,130,0.073239437
Mobile-Pensacola (Ft Walt),36530,9476,241,228,225,694,0.073237653
Champaign&Sprngfld-Decatur,61841,1461,51,33,23,107,0.073237509
Tucson (Sierra Vista),85735,10309,300,243,212,755,0.073236977
Binghamton,13825,2963,84,70,63,217,0.073236585
Detroit,48072,14720,321,352,405,1078,0.073233696
Philadelphia,18037,7565,186,183,185,554,0.073231989
New Orleans,70041,2854,77,75,57,209,0.073230554
Fairbanks,99712,13205,371,310,286,967,0.073229837
Buffalo,14754,833,24,19,18,61,0.073229292
Wilmington,28463,8221,198,211,193,602,0.073227101
Pittsburgh,16311,437,11,10,11,32,0.073226545
Louisville,40076,3100,95,68,64,227,0.073225806
Baltimore,21111,5012,156,123,88,367,0.073224262
Chicago,60646,26494,718,658,564,1940,0.073224126
Clarksburg-Weston,26337,915,20,24,23,67,0.073224044
Cedar Rapids-Wtrlo-IWC&Dub,50647,1871,61,45,31,137,0.073222875
Louisville,40022,956,30,23,17,70,0.073221757
Tulsa,74650,478,16,8,11,35,0.073221757
Chicago,60491,23108,661,544,487,1692,0.073221395
Minneapolis-St. Paul,56098,2035,61,47,41,149,0.073218673
Minneapolis-St. Paul,56323,519,16,10,12,38,0.073217726
San Antonio,78004,519,17,15,6,38,0.073217726
Erie,16415,9902,319,239,167,725,0.073217532
Rochestr-Mason City-Austin,55963,5778,168,130,125,423,0.073208723
Columbia-Jefferson City,65230,642,19,14,14,47,0.073208723
"Tri-Cities, TN-VA",24622,683,20,15,15,50,0.073206442
Peoria-Bloomington,61776,1366,41,32,27,100,0.073206442
Bismarck-Mnt-Dcknsn(Wlstn),59262,724,22,13,18,53,0.07320442
Omaha,68057,1489,47,32,30,109,0.073203492
New York,12472,1571,33,36,46,115,0.073201782
Watertown,13607,1694,40,40,44,124,0.073199528
Buffalo,14755,2623,60,63,69,192,0.073198628
Minneapolis-St. Paul,55395,2746,85,63,53,201,0.073197378
"Tri-Cities, TN-VA",37659,29537,770,727,665,2162,0.07319633
Boston (Manchester),2474,27925,598,642,804,2044,0.073196061
"Tri-Cities, TN-VA",24260,5014,138,113,116,367,0.073195054
Philadelphia,8406,9140,174,235,260,669,0.073194748
Memphis,38927,1134,26,26,31,83,0.07319224
Des Moines-Ames,50240,2391,77,56,42,175,0.073191133
New York,7834,17557,465,426,394,1285,0.073190181
"Columbus, GA (Opelika, AL)",39886,1257,37,28,27,92,0.073190135
Champaign&Sprngfld-Decatur,61878,1298,28,33,34,95,0.073189522
Savannah,29916,1585,46,35,35,116,0.07318612
Roanoke-Lynchburg,24079,1626,46,34,39,119,0.073185732
Pittsburgh,15748,6832,177,163,160,500,0.073185012
Chattanooga,37336,4892,124,119,115,358,0.073180703
Pittsburgh,15944,2897,80,66,66,212,0.073179151
Oklahoma City,73026,13324,379,318,278,975,0.073176223
Tulsa,74114,16222,344,383,460,1187,0.073172235
Providence-New Bedford,2832,5207,131,125,125,381,0.073170732
Burlington-Plattsburgh,3781,2132,66,51,39,156,0.073170732
Burlington-Plattsburgh,5442,369,9,8,10,27,0.073170732
New York,11958,902,26,22,18,66,0.073170732
Richmond-Petersburg,23085,287,7,8,6,21,0.073170732
Charleston-Huntington,25654,410,8,12,10,30,0.073170732
Wheeling-Steubenville,26575,574,15,14,13,42,0.073170732
Des Moines-Ames,50067,328,9,8,7,24,0.073170732
Des Moines-Ames,50127,41,1,1,1,3,0.073170732
Minneapolis-St. Paul,55419,26937,720,654,597,1971,0.073170732
Bismarck-Mnt-Dcknsn(Wlstn),58564,82,3,2,1,6,0.073170732
Bismarck-Mnt-Dcknsn(Wlstn),58569,82,3,2,1,6,0.073170732
Joplin-Pittsburg,66761,164,6,3,3,12,0.073170732
Joplin-Pittsburg,66775,164,5,4,3,12,0.073170732
Wichita-Hutchinson Plus,67149,1107,35,27,19,81,0.073170732
Wichita-Hutchinson Plus,67442,246,7,6,5,18,0.073170732
Wichita-Hutchinson Plus,67492,246,10,5,3,18,0.073170732
Wichita-Hutchinson Plus,67645,533,13,17,9,39,0.073170732
Oklahoma City,73017,1640,48,43,29,120,0.073170732
Lubbock,79353,41,1,1,1,3,0.073170732
Salt Lake City,84722,1148,34,27,23,84,0.073170732
Seattle-Tacoma,98542,615,18,14,13,45,0.073170732
Nashville,37096,6219,170,142,143,455,0.073162888
Cleveland-Akron (Canton),44116,21186,565,484,501,1550,0.073161522
Charleston-Huntington,25671,1203,36,20,32,88,0.073150457
Johnstown-Altoona-St Colge,15909,4525,118,119,94,331,0.073149171
Des Moines-Ames,50230,1039,26,23,27,76,0.073147257
Milwaukee,53072,27206,756,670,564,1990,0.07314563
Burlington-Plattsburgh,5676,5127,125,123,127,375,0.073142188
Sioux City,51351,5127,137,120,118,375,0.073142188
Salisbury,21849,3842,82,92,107,281,0.07313899
New York,10706,9325,306,211,165,682,0.073136729
Rockford,61019,3432,102,80,69,251,0.073135198
Burlington-Plattsburgh,5069,629,19,13,14,46,0.073131955
Lincoln & Hastings-Krny,68924,1217,35,26,28,89,0.073130649
Davenport-R.Island-Moline,61434,3022,89,65,67,221,0.073130377
Madison,54646,4075,122,94,82,298,0.073128834
"Springfield, MO",65649,1723,51,42,33,126,0.073128265
Sioux Falls(Mitchell),56116,547,20,11,9,40,0.073126143
Kansas City,64625,547,14,12,14,40,0.073126143
Bangor,4479,1313,38,25,33,96,0.073115004
Harrisburg-Lncstr-Leb-York,17364,3898,110,78,97,285,0.073114418
San Francisco-Oak-San Jose,94019,18943,486,468,431,1385,0.073114079
Ottumwa-Kirksville,63561,1149,26,24,34,84,0.07310705
Lincoln & Hastings-Krny,68853,1532,47,29,36,112,0.07310705
Houston,77381,34690,1044,853,639,2536,0.073104641
Baton Rouge,70770,3666,105,86,77,268,0.073104201
"Jackson, TN",38363,5417,138,141,117,396,0.073103194
Grand Rapids-Kalmzoo-B.Crk,49052,1067,35,23,20,78,0.073102156
Binghamton,13754,2818,77,61,68,206,0.07310149
Madison,53589,19946,549,490,419,1458,0.073097363
Shreveport,71028,1327,26,36,35,97,0.073097212
Buffalo,14428,7839,190,183,200,573,0.073096058
La Crosse-Eau Claire,54747,2613,75,51,65,191,0.073096058
Cleveland-Akron (Canton),44067,19605,511,467,455,1433,0.073093599
Joplin-Pittsburg,66755,944,29,17,23,69,0.07309322
Norfolk-Portsmth-Newpt Nws,27897,1245,32,24,35,91,0.073092369
Minneapolis-St. Paul,54736,3995,113,88,91,292,0.073091364
Missoula,59847,6143,190,144,115,449,0.073091323
Burlington-Plattsburgh,5744,602,15,15,14,44,0.073089701
Clarksburg-Weston,26203,301,7,9,6,22,0.073089701
Boston (Manchester),3851,4050,99,93,104,296,0.07308642
Fargo,56572,5692,180,130,106,416,0.073085032
"Tri-Cities, TN-VA",24649,2039,55,53,41,149,0.073075037
Philadelphia,18977,3818,118,107,54,279,0.073074908
Detroit,48427,2518,68,58,58,184,0.073073868
Ft. Smith-Fay-Sprngdl-Rgrs,72930,479,15,10,10,35,0.073068894
Elmira (Corning),16932,698,19,20,12,51,0.073065903
Los Angeles,91001,34695,885,843,807,2535,0.073065283
Youngstown,44408,11086,319,254,237,810,0.073065127
Johnstown-Altoona-St Colge,16877,1615,43,41,34,118,0.073065015
Louisville,40055,2053,58,50,42,150,0.073063809
"Portland, OR",97386,14768,412,352,315,1079,0.07306338
Detroit,48462,12414,316,298,293,907,0.073062671
Tampa-St. Pete (Sarasota),33756,33192,790,781,854,2425,0.073059773
Sioux Falls(Mitchell),57585,219,6,6,4,16,0.073059361
Lincoln & Hastings-Krny,68766,438,15,9,8,32,0.073059361
Sacramnto-Stkton-Modesto,95628,43075,1066,1026,1055,3147,0.073058619
New York,12542,6064,155,142,146,443,0.07305409
"Washington, DC (Hagrstwn)",22624,2464,63,56,61,180,0.073051948
Shreveport,71959,616,18,15,12,45,0.073051948
Atlanta,31024,21889,598,520,481,1599,0.073050391
New York,7420,4600,102,105,129,336,0.073043478
Tampa-St. Pete (Sarasota),33859,13006,356,294,300,950,0.073043211
Nashville,38587,1506,42,34,34,110,0.073041169
Louisville,47117,4518,134,109,87,330,0.073041169
Roanoke-Lynchburg,23959,1109,27,25,29,81,0.073038774
Omaha,68347,2574,93,58,37,188,0.073038073
Boston (Manchester),1527,13925,341,336,340,1017,0.073034111
Atlanta,30124,3026,58,80,83,221,0.073033708
Sioux Falls(Mitchell),57534,178,5,4,4,13,0.073033708
Topeka,66960,178,7,3,3,13,0.073033708
Wichita-Hutchinson Plus,67573,178,6,4,3,13,0.073033708
Lincoln & Hastings-Krny,69214,178,5,5,3,13,0.073033708
Seattle-Tacoma,98026,40914,927,964,1097,2988,0.073031236
Kansas City,66007,10530,354,256,159,769,0.07302944
Davenport-R.Island-Moline,52751,1027,30,21,24,75,0.073028238
Greenwood-Greenville,38948,1835,52,40,42,134,0.073024523
Harrisburg-Lncstr-Leb-York,17099,1164,23,32,30,85,0.073024055
New York,11752,9586,244,213,243,700,0.073023159
St. Louis,62831,493,14,9,13,36,0.073022312
Nashville,37082,6108,184,149,113,446,0.073018991
Paducah-Cape Girard-Harsbg,62814,1753,48,38,42,128,0.073017684
Minneapolis-St. Paul,56085,5040,143,109,116,368,0.073015873
Wichita-Hutchinson Plus,66842,315,10,7,6,23,0.073015873
Boston (Manchester),1468,4862,123,121,111,355,0.07301522
"Columbia, SC",29010,11149,285,264,265,814,0.073011032
Hartford & New Haven,6241,7136,182,170,169,521,0.07301009
Milwaukee,53059,1808,45,49,38,132,0.07300885
Wichita-Hutchinson Plus,67570,1356,49,29,21,99,0.07300885
Rapid City,82838,452,15,11,7,33,0.07300885
Buffalo,14174,5479,137,128,135,400,0.073006023
Wheeling-Steubenville,26041,14766,364,362,352,1078,0.073005553
Columbia-Jefferson City,65046,1178,31,24,31,86,0.073005093
Cleveland-Akron (Canton),44050,6575,192,142,146,480,0.073003802
St. Louis,62546,1452,44,32,30,106,0.073002755
Chicago,60922,1863,46,51,39,136,0.073000537
Dothan,36320,3685,98,91,80,269,0.072998643
Montgomery-Selma,36005,1274,36,27,30,93,0.07299843
Louisville,40050,1548,44,40,29,113,0.072997416
San Francisco-Oak-San Jose,94519,18357,466,418,456,1340,0.072996677
Knoxville,38556,13275,362,302,305,969,0.07299435
Boston (Manchester),1520,16522,523,390,293,1206,0.072993584
Binghamton,12434,548,13,12,15,40,0.072992701
Binghamton,13841,411,9,13,8,30,0.072992701
Charleston-Huntington,26376,548,17,11,12,40,0.072992701
Bismarck-Mnt-Dcknsn(Wlstn),58532,274,9,6,5,20,0.072992701
"Springfield, MO",65720,411,14,8,8,30,0.072992701
Sioux City,68710,822,22,19,19,60,0.072992701
Duluth-Superior,55707,3384,97,89,61,247,0.072990544
Peoria-Bloomington,61753,2973,88,69,60,217,0.072990246
Eureka,95525,1740,34,50,43,127,0.072988506
Fargo,56723,918,32,20,15,67,0.072984749
Johnstown-Altoona-St Colge,16863,781,20,20,17,57,0.072983355
"Springfield, MO",72662,2987,93,63,62,218,0.072982926
"Springfield, MO",65760,644,20,16,11,47,0.072981366
Wilkes Barre-Scranton-Hztn,18353,12565,321,279,317,917,0.072980501
Pittsburgh,15229,14840,309,346,428,1083,0.072978437
"Portland, OR",97111,3549,95,88,76,259,0.072978304
Philadelphia,8690,19280,462,442,503,1407,0.072977178
Harrisburg-Lncstr-Leb-York,17045,3275,85,76,78,239,0.072977099
"Columbus, OH",43319,1384,44,31,26,101,0.072976879
Philadelphia,19301,7989,228,188,167,583,0.072975341
Detroit,49285,5961,171,141,123,435,0.072974333
Macon,30820,1110,33,25,23,81,0.072972973
Detroit,48236,29765,851,729,592,2172,0.072971611
Madison,53575,18199,540,420,368,1328,0.072971042
Oklahoma City,74062,973,31,21,19,71,0.072970195
Gainesville,32653,15020,366,360,370,1096,0.072969374
Charleston-Huntington,26447,1206,35,24,29,88,0.072968491
Evansville,47620,12896,331,299,311,941,0.072968362
Boston (Manchester),1504,9196,235,218,218,671,0.072966507
Cedar Rapids-Wtrlo-IWC&Dub,50662,6606,178,151,153,482,0.072963972
Nashville,38580,2330,67,48,55,170,0.072961373
Sioux Falls(Mitchell),57224,233,6,5,6,17,0.072961373
Sioux Falls(Mitchell),57544,466,14,12,8,34,0.072961373
"Washington, DC (Hagrstwn)",20842,2056,61,48,41,150,0.072957198
Detroit,49276,1028,28,24,23,75,0.072957198
Clarksburg-Weston,26385,3646,102,89,75,266,0.072956665
Charlotte,28761,8649,241,196,194,631,0.072956411
Chicago,60420,4496,104,108,116,328,0.072953737
Dothan,36343,1453,41,35,30,106,0.072952512
Burlington-Plattsburgh,3585,2673,63,71,61,195,0.07295174
Kansas City,65349,2303,73,53,42,168,0.072948328
Hartford & New Haven,6777,1741,38,48,41,127,0.072946582
Johnstown-Altoona-St Colge,16875,4003,123,90,79,292,0.072945291
Wichita-Hutchinson Plus,67004,754,26,12,17,55,0.072944297
Milwaukee,53024,18686,513,438,412,1363,0.07294231
Buffalo,14717,850,21,22,19,62,0.072941176
Memphis,72366,1700,44,51,29,124,0.072941176
Cleveland-Akron (Canton),44060,60024,1482,1449,1447,4378,0.072937492
Phoenix (Prescott),85131,16960,405,455,377,1237,0.072936321
New York,12564,7212,184,184,158,526,0.072933999
San Francisco-Oak-San Jose,95490,14123,337,356,337,1030,0.07293068
Portland-Auburn,4270,6184,180,137,134,451,0.072930142
Bangor,4668,1714,44,38,43,125,0.072928821
Sioux City,51360,8584,198,218,210,626,0.072926375
Columbia-Jefferson City,65049,7268,214,170,146,530,0.0729224
"Albany, GA",31795,2057,52,54,44,150,0.072921731
Harrisburg-Lncstr-Leb-York,17407,2400,77,50,48,175,0.072916667
Charleston-Huntington,25203,96,2,3,2,7,0.072916667
Youngstown,43932,864,23,20,20,63,0.072916667
Toledo,44804,1152,32,28,24,84,0.072916667
Indianapolis,47997,96,2,2,3,7,0.072916667
Cedar Rapids-Wtrlo-IWC&Dub,52042,1824,53,44,36,133,0.072916667
Minneapolis-St. Paul,56225,768,23,17,16,56,0.072916667
Fargo,58497,384,12,9,7,28,0.072916667
Bismarck-Mnt-Dcknsn(Wlstn),59211,192,6,4,4,14,0.072916667
Great Falls,59443,864,25,21,17,63,0.072916667
St. Louis,62875,1152,29,27,28,84,0.072916667
St. Louis,63625,480,16,12,7,35,0.072916667
Philadelphia,19555,3511,90,81,85,256,0.0729137
Tallahassee-Thomasville,32008,5939,162,149,122,433,0.072907897
Boston (Manchester),1907,15170,419,385,302,1106,0.072907053
Charleston-Huntington,41180,1015,24,26,24,74,0.072906404
Oklahoma City,74832,1015,21,26,27,74,0.072906404
Boston (Manchester),1462,12043,349,278,251,878,0.072905422
Pittsburgh,16259,1742,47,38,42,127,0.072904707
Baltimore,21146,26816,894,635,426,1955,0.072904236
Traverse City-Cadillac,49684,22825,574,529,561,1664,0.072902519
New York,10546,1454,49,34,23,106,0.072902338
Wichita Falls & Lawton,76251,727,24,15,14,53,0.072902338
Tallahassee-Thomasville,32324,4705,103,122,118,343,0.072901169
Harrisonburg,22846,2428,70,61,46,177,0.072899506
Binghamton,13843,1701,41,38,45,124,0.072898295
Austin,78638,2771,74,70,58,202,0.072897871
Los Angeles,90290,6475,159,170,143,472,0.072895753
Miami-Ft. Lauderdale,33013,30031,692,743,754,2189,0.072891346
Minneapolis-St. Paul,55011,10701,316,264,200,780,0.072890384
Buffalo,14131,5680,138,142,134,414,0.072887324
Minneapolis-St. Paul,56441,3526,88,81,88,257,0.072887124
Watertown,13325,1029,23,21,31,75,0.072886297
Joplin-Pittsburg,66710,686,24,13,13,50,0.072886297
Las Vegas,89161,343,9,7,9,25,0.072886297
Hartford & New Haven,6057,6476,167,171,134,472,0.072884497
San Diego,92024,51248,1346,1260,1129,3735,0.072880893
Pittsburgh,15480,2072,62,42,47,151,0.072876448
"Columbia, SC",29163,1482,37,37,34,108,0.072874494
Minneapolis-St. Paul,56113,247,11,4,3,18,0.072874494
Chicago,60917,494,15,12,9,36,0.072874494
Houston,78946,988,31,20,21,72,0.072874494
Denver,80824,247,8,4,6,18,0.072874494
Denver,82327,741,29,8,17,54,0.072874494
Detroit,48428,4858,123,120,111,354,0.072869494
Oklahoma City,74852,1537,44,36,32,112,0.072869226
Boston (Manchester),3062,29107,671,697,753,2121,0.072869069
Sioux City,51012,6450,185,135,150,470,0.072868217
"Rochester, NY",14450,41733,1055,1017,969,3041,0.072867994
San Francisco-Oak-San Jose,94939,7397,213,185,141,539,0.072867379
Pittsburgh,15312,3431,76,86,88,250,0.072865054
Syracuse,13082,4227,101,103,104,308,0.072864916
Great Falls,59468,796,23,19,16,58,0.072864322
St. Louis,62236,14040,382,324,317,1023,0.072863248
Greensboro-H.Point-W.Salem,24053,2347,65,52,54,171,0.072858969
Flint-Saginaw-Bay City,48470,700,18,18,15,51,0.072857143
West Palm Beach-Ft. Pierce,33498,14783,461,344,272,1077,0.072853954
"Columbus, OH",43046,2965,86,61,69,216,0.072849916
Seattle-Tacoma,98370,34112,953,808,724,2485,0.072848265
Atlanta,30177,453,12,12,9,33,0.072847682
Minneapolis-St. Paul,55046,6644,207,134,143,484,0.072847682
Paducah-Cape Girard-Harsbg,63770,151,5,3,3,11,0.072847682
Minneapolis-St. Paul,56208,2018,67,49,31,147,0.0728444
Philadelphia,19342,19425,519,489,407,1415,0.072844273
Champaign&Sprngfld-Decatur,62520,1414,37,32,34,103,0.072842999
Denver,80106,4654,153,98,88,339,0.072840567
Kansas City,64020,3693,97,80,92,269,0.072840509
Syracuse,13054,1771,44,41,44,129,0.072840203
Mobile-Pensacola (Ft Walt),32564,3295,102,69,69,240,0.072837633
Butte-Bozeman,59730,2485,56,54,71,181,0.072837022
Toledo,49220,2334,62,55,53,170,0.072836332
Orlando-Daytona Bch-Melbrn,34739,1016,21,26,27,74,0.072834646
New York,7421,7977,195,206,180,581,0.072834399
"Portland, OR",98645,1579,46,38,31,115,0.072830906
Tallahassee-Thomasville,32060,22491,643,522,473,1638,0.072829132
Los Angeles,91042,27586,608,653,748,2009,0.072826796
Duluth-Superior,55792,9351,223,244,214,681,0.072826436
Dallas-Ft. Worth,75144,3529,104,87,66,257,0.072825163
Roanoke-Lynchburg,24175,7992,233,203,146,582,0.072822823
Chicago,60124,26751,834,616,498,1948,0.072819708
Roanoke-Lynchburg,24555,2005,48,45,53,146,0.072817955
Sherman-Ada,73437,206,6,5,4,15,0.072815534
Houston,75847,1442,41,33,31,105,0.072815534
Albuquerque-Santa Fe,87004,10891,297,271,225,793,0.072812414
Santabarbra-Sanmar-Sanluob,93105,25230,505,609,723,1837,0.072810147
New York,10607,8777,195,227,217,639,0.072803919
Hartford & New Haven,6473,24889,584,602,626,1812,0.072803246
Orlando-Daytona Bch-Melbrn,32757,34243,860,842,791,2493,0.072803201
Bangor,4973,1456,34,39,33,106,0.072802198
Ottumwa-Kirksville,52563,1456,42,29,35,106,0.072802198
Chattanooga,37396,261,7,6,6,19,0.072796935
"Columbus, GA (Opelika, AL)",39867,261,7,6,6,19,0.072796935
Charleston-Huntington,26601,3764,104,86,84,274,0.072794899
Tulsa,74022,1621,46,37,35,118,0.072794571
Baltimore,21154,6704,187,165,136,488,0.072792363
New York,12419,577,13,14,15,42,0.072790295
Champaign&Sprngfld-Decatur,62554,1525,42,37,32,111,0.072786885
Rapid City,57763,316,10,8,5,23,0.07278481
Abilene-Sweetwater,79565,316,8,9,6,23,0.07278481
Pittsburgh,15106,19386,388,487,536,1411,0.072784484
Portland-Auburn,4553,2006,63,43,40,146,0.072781655
Lubbock,79329,3380,106,77,63,246,0.072781065
Charlottesville,22738,1429,43,31,30,104,0.072778167
Seattle-Tacoma,98008,26918,691,658,610,1959,0.072776581
"Rochester, NY",14622,11996,281,249,343,873,0.072774258
"Jackson, TN",38321,2762,79,60,62,201,0.072773353
New York,10533,7819,216,188,165,569,0.072771454
Seattle-Tacoma,98323,852,27,15,20,62,0.072769953
Medford-Klamath Falls,97632,1333,39,31,27,97,0.072768192
Wausau-Rhinelander,54501,20710,487,518,502,1507,0.072766779
Dallas-Ft. Worth,75494,12176,355,273,258,886,0.072766097
Charleston-Huntington,41669,481,13,12,10,35,0.072765073
Chicago,60142,30523,915,769,537,2221,0.0727648
Chicago,60089,42920,1304,1023,796,3123,0.072763281
Jonesboro,72434,2034,58,49,41,148,0.072763029
"Washington, DC (Hagrstwn)",22315,28711,732,654,703,2089,0.07275957
Boston (Manchester),3885,7889,244,198,132,574,0.072759539
Kansas City,65323,1127,34,28,20,82,0.072759539
Bismarck-Mnt-Dcknsn(Wlstn),58571,591,24,11,8,43,0.072758037
Wheeling-Steubenville,26456,3120,87,71,69,227,0.07275641
Cincinnati,47040,5168,139,121,116,376,0.072755418
Oklahoma City,73840,646,20,16,11,47,0.072755418
Indianapolis,47960,15051,391,340,364,1095,0.072752641
Milwaukee,53045,23862,738,567,431,1736,0.072751655
Roanoke-Lynchburg,24473,756,18,24,13,55,0.072751323
Sioux City,68715,1622,51,34,33,118,0.072749692
Minneapolis-St. Paul,56378,8165,232,181,181,594,0.072749541
Norfolk-Portsmth-Newpt Nws,23487,6722,203,150,136,489,0.072746206
"Portland, OR",97002,5650,152,142,117,411,0.072743363
Burlington-Plattsburgh,5836,1141,31,26,26,83,0.072743208
Oklahoma City,73062,1141,32,29,22,83,0.072743208
"Springfield, MO",65656,4743,129,111,105,345,0.072738773
Dallas-Ft. Worth,75156,15866,400,380,374,1154,0.072734148
Boston (Manchester),1501,17296,468,395,395,1258,0.07273358
Panama City,32425,14093,402,335,288,1025,0.072731143
Bangor,4424,825,33,15,12,60,0.072727273
Burlington-Plattsburgh,5868,55,2,1,1,4,0.072727273
New York,11042,55,2,1,1,4,0.072727273
"Washington, DC (Hagrstwn)",17212,605,16,14,14,44,0.072727273
Norfolk-Portsmth-Newpt Nws,23396,55,1,1,2,4,0.072727273
"Washington, DC (Hagrstwn)",26838,55,2,1,1,4,0.072727273
Minneapolis-St. Paul,55036,55,2,1,1,4,0.072727273
Sioux Falls(Mitchell),57041,110,4,2,2,8,0.072727273
Sioux Falls(Mitchell),57255,385,11,8,9,28,0.072727273
Sioux Falls(Mitchell),57457,110,2,3,3,8,0.072727273
Sioux Falls(Mitchell),57473,110,3,2,3,8,0.072727273
Rapid City,57553,220,7,4,5,16,0.072727273
Paducah-Cape Girard-Harsbg,62865,1815,44,51,37,132,0.072727273
St. Louis,63061,165,4,4,4,12,0.072727273
Paducah-Cape Girard-Harsbg,63950,55,2,1,1,4,0.072727273
Shreveport,74724,165,4,4,4,12,0.072727273
Rapid City,82844,55,2,1,1,4,0.072727273
"Portland, OR",97064,3864,106,95,80,281,0.072722567
Madison,53574,4043,145,85,64,294,0.072718279
"Portland, OR",97023,13078,366,286,299,951,0.072717541
"Jackson, TN",38357,2888,82,72,56,210,0.072714681
Orlando-Daytona Bch-Melbrn,32130,5446,145,136,115,396,0.072713918
Spokane,99026,9902,292,240,188,720,0.072712583
Albany-Schenectady-Troy,1226,6189,158,157,135,450,0.072709646
Boston (Manchester),3054,28236,732,705,616,2053,0.072708599
Huntsville-Decatur (Flor),35975,949,25,21,23,69,0.072708114
San Francisco-Oak-San Jose,95425,10728,277,250,253,780,0.072706935
Ft. Smith-Fay-Sprngdl-Rgrs,72714,15102,460,330,308,1098,0.072705602
Binghamton,13802,784,22,20,15,57,0.072704082
Hartford & New Haven,6410,27991,838,671,526,2035,0.07270194
Clarksburg-Weston,26372,674,18,14,17,49,0.072700297
Ottumwa-Kirksville,65247,674,16,14,19,49,0.072700297
Columbia-Jefferson City,65082,1238,34,29,27,90,0.0726979
Dayton,45430,7717,210,152,199,561,0.072696644
Beaumont-Port Arthur,77705,38243,992,920,868,2780,0.072693042
Grand Rapids-Kalmzoo-B.Crk,49046,6727,182,161,146,489,0.072692136
Kansas City,64070,4072,135,97,64,296,0.072691552
Joplin-Pittsburg,66735,509,14,12,11,37,0.072691552
Traverse City-Cadillac,49637,3632,94,86,84,264,0.072687225
Baltimore,21601,24489,626,624,530,1780,0.072685696
Richmond-Petersburg,23236,28273,757,688,610,2055,0.072684186
Portland-Auburn,4220,3247,101,68,67,236,0.072682476
Albany-Schenectady-Troy,12832,6618,164,144,173,481,0.072680568
New York,11514,4747,118,112,115,345,0.072677481
Sioux Falls(Mitchell),57273,1032,33,25,17,75,0.072674419
Paducah-Cape Girard-Harsbg,63787,1032,31,24,20,75,0.072674419
Richmond-Petersburg,23921,2587,78,50,60,188,0.072671048
Toledo,43548,633,21,15,10,46,0.072669826
Chico-Redding,95938,3798,104,97,75,276,0.072669826
Youngstown,44438,4665,108,111,120,339,0.07266881
Sioux Falls(Mitchell),57059,1211,33,29,26,88,0.072667217
Cedar Rapids-Wtrlo-IWC&Dub,52050,578,17,13,12,42,0.07266436
Sioux Falls(Mitchell),51241,1968,64,48,31,143,0.072662602
Buffalo,14711,1679,50,34,38,122,0.072662299
Springfield-Holyoke,1028,16433,455,383,356,1194,0.072658675
Monroe-El Dorado,71473,523,14,14,10,38,0.072657744
Rochestr-Mason City-Austin,55991,1280,36,27,30,93,0.07265625
"Jackson, TN",38341,2161,69,51,37,157,0.07265155
Wilmington,28439,1170,28,26,31,85,0.072649573
Baton Rouge,39633,936,27,22,19,68,0.072649573
Des Moines-Ames,50051,234,7,4,6,17,0.072649573
Fargo,58030,702,22,18,11,51,0.072649573
Bismarck-Mnt-Dcknsn(Wlstn),58830,234,8,5,4,17,0.072649573
Baltimore,21635,1996,45,46,54,145,0.072645291
Macon,31009,1473,45,29,33,107,0.072640869
Charlottesville,22972,413,11,9,10,30,0.072639225
Omaha,68621,413,14,9,7,30,0.072639225
Sherman-Ada,74733,2657,71,57,65,193,0.072638314
Boston (Manchester),3246,17636,414,433,434,1281,0.072635518
Minneapolis-St. Paul,55332,1776,45,53,31,129,0.072635135
Milwaukee,53051,38907,1039,915,872,2826,0.072634744
Peoria-Bloomington,61427,2134,51,62,42,155,0.072633552
Dayton,45502,17045,480,420,338,1238,0.07263127
Clarksburg-Weston,26362,2740,75,67,57,199,0.072627737
"Tri-Cities, TN-VA",37617,14237,364,347,323,1034,0.07262766
Burlington-Plattsburgh,5447,179,5,5,3,13,0.072625698
Salisbury,21822,2864,80,62,66,208,0.072625698
"Jackson, TN",38236,716,22,17,13,52,0.072625698
Madison,53507,2355,75,57,39,171,0.072611465
Madison,54618,2479,73,51,56,180,0.072609923
Wichita-Hutchinson Plus,67752,1391,42,28,31,101,0.072609633
Greenvll-Spart-Ashevll-And,29335,5812,149,133,140,422,0.072608396
Tampa-St. Pete (Sarasota),33710,33013,750,763,884,2397,0.072607761
Sioux Falls(Mitchell),57479,606,21,13,10,44,0.072607261
Chicago,61334,606,17,12,15,44,0.072607261
Wausau-Rhinelander,54520,4132,118,95,87,300,0.072604066
New York,7422,6625,179,149,153,481,0.072603774
Dallas-Ft. Worth,76048,28415,746,674,643,2063,0.072602499
Flint-Saginaw-Bay City,48413,7011,184,160,165,509,0.0726002
Wilkes Barre-Scranton-Hztn,18854,1281,34,28,31,93,0.072599532
Sioux Falls(Mitchell),56139,427,15,9,7,31,0.072599532
Wichita-Hutchinson Plus,67753,427,14,8,9,31,0.072599532
Oklahoma City,73762,2507,70,65,47,182,0.072596729
Des Moines-Ames,51443,1777,52,35,42,129,0.07259426
Baltimore,21619,7356,195,179,160,534,0.072593801
"Lafayette, IN",47948,1226,42,24,23,89,0.072593801
Seattle-Tacoma,98407,23502,510,541,655,1706,0.072589567
Burlington-Plattsburgh,3741,4188,110,86,108,304,0.072588348
Paducah-Cape Girard-Harsbg,63956,1047,32,25,19,76,0.072588348
Pittsburgh,15557,3513,86,85,84,255,0.072587532
Charlotte,28125,2783,74,61,67,202,0.072583543
Greenvll-Spart-Ashevll-And,28732,19647,546,471,409,1426,0.072581056
Syracuse,14860,1116,36,21,24,81,0.072580645
Glendive,59315,124,3,4,2,9,0.072580645
Denver,80740,124,3,3,3,9,0.072580645
Columbia-Jefferson City,65065,6710,142,168,177,487,0.072578241
West Palm Beach-Ft. Pierce,33410,37092,817,895,980,2692,0.072576297
Minneapolis-St. Paul,56339,1061,36,20,21,77,0.072573044
Columbus-Tupelo-West Point,39769,1750,41,41,45,127,0.072571429
Baltimore,21155,2439,66,64,47,177,0.072570726
New York,10588,2315,58,61,49,168,0.072570194
Lincoln & Hastings-Krny,68763,4823,134,100,116,350,0.07256894
Cleveland-Akron (Canton),44846,3321,77,90,74,241,0.072568503
Cleveland-Akron (Canton),44215,2260,62,56,46,164,0.072566372
Indianapolis,46181,5292,158,114,112,384,0.072562358
Wichita Falls & Lawton,73442,441,13,11,8,32,0.072562358
Tallahassee-Thomasville,32309,30430,923,706,579,2208,0.072559974
Pittsburgh,16201,17048,437,394,406,1237,0.072559831
Greenwood-Greenville,38950,317,8,8,7,23,0.072555205
Wichita-Hutchinson Plus,67520,317,8,7,8,23,0.072555205
Yakima-Pasco-Rchlnd-Knnwck,98937,3680,102,85,80,267,0.072554348
Rochestr-Mason City-Austin,50450,2922,78,81,53,212,0.072553046
Houston,78956,5279,150,128,105,383,0.07255162
Joplin-Pittsburg,66776,1337,38,24,35,97,0.072550486
Harrisburg-Lncstr-Leb-York,17408,25734,622,610,635,1867,0.072549934
Hartford & New Haven,6073,5417,156,160,77,393,0.072549382
Wilkes Barre-Scranton-Hztn,18635,4783,117,116,114,347,0.07254861
Providence-New Bedford,2889,28395,660,629,771,2060,0.072547984
Harrisburg-Lncstr-Leb-York,17035,703,19,18,14,51,0.07254623
Austin,78963,896,23,23,19,65,0.072544643
St. Louis,62097,2633,81,68,42,191,0.072540828
Burlington-Plattsburgh,5904,193,6,5,3,14,0.07253886
Cedar Rapids-Wtrlo-IWC&Dub,52334,386,10,9,9,28,0.07253886
Sioux City,68789,193,6,4,4,14,0.07253886
Oklahoma City,73744,193,6,3,5,14,0.07253886
Providence-New Bedford,2726,15716,451,353,336,1140,0.072537541
Portland-Auburn,4355,2578,84,63,40,187,0.07253685
"Washington, DC (Hagrstwn)",22469,2068,57,43,50,150,0.072533849
Providence-New Bedford,2865,18792,476,456,431,1363,0.072530864
New York,10560,5184,140,134,102,376,0.072530864
Pittsburgh,15671,648,18,15,14,47,0.072530864
Charleston-Huntington,25555,1944,52,46,43,141,0.072530864
Wheeling-Steubenville,43779,910,25,21,20,66,0.072527473
New York,10804,14630,426,380,255,1061,0.072522215
Harrisburg-Lncstr-Leb-York,17307,6343,178,142,140,460,0.072520889
Wheeling-Steubenville,43947,4840,110,121,120,351,0.072520661
Madison,53961,786,25,16,16,57,0.072519084
Sioux Falls(Mitchell),57239,262,8,6,5,19,0.072519084
Eureka,95565,855,28,21,13,62,0.07251462
Wilkes Barre-Scranton-Hztn,18421,4634,115,119,102,336,0.072507553
Rochestr-Mason City-Austin,50455,331,10,8,6,24,0.072507553
Cedar Rapids-Wtrlo-IWC&Dub,50611,331,10,6,8,24,0.072507553
Toledo,43412,4124,118,89,92,299,0.072502425
Omaha,68142,6124,162,135,147,444,0.072501633
Spokane,98851,4593,126,107,100,333,0.072501633
Dallas-Ft. Worth,76126,29434,836,651,647,2134,0.072501189
Chicago,60196,800,22,20,16,58,0.0725
Portland-Auburn,4259,3269,88,76,73,237,0.072499235
Charleston-Huntington,26136,469,13,11,10,34,0.07249467
St. Joseph,64421,938,22,27,19,68,0.07249467
Roanoke-Lynchburg,24426,13629,335,333,320,988,0.072492479
"Tri-Cities, TN-VA",24220,538,18,11,10,39,0.072490706
Terre Haute,47453,607,17,15,12,44,0.072487644
Charleston-Huntington,41512,745,21,17,16,54,0.072483221
Minneapolis-St. Paul,55009,8485,238,183,194,615,0.072480849
Tampa-St. Pete (Sarasota),33870,24379,609,589,569,1767,0.072480413
Knoxville,38504,883,24,18,22,64,0.072480181
Nashville,38545,1090,33,24,22,79,0.072477064
Evansville,47639,4512,132,106,89,327,0.072473404
Philadelphia,19317,10487,300,270,190,760,0.072470678
Charleston-Huntington,41222,2401,70,52,52,174,0.072469804
"Washington, DC (Hagrstwn)",22824,6251,182,141,130,453,0.072468405
Wilkes Barre-Scranton-Hztn,17777,6955,187,159,158,504,0.072465852
Johnstown-Altoona-St Colge,15931,8956,209,228,212,649,0.072465386
Wilkes Barre-Scranton-Hztn,18628,276,13,3,4,20,0.072463768
Richmond-Petersburg,24553,1449,34,33,38,105,0.072463768
Charleston-Huntington,25160,276,8,6,6,20,0.072463768
Tallahassee-Thomasville,32096,2967,71,72,72,215,0.072463768
Dothan,36370,897,21,22,22,65,0.072463768
Chattanooga,37340,483,12,12,11,35,0.072463768
Nashville,38459,552,15,12,13,40,0.072463768
Des Moines-Ames,50520,207,7,4,4,15,0.072463768
Wichita-Hutchinson Plus,67475,207,7,4,4,15,0.072463768
Wichita-Hutchinson Plus,67747,138,3,3,4,10,0.072463768
Lincoln & Hastings-Krny,69046,207,6,5,4,15,0.072463768
Amarillo,79101,2553,56,62,67,185,0.072463768
Los Angeles,92342,6900,191,159,150,500,0.072463768
"Portland, OR",99322,276,10,5,5,20,0.072463768
La Crosse-Eau Claire,54466,2774,82,64,55,201,0.072458544
Greenville-N.Bern-Washngtn,28444,1946,55,39,47,141,0.072456321
Sioux Falls(Mitchell),57077,1532,47,35,29,111,0.072454308
Sioux Falls(Mitchell),57532,2857,89,66,52,207,0.072453623
Montgomery-Selma,36046,1256,37,30,24,91,0.072452229
Milwaukee,53946,4541,128,112,89,329,0.072451002
Topeka,66546,980,30,24,17,71,0.07244898
Charleston-Huntington,25234,911,22,27,17,66,0.072447859
Portland-Auburn,3582,2250,62,51,50,163,0.072444444
Topeka,66537,1408,32,40,30,102,0.072443182
Ft. Smith-Fay-Sprngdl-Rgrs,72718,6557,212,134,129,475,0.072441665
Little Rock-Pine Bluff,72629,635,19,16,11,46,0.072440945
Ft. Smith-Fay-Sprngdl-Rgrs,74563,1836,51,47,35,133,0.072440087
"Columbus, GA (Opelika, AL)",31830,2126,56,51,47,154,0.0724365
Omaha,51573,1063,30,25,22,77,0.0724365
Duluth-Superior,55810,8504,232,200,184,616,0.0724365
Burlington-Plattsburgh,12992,4183,112,89,102,303,0.072436051
Detroit,48070,6171,203,160,84,447,0.072435586
Baltimore,21132,3051,77,76,68,221,0.072435267
Harrisburg-Lncstr-Leb-York,17316,8518,228,197,192,617,0.072434844
Ft. Wayne,46759,497,15,10,11,36,0.072434608
New York,7081,17202,413,380,453,1246,0.072433438
Spokane,83864,22186,603,535,469,1607,0.072433066
St. Louis,62275,3272,88,76,73,237,0.072432763
Atlanta,30525,9057,246,208,202,656,0.072430165
Minneapolis-St. Paul,55037,5136,145,126,101,372,0.072429907
Syracuse,13066,13061,363,314,269,946,0.07242937
Clarksburg-Weston,26347,2071,56,50,44,150,0.072428778
Boston (Manchester),2072,29009,696,699,706,2101,0.072425799
Charlotte,29067,10259,255,253,235,743,0.072424213
Wheeling-Steubenville,43718,3231,91,67,76,234,0.072423398
Minneapolis-St. Paul,56626,359,9,6,11,26,0.072423398
St. Louis,62217,718,13,16,23,52,0.072423398
Marquette,49837,9928,268,231,220,719,0.072421434
Burlington-Plattsburgh,5360,649,17,16,14,47,0.072419106
"Charleston, SC",29018,3038,78,74,68,220,0.072416063
Des Moines-Ames,50066,290,8,7,6,21,0.072413793
Cedar Rapids-Wtrlo-IWC&Dub,52236,580,16,13,13,42,0.072413793
Davenport-R.Island-Moline,61474,290,7,7,7,21,0.072413793
Oklahoma City,74826,1160,36,25,23,84,0.072413793
Champaign&Sprngfld-Decatur,62501,2251,54,53,56,163,0.072412261
Boston (Manchester),1432,8507,178,199,239,616,0.072410956
Providence-New Bedford,2804,2983,82,74,60,216,0.072410325
Marquette,49834,511,16,11,10,37,0.072407045
Johnstown-Altoona-St Colge,15905,19432,469,474,464,1407,0.07240634
Roanoke-Lynchburg,22969,1243,32,30,28,90,0.072405471
Johnstown-Altoona-St Colge,16839,732,20,15,18,53,0.072404372
Traverse City-Cadillac,49618,732,19,16,18,53,0.072404372
Milwaukee,53017,5856,180,136,108,424,0.072404372
Rochestr-Mason City-Austin,55926,732,21,15,17,53,0.072404372
Tallahassee-Thomasville,39825,1326,34,28,34,96,0.07239819
Lexington,40445,663,17,15,16,48,0.07239819
Johnstown-Altoona-St Colge,16858,4130,105,90,104,299,0.072397094
Wheeling-Steubenville,43963,1257,28,33,30,91,0.07239459
Indianapolis,46932,3039,85,75,60,220,0.072392234
Quincy-Hannibal-Keokuk,62316,594,18,14,11,43,0.072390572
Oklahoma City,73627,594,18,14,11,43,0.072390572
Rapid City,57754,3716,109,89,71,269,0.072389666
"Springfield, MO",72687,6990,203,158,145,506,0.072389127
Nashville,38547,2238,61,56,45,162,0.072386059
Dayton,45339,1492,56,25,27,108,0.072386059
Tulsa,74561,2100,50,54,48,152,0.072380952
Cedar Rapids-Wtrlo-IWC&Dub,52205,8856,238,200,203,641,0.072380307
Pittsburgh,15670,3454,83,76,91,250,0.072379849
Davenport-R.Island-Moline,52745,677,22,15,12,49,0.072378139
Baltimore,21655,4684,147,103,89,339,0.072374039
Baltimore,21673,3261,93,66,77,236,0.072370439
Elmira (Corning),14865,2736,67,61,70,198,0.072368421
"Jackson, TN",38392,760,19,20,16,55,0.072368421
Cedar Rapids-Wtrlo-IWC&Dub,50605,152,5,3,3,11,0.072368421
Lincoln & Hastings-Krny,68734,152,3,3,5,11,0.072368421
Shreveport,71822,8043,210,189,183,582,0.072361059
Greenvll-Spart-Ashevll-And,28716,17510,441,406,420,1267,0.072358652
Toledo,43465,5252,115,123,142,380,0.072353389
Chicago,60068,37829,1136,906,695,2737,0.072351899
Little Rock-Pine Bluff,72179,387,12,10,6,28,0.072351421
Yakima-Pasco-Rchlnd-Knnwck,97836,2018,56,43,47,146,0.07234886
Pittsburgh,16226,8114,201,183,203,587,0.072344097
Baltimore,21104,5626,182,130,95,407,0.072342695
Minneapolis-St. Paul,56293,1175,33,26,26,85,0.072340426
Lincoln & Hastings-Krny,68742,235,8,5,4,17,0.072340426
"Washington, DC (Hagrstwn)",21782,3857,106,86,87,279,0.072336012
Albany-Schenectady-Troy,12170,5198,139,129,108,376,0.072335514
Burlington-Plattsburgh,5859,2129,56,50,48,154,0.072334429
Pittsburgh,15765,1659,49,37,34,120,0.072332731
Sioux Falls(Mitchell),57632,553,18,9,13,40,0.072332731
Spokane,83835,25134,773,556,489,1818,0.072332299
Evansville,42436,1189,41,23,22,86,0.072329689
Charleston-Huntington,25565,636,20,13,13,46,0.072327044
Shreveport,71853,318,9,5,9,23,0.072327044
St. Louis,63357,5890,173,137,116,426,0.072325976
"Springfield, MO",65440,401,13,9,7,29,0.072319202
Houston,78932,802,25,20,13,58,0.072319202
Tampa-St. Pete (Sarasota),34677,22470,559,539,527,1625,0.072318647
Champaign&Sprngfld-Decatur,62548,2171,52,45,60,157,0.072316905
Milwaukee,53013,3305,90,73,76,239,0.072314675
Great Falls,59483,484,14,12,9,35,0.07231405
Cedar Rapids-Wtrlo-IWC&Dub,50638,3471,96,68,87,251,0.072313454
"Columbus, OH",43001,2752,74,59,66,199,0.072311047
Watertown,13621,567,16,11,14,41,0.072310406
Hartford & New Haven,6413,13124,328,311,310,949,0.072310271
Greensboro-H.Point-W.Salem,27050,3983,111,85,92,288,0.072307306
Wilmington,28430,1549,46,32,34,112,0.072304713
Denver,80107,15739,488,369,281,1138,0.072304467
Austin,78947,5145,158,121,93,372,0.072303207
Amarillo,79057,899,22,27,16,65,0.072302558
Yakima-Pasco-Rchlnd-Knnwck,99326,5657,169,136,104,409,0.072299806
Providence-New Bedford,2743,10581,286,240,239,765,0.072299405
Seattle-Tacoma,98240,3306,94,78,67,239,0.072292801
Memphis,38132,83,2,2,2,6,0.072289157
Charleston-Huntington,41265,1494,42,33,33,108,0.072289157
Louisville,47270,747,23,15,16,54,0.072289157
Sioux City,50576,332,11,7,6,24,0.072289157
Billings,59062,83,2,2,2,6,0.072289157
"Jackson, TN",38329,3334,93,82,66,241,0.072285543
Miami-Ft. Lauderdale,33133,34586,717,779,1004,2500,0.072283583
Portland-Auburn,4074,23491,591,550,557,1698,0.072283002
St. Louis,65535,1425,34,36,33,103,0.072280702
Hartford & New Haven,6016,6212,143,144,162,449,0.072279459
Bangor,4952,2103,70,44,38,152,0.072277699
San Antonio,78163,20864,657,485,366,1508,0.072277607
Davenport-R.Island-Moline,61438,678,19,17,13,49,0.072271386
Charleston-Huntington,25106,595,15,15,13,43,0.072268908
Burlington-Plattsburgh,3765,512,12,14,11,37,0.072265625
Tallahassee-Thomasville,32327,31788,875,766,656,2297,0.072259972
Burlington-Plattsburgh,5654,1204,31,22,34,87,0.072259136
"Springfield, MO",65646,1979,63,42,38,143,0.072258717
Macon,31038,775,23,19,14,56,0.072258065
Denver,80821,1121,30,23,28,81,0.072256913
Colorado Springs-Pueblo,81025,1038,27,28,20,75,0.072254335
La Crosse-Eau Claire,54741,1647,47,35,37,119,0.07225258
Albuquerque-Santa Fe,87015,12678,354,300,262,916,0.072251144
Salisbury,21838,1564,41,36,36,113,0.072250639
Buffalo,14757,3045,77,88,55,220,0.072249589
Duluth-Superior,49911,2436,56,63,57,176,0.072249589
Champaign&Sprngfld-Decatur,62707,7059,197,171,142,510,0.072248194
Denver,80122,32597,912,779,664,2355,0.072245912
Wheeling-Steubenville,26415,3322,75,82,83,240,0.072245635
Philadelphia,18966,37968,1012,912,819,2743,0.072245048
Cedar Rapids-Wtrlo-IWC&Dub,52231,263,10,5,4,19,0.072243346
Davenport-R.Island-Moline,61423,526,14,14,10,38,0.072243346
Corpus Christi,78102,27561,717,660,614,1991,0.072239759
New York,12514,3087,70,81,72,223,0.072238419
Atlanta,30540,20336,582,473,414,1469,0.072236428
Greensboro-H.Point-W.Salem,27053,2921,72,71,68,211,0.072235536
Denver,80516,43303,1486,972,670,3128,0.07223518
Pittsburgh,15337,623,17,14,14,45,0.07223114
"Springfield, MO",72685,1246,29,29,32,90,0.07223114
"Portland, OR",97016,6410,169,165,129,463,0.072230889
"Tri-Cities, TN-VA",37658,4015,103,102,85,290,0.072229141
Hartford & New Haven,6063,3392,94,91,60,245,0.072228774
Clarksburg-Weston,26339,180,5,4,4,13,0.072222222
Wausau-Rhinelander,54430,180,6,3,4,13,0.072222222
"Alexandria, LA",70639,540,18,13,8,39,0.072222222
Oklahoma City,73658,180,6,5,2,13,0.072222222
Medford-Klamath Falls,96013,4154,121,93,86,300,0.072219547
Spokane,99109,5456,176,132,86,394,0.072214076
Cleveland-Akron (Canton),44644,4196,110,104,89,303,0.07221163
Los Angeles,92356,5858,150,143,130,423,0.072208945
St. Louis,63091,1191,34,27,25,86,0.072208228
St. Louis,63628,16314,430,385,363,1178,0.07220792
Huntsville-Decatur (Flor),35616,3961,109,88,89,286,0.072203989
Paducah-Cape Girard-Harsbg,62975,277,8,5,7,20,0.072202166
Oklahoma City,73015,2036,52,48,47,147,0.072200393
St. Louis,62044,1482,45,37,25,107,0.07219973
Tampa-St. Pete (Sarasota),34434,10748,292,231,253,776,0.072199479
Topeka,66860,1205,39,25,23,87,0.07219917
Harrisburg-Lncstr-Leb-York,17222,11857,330,246,280,856,0.072193641
Johnstown-Altoona-St Colge,15935,2618,74,63,52,189,0.072192513
Nashville,38562,6663,182,148,151,481,0.072189704
West Palm Beach-Ft. Pierce,32960,21402,456,530,559,1545,0.072189515
Chattanooga,37391,1690,48,39,35,122,0.072189349
Amarillo,88415,3200,90,74,67,231,0.0721875
San Antonio,78886,471,12,11,11,34,0.072186837
Wheeling-Steubenville,26037,6137,150,130,163,443,0.072185107
St. Louis,62014,3782,91,88,94,273,0.07218403
Cedar Rapids-Wtrlo-IWC&Dub,50642,568,21,12,8,41,0.072183099
Cedar Rapids-Wtrlo-IWC&Dub,52033,3602,98,84,78,260,0.072182121
Burlington-Plattsburgh,5821,1330,46,30,20,96,0.072180451
"Springfield, MO",65466,1330,39,33,24,96,0.072180451
Los Angeles,91201,22168,474,519,607,1600,0.07217611
Denver,80810,956,33,19,17,69,0.072175732
Milwaukee,53177,9200,212,236,216,664,0.072173913
Phoenix (Prescott),85618,1150,26,26,31,83,0.072173913
Minneapolis-St. Paul,54024,5099,138,123,107,368,0.072171014
Charleston-Huntington,26143,3769,117,77,78,272,0.072167684
New York,12736,97,2,2,3,7,0.072164948
Burlington-Plattsburgh,12928,1940,61,40,39,140,0.072164948
"Jackson, TN",38374,1940,51,50,39,140,0.072164948
Minneapolis-St. Paul,56355,582,22,11,9,42,0.072164948
Bismarck-Mnt-Dcknsn(Wlstn),59257,97,3,2,2,7,0.072164948
Paducah-Cape Girard-Harsbg,63849,97,3,2,2,7,0.072164948
St. Louis,65449,388,12,10,6,28,0.072164948
"Springfield, MO",65766,97,2,3,2,7,0.072164948
Oklahoma City,73544,291,9,6,6,21,0.072164948
Spokane,99126,970,29,27,14,70,0.072164948
Tulsa,67333,2633,74,63,53,190,0.072161033
Lincoln & Hastings-Krny,68823,2148,57,52,46,155,0.072160149
Sioux City,57004,3714,119,81,68,268,0.072159397
Baton Rouge,39653,2550,77,55,52,184,0.072156863
Wilkes Barre-Scranton-Hztn,18655,6001,158,148,127,433,0.072154641
Eugene,97456,3354,81,79,82,242,0.072152654
Springfield-Holyoke,1129,6930,175,156,169,500,0.072150072
Des Moines-Ames,50276,2675,81,56,56,193,0.072149533
"Tri-Cities, TN-VA",37869,4962,120,116,122,358,0.072148327
Indianapolis,47994,596,17,14,12,43,0.072147651
Harrisburg-Lncstr-Leb-York,17028,3479,99,83,69,251,0.072147169
Springfield-Holyoke,1301,17854,381,443,464,1288,0.072140697
"Jackson, MS",39156,402,11,9,9,29,0.072139303
"Columbus, GA (Opelika, AL)",31764,1012,23,23,27,73,0.072134387
Wilmington,28420,4464,132,92,98,322,0.072132616
Joplin-Pittsburg,66756,915,25,21,20,66,0.072131148
Little Rock-Pine Bluff,72025,818,24,20,15,59,0.072127139
"Tri-Cities, TN-VA",24319,6253,161,149,141,451,0.07212538
Topeka,66424,513,19,12,6,37,0.072124756
Little Rock-Pine Bluff,72639,513,12,15,10,37,0.072124756
"Columbia, SC",29048,4312,123,97,91,311,0.072124304
Dallas-Ft. Worth,76265,1553,39,43,30,112,0.07211848
"Columbus, OH",43155,2801,69,68,65,202,0.072117101
Bangor,4642,208,6,4,5,15,0.072115385
"Jackson, MS",39162,208,6,6,3,15,0.072115385
Champaign&Sprngfld-Decatur,61773,416,14,9,7,30,0.072115385
Wichita-Hutchinson Plus,66858,416,13,9,8,30,0.072115385
Lincoln & Hastings-Krny,68316,416,13,7,10,30,0.072115385
Waco-Temple-Bryan,76561,1040,25,26,24,75,0.072115385
Clarksburg-Weston,26354,10303,250,242,251,743,0.072114918
Omaha,68007,17972,650,362,284,1296,0.072112174
Boston (Manchester),2717,4923,126,110,119,355,0.072110502
Roanoke-Lynchburg,24066,4715,123,111,106,340,0.072110286
Pittsburgh,15085,8085,226,173,184,583,0.072108844
Champaign&Sprngfld-Decatur,61854,1581,38,31,45,114,0.072106262
Traverse City-Cadillac,49410,1900,56,42,39,137,0.072105263
St. Louis,62067,2330,61,58,49,168,0.072103004
Traverse City-Cadillac,49620,2649,74,54,63,191,0.07210268
"Tri-Cities, TN-VA",24280,638,15,16,15,46,0.072100313
"Springfield, MO",65601,957,29,21,19,69,0.072100313
Johnstown-Altoona-St Colge,15550,1609,54,31,31,116,0.072094469
Champaign&Sprngfld-Decatur,62468,2469,74,53,51,178,0.072093965
Jacksonville,32038,10348,267,252,227,746,0.072091225
Macon,31041,971,24,24,22,70,0.072090628
Evansville,62844,1942,44,48,48,140,0.072090628
Boston (Manchester),2539,5396,118,117,154,389,0.072090437
Flint-Saginaw-Bay City,48734,7241,198,178,146,522,0.07208949
Indianapolis,46928,4564,117,118,94,329,0.07208589
Memphis,72069,652,16,16,15,47,0.07208589
Albuquerque-Santa Fe,87412,652,17,17,13,47,0.07208589
Madison,53801,874,24,18,21,63,0.07208238
Sioux City,51038,1651,47,34,38,119,0.072077529
Des Moines-Ames,50129,4967,142,116,100,358,0.0720757
Greenvll-Spart-Ashevll-And,28753,12085,319,285,267,871,0.072072818
New York,12770,222,6,6,4,16,0.072072072
Madison,53550,1110,29,25,26,80,0.072072072
Monroe-El Dorado,71663,555,17,14,9,40,0.072072072
Oklahoma City,73733,222,7,6,3,16,0.072072072
Salt Lake City,84028,1110,37,24,19,80,0.072072072
Tucson (Sierra Vista),85718,28472,617,711,724,2052,0.072070806
Rockford,61061,6841,186,162,145,493,0.072065488
Minneapolis-St. Paul,55382,3594,112,84,63,259,0.072064552
Evansville,47532,4163,105,96,99,300,0.072063416
San Francisco-Oak-San Jose,94549,28672,953,639,474,2066,0.072056362
Greensboro-H.Point-W.Salem,27027,3983,85,108,94,287,0.072056239
Indianapolis,47949,1138,24,30,28,82,0.072056239
Minneapolis-St. Paul,54730,5593,157,129,117,403,0.072054354
Cincinnati,45039,29589,895,704,533,2132,0.072053804
Toledo,49265,4913,127,110,117,354,0.072053735
Cleveland-Akron (Canton),44003,4233,116,94,95,305,0.072052918
Myrtle Beach-Florence,29581,4011,111,94,84,289,0.072051857
Wilkes Barre-Scranton-Hztn,17754,12894,361,325,243,929,0.072049015
"Jackson, TN",38359,347,9,8,8,25,0.07204611
Raleigh-Durham (Fayetvlle),27507,1624,46,37,34,117,0.072044335
Chico-Redding,96101,5108,157,106,105,368,0.072043853
Paducah-Cape Girard-Harsbg,62817,583,15,16,11,42,0.072041166
Spokane,99158,583,17,12,13,42,0.072041166
Salisbury,21871,1985,51,55,37,143,0.072040302
Fargo,58027,1402,39,24,38,101,0.072039943
Portland-Auburn,4027,6802,195,158,137,490,0.072037636
New York,11747,20240,513,513,432,1458,0.072035573
Johnstown-Altoona-St Colge,16670,236,6,5,6,17,0.072033898
Minneapolis-St. Paul,56226,236,8,5,4,17,0.072033898
Colorado Springs-Pueblo,81006,12272,349,292,243,884,0.072033898
New York,7432,6983,160,188,155,503,0.072032078
Harrisburg-Lncstr-Leb-York,17352,1194,31,30,25,86,0.072026801
Columbia-Jefferson City,63359,1194,33,27,26,86,0.072026801
Pittsburgh,15628,361,12,7,7,26,0.072022161
Wilkes Barre-Scranton-Hztn,18354,1083,30,24,24,78,0.072022161
Nashville,38453,361,10,8,8,26,0.072022161
Baton Rouge,39664,2166,62,52,42,156,0.072022161
Chicago,60531,1805,53,37,40,130,0.072022161
Houston,77356,33962,983,795,668,2446,0.072021671
St. Louis,62237,2416,66,53,55,174,0.072019868
Tampa-St. Pete (Sarasota),34601,24952,558,599,640,1797,0.072018275
Birmingham (Ann and Tusc),35128,11414,304,267,251,822,0.072016821
Cleveland-Akron (Canton),44695,1347,36,32,29,97,0.072011878
St. Louis,63670,11651,295,283,261,839,0.072010986
Baltimore,21666,14109,394,342,280,1016,0.072010773
Minneapolis-St. Paul,56063,2958,78,72,63,213,0.072008114
"Washington, DC (Hagrstwn)",20106,5069,139,105,121,365,0.072006313
San Francisco-Oak-San Jose,95405,21776,542,522,504,1568,0.072005878
Eugene,97479,10555,281,229,250,760,0.07200379
Pittsburgh,15620,500,16,11,9,36,0.072
Nashville,38541,1500,35,37,36,108,0.072
Columbia-Jefferson City,65285,625,17,13,15,45,0.072
St. Joseph,66017,250,8,5,5,18,0.072
Wichita-Hutchinson Plus,67552,625,20,13,12,45,0.072
Lincoln & Hastings-Krny,68952,125,3,2,4,9,0.072
Champaign&Sprngfld-Decatur,62568,16431,428,356,399,1183,0.071998052
Buffalo,14047,6292,141,149,163,453,0.071996186
Boston (Manchester),2066,19029,576,450,344,1370,0.071995375
Dothan,36318,1514,41,36,32,109,0.071994716
Cleveland-Akron (Canton),43840,1014,29,22,22,73,0.07199211
Green Bay-Appleton,54169,3195,92,77,61,230,0.07198748
"Lafayette, LA",71463,9613,242,229,221,692,0.071985852
Bismarck-Mnt-Dcknsn(Wlstn),58366,903,30,21,14,65,0.071982281
Monroe-El Dorado,71435,4001,111,113,64,288,0.071982004
Bangor,4680,1167,31,23,30,84,0.071979434
Johnstown-Altoona-St Colge,16613,1556,46,33,33,112,0.071979434
Butte-Bozeman,59832,778,23,13,20,56,0.071979434
Chicago,60631,28009,733,633,650,2016,0.071976865
Albany-Schenectady-Troy,12187,653,19,13,15,47,0.071975498
Lincoln & Hastings-Krny,68401,653,24,12,11,47,0.071975498
Buffalo,14028,2098,65,49,37,151,0.071973308
Cedar Rapids-Wtrlo-IWC&Dub,52338,3543,101,94,60,255,0.071972904
Phoenix (Prescott),86401,29970,824,632,701,2157,0.071971972
"Washington, DC (Hagrstwn)",20754,7100,203,180,128,511,0.071971831
Champaign&Sprngfld-Decatur,62447,3029,84,62,72,218,0.071970948
Buffalo,14782,2376,58,61,52,171,0.071969697
Roanoke-Lynchburg,24578,1056,27,26,23,76,0.071969697
Des Moines-Ames,50232,528,14,13,11,38,0.071969697
Monroe-El Dorado,71676,528,11,14,13,38,0.071969697
Pittsburgh,16033,7142,186,170,158,514,0.071968636
Roanoke-Lynchburg,24571,1459,39,35,31,105,0.071967101
Cedar Rapids-Wtrlo-IWC&Dub,52147,931,27,16,24,67,0.071965628
Grand Rapids-Kalmzoo-B.Crk,49055,5989,162,140,129,431,0.07196527
Tulsa,74426,9463,236,233,212,681,0.071964493
Sioux Falls(Mitchell),57276,1334,35,34,27,96,0.071964018
Oklahoma City,73735,667,25,9,14,48,0.071964018
Boston (Manchester),3869,2543,57,60,66,183,0.071962249
Rochestr-Mason City-Austin,52136,5948,166,133,129,428,0.07195696
Clarksburg-Weston,26384,542,14,13,12,39,0.07195572
Jonesboro,72456,542,17,11,11,39,0.07195572
"Columbus, OH",43028,8297,245,199,153,597,0.071953718
Detroit,48096,3947,101,97,86,284,0.071953382
Milwaukee,53078,1779,54,44,30,128,0.071950534
Seattle-Tacoma,98021,35900,980,770,833,2583,0.071949861
Syracuse,13042,2335,75,49,44,168,0.071948608
"Columbia, SC",29142,4406,104,109,104,317,0.071947345
Chattanooga,37381,9563,250,230,208,688,0.071943951
Boston (Manchester),1745,139,4,3,3,10,0.071942446
Pittsburgh,16253,139,3,3,4,10,0.071942446
Youngstown,44404,1668,41,39,40,120,0.071942446
Sioux City,51060,556,11,15,14,40,0.071942446
Columbia-Jefferson City,65067,417,10,12,8,30,0.071942446
Lincoln & Hastings-Krny,69022,1251,33,23,34,90,0.071942446
Shreveport,71007,834,19,25,16,60,0.071942446
Spokane,83870,278,9,6,5,20,0.071942446
Seattle-Tacoma,98538,417,9,12,9,30,0.071942446
New York,11803,29247,858,670,576,2104,0.071939002
Wichita Falls & Lawton,76380,3503,91,82,79,252,0.071938339
"Tri-Cities, TN-VA",24244,5185,130,120,123,373,0.071938284
"Portland, OR",97267,31958,777,766,756,2299,0.071938169
Sioux Falls(Mitchell),57234,1265,36,29,26,91,0.071936759
Mobile-Pensacola (Ft Walt),36033,3392,72,73,99,244,0.071933962
Cedar Rapids-Wtrlo-IWC&Dub,50627,3253,94,75,65,234,0.0719336
Minneapolis-St. Paul,55312,1557,42,42,28,112,0.071933205
Terre Haute,47846,709,18,19,14,51,0.071932299
Portland-Auburn,4364,6256,170,139,141,450,0.071930946
Milwaukee,53040,8397,255,183,166,604,0.071930451
Lincoln & Hastings-Krny,68336,570,19,13,9,41,0.071929825
Indianapolis,47840,1432,34,33,36,103,0.071927374
Minneapolis-St. Paul,56118,431,12,7,12,31,0.071925754
Montgomery-Selma,36785,723,19,18,15,52,0.071922545
Hartford & New Haven,6339,8426,220,184,202,606,0.071920247
Wilkes Barre-Scranton-Hztn,18414,5381,139,123,125,387,0.071919718
Roanoke-Lynchburg,24520,2183,59,45,53,157,0.071919377
Evansville,47537,876,24,23,16,63,0.071917808
Little Rock-Pine Bluff,71660,876,24,24,15,63,0.071917808
Chicago,60192,15963,474,365,309,1148,0.071916306
Monroe-El Dorado,71357,1321,40,26,29,95,0.071915216
Traverse City-Cadillac,49683,2058,54,45,49,148,0.07191448
Rochestr-Mason City-Austin,50446,445,13,11,8,32,0.071910112
Amarillo,73947,445,10,9,13,32,0.071910112
Boston (Manchester),1701,32819,803,793,764,2360,0.071909565
Pittsburgh,15634,598,16,13,14,43,0.071906355
Lincoln & Hastings-Krny,68935,598,21,12,10,43,0.071906355
Indianapolis,47470,1502,46,30,32,108,0.071904128
Davenport-R.Island-Moline,61469,1808,45,46,39,130,0.071902655
Pittsburgh,26440,1210,32,29,26,87,0.071900826
Buffalo,14057,8331,219,196,184,599,0.071900132
Orlando-Daytona Bch-Melbrn,32113,6523,177,145,147,469,0.071899433
New York,11797,9110,248,226,181,655,0.071899012
Lansing,49272,2587,77,59,50,186,0.071897951
Madison,53948,8220,214,178,199,591,0.07189781
Boston (Manchester),1887,23297,599,541,535,1675,0.071897669
New York,7927,4117,82,108,106,296,0.071897012
Philadelphia,18011,5953,151,136,141,428,0.071896523
Seattle-Tacoma,98363,14521,368,347,329,1044,0.071895875
Richmond-Petersburg,23843,612,13,16,15,44,0.071895425
Marquette,49873,153,4,4,3,11,0.071895425
Paducah-Cape Girard-Harsbg,63939,306,11,6,5,22,0.071895425
Odessa-Midland,79748,153,3,4,4,11,0.071895425
Burlington-Plattsburgh,5492,779,18,17,21,56,0.071887035
Sioux Falls(Mitchell),57235,779,24,20,12,56,0.071887035
Johnstown-Altoona-St Colge,15926,2351,57,51,61,169,0.071884305
Springfield-Holyoke,1073,6191,163,166,116,445,0.071878533
Knoxville,37385,8306,243,175,179,597,0.071875752
Indianapolis,47833,960,27,22,20,69,0.071875
"Portland, OR",97392,6734,181,166,137,484,0.071874072
Honolulu,96825,30637,878,757,567,2202,0.071873878
Orlando-Daytona Bch-Melbrn,32110,11395,281,277,261,819,0.071873629
Mobile-Pensacola (Ft Walt),36579,1447,37,33,34,104,0.07187284
Los Angeles,93545,2268,71,51,41,163,0.071869489
Kansas City,64048,3910,116,92,73,281,0.071867008
Harrisburg-Lncstr-Leb-York,17053,5218,126,108,141,375,0.071866616
Minneapolis-St. Paul,55063,9504,269,235,179,683,0.071864478
"Albany, GA",39841,821,25,19,15,59,0.071863581
Cedar Rapids-Wtrlo-IWC&Dub,52332,2157,60,47,48,155,0.071859064
Albany-Schenectady-Troy,5352,835,21,20,19,60,0.071856287
Ottumwa-Kirksville,52573,167,4,4,4,12,0.071856287
Bismarck-Mnt-Dcknsn(Wlstn),58478,167,5,4,3,12,0.071856287
Billings,59322,167,6,4,2,12,0.071856287
Minneapolis-St. Paul,56284,2018,52,44,49,145,0.07185332
Minneapolis-St. Paul,55359,6569,211,153,108,472,0.071852641
Tucson (Sierra Vista),85743,32748,925,756,672,2353,0.071851716
Amarillo,88124,1016,30,23,20,73,0.071850394
Pittsburgh,15428,1698,45,36,41,122,0.071849234
Los Angeles,91040,20851,459,439,600,1498,0.071843077
New York,7016,24208,647,607,485,1739,0.071835757
San Francisco-Oak-San Jose,94904,12334,400,303,183,886,0.071833955
Chico-Redding,96022,16413,481,361,337,1179,0.071833303
Grand Rapids-Kalmzoo-B.Crk,48815,2492,68,49,62,179,0.071829856
St. Louis,62246,9648,228,259,206,693,0.071828358
Utica,13459,1977,43,51,48,142,0.071825999
Richmond-Petersburg,24562,362,11,8,7,26,0.071823204
Terre Haute,47849,543,21,10,8,39,0.071823204
Cedar Rapids-Wtrlo-IWC&Dub,52217,543,16,10,13,39,0.071823204
Sioux Falls(Mitchell),56173,362,12,7,7,26,0.071823204
St. Louis,62261,181,6,4,3,13,0.071823204
Champaign&Sprngfld-Decatur,62684,5249,165,120,92,377,0.071823204
Spokane,99128,362,11,7,8,26,0.071823204
New York,12508,20913,410,502,590,1502,0.071821355
Tulsa,74455,2548,64,63,56,183,0.071821036
New York,7418,2005,47,47,50,144,0.071820449
New York,10969,1824,55,44,32,131,0.071820175
Indianapolis,47932,5319,149,121,112,382,0.071818011
St. Louis,62885,738,20,15,18,53,0.071815718
San Francisco-Oak-San Jose,94941,31748,1023,764,493,2280,0.071815547
Knoxville,37853,3509,94,69,89,252,0.071815332
Minneapolis-St. Paul,56145,557,14,15,11,40,0.071813285
Toledo,44841,933,25,22,20,67,0.071811361
Sioux Falls(Mitchell),57068,1685,58,38,25,121,0.071810089
Burlington-Plattsburgh,3780,376,9,10,8,27,0.071808511
"Jackson, TN",38376,376,10,8,9,27,0.071808511
"Columbus, GA (Opelika, AL)",39836,376,13,9,5,27,0.071808511
"Columbus, OH",43844,3760,103,84,83,270,0.071808511
Springfield-Holyoke,1057,7910,216,170,182,568,0.071807838
Pittsburgh,15636,3774,113,88,70,271,0.071807101
Denver,69348,1323,44,30,21,95,0.0718065
Pittsburgh,16041,1894,52,39,45,136,0.071805702
Grand Rapids-Kalmzoo-B.Crk,49326,3788,103,86,83,272,0.071805702
Billings,59015,571,16,15,10,41,0.071803853
Green Bay-Appleton,54409,12757,345,300,271,916,0.071803716
Miami-Ft. Lauderdale,33144,25821,584,645,625,1854,0.071802022
Philadelphia,19810,25139,643,591,571,1805,0.071800788
Little Rock-Pine Bluff,72131,4443,121,104,94,319,0.071798334
Philadelphia,18974,43095,1066,1013,1015,3094,0.071794872
Paducah-Cape Girard-Harsbg,42048,2535,61,54,67,182,0.071794872
Columbia-Jefferson City,65064,585,15,12,15,42,0.071794872
Denver,80498,8580,172,208,236,616,0.071794872
San Francisco-Oak-San Jose,95470,6240,169,147,132,448,0.071794872
Richmond-Petersburg,23139,29264,809,708,584,2101,0.071794697
New York,10069,10934,201,230,354,785,0.071794403
Cleveland-Akron (Canton),44839,12118,320,277,273,870,0.071794025
Hartford & New Haven,6018,2549,66,66,51,183,0.07179286
Philadelphia,19025,7062,231,157,119,507,0.071792693
Watertown,13433,1379,36,37,26,99,0.071791153
Boston (Manchester),3047,1783,51,30,47,128,0.071789119
Boston (Manchester),1863,9319,208,226,235,669,0.071788819
Cleveland-Akron (Canton),44001,21536,563,531,452,1546,0.071786776
Harrisonburg,26815,599,16,14,13,43,0.071786311
Charleston-Huntington,45771,3399,94,80,70,244,0.071785819
Seattle-Tacoma,98155,38392,894,886,976,2756,0.071785789
Baltimore,21658,3803,103,88,82,273,0.071785433
Burlington-Plattsburgh,5483,1602,45,32,38,115,0.071785268
Sherman-Ada,74533,1003,33,21,18,72,0.071784646
Fargo,58251,1811,58,36,36,130,0.071783545
Houston,77478,25146,598,601,606,1805,0.0717808
Seattle-Tacoma,98230,19490,522,472,405,1399,0.0717804
New York,7676,9139,245,215,196,656,0.071780282
Sioux Falls(Mitchell),57564,1017,27,22,24,73,0.071779744
Austin,78620,25704,807,625,413,1845,0.071778711
Pittsburgh,15052,3469,96,80,73,249,0.071778611
Wichita-Hutchinson Plus,67576,1839,53,40,39,132,0.07177814
Charleston-Huntington,25123,3274,91,71,73,235,0.071777642
Flint-Saginaw-Bay City,48463,4305,120,100,89,309,0.071777003
Missoula,59922,2870,65,67,74,206,0.071777003
Waco-Temple-Bryan,77856,5141,142,118,109,369,0.071775919
Columbia-Jefferson City,65039,2689,85,62,46,193,0.071773894
Hartford & New Haven,6443,17556,561,404,295,1260,0.071770335
New York,12745,209,7,4,4,15,0.071770335
Great Falls,59487,1254,37,31,22,90,0.071770335
St. Louis,63013,1672,50,39,31,120,0.071770335
Shreveport,74754,418,11,10,9,30,0.071770335
San Antonio,78837,209,5,6,4,15,0.071770335
Denver,81654,1254,28,24,38,90,0.071770335
Yakima-Pasco-Rchlnd-Knnwck,97843,627,14,17,14,45,0.071770335
Providence-New Bedford,2886,29679,585,697,848,2130,0.071767917
Lubbock,79381,1477,50,29,27,106,0.071767095
Flint-Saginaw-Bay City,48631,4724,122,113,104,339,0.071761219
Pittsburgh,15644,18130,468,416,417,1301,0.071759515
Elmira (Corning),14808,432,11,11,9,31,0.071759259
Cheyenne-Scottsbluff,82212,432,15,8,8,31,0.071759259
Kansas City,64724,1742,53,33,39,125,0.071756602
Los Angeles,93553,1742,43,44,38,125,0.071756602
Charlotte,28606,1965,57,44,40,141,0.071755725
Pittsburgh,15632,9393,252,224,198,674,0.071755563
St. Louis,63638,2634,72,67,50,189,0.071753986
Amarillo,79039,878,28,24,11,63,0.071753986
Green Bay-Appleton,54986,5059,154,120,89,363,0.071753311
Baton Rouge,39645,5073,144,120,100,364,0.071752415
Sioux Falls(Mitchell),57012,1324,37,30,28,95,0.071752266
Detroit,48081,20265,449,461,544,1454,0.071749321
Utica,13337,669,17,14,17,48,0.071748879
Traverse City-Cadillac,49651,8056,226,185,167,578,0.071747766
Wheeling-Steubenville,26070,7875,195,190,180,565,0.071746032
Philadelphia,18056,906,27,16,22,65,0.071743929
Wilkes Barre-Scranton-Hztn,17959,1366,33,36,29,98,0.071742313
Wichita-Hutchinson Plus,67425,683,19,15,15,49,0.071742313
Minneapolis-St. Paul,56273,5018,155,108,97,360,0.07174173
Spokane,83855,2286,71,45,48,164,0.071741032
Albany-Schenectady-Troy,13428,1603,43,35,37,115,0.071740487
Philadelphia,8019,920,26,21,19,66,0.07173913
Binghamton,13865,5520,143,125,128,396,0.07173913
Burlington-Plattsburgh,3773,8099,209,173,199,581,0.071737252
Peoria-Bloomington,61421,1157,33,24,26,83,0.071737252
"Washington, DC (Hagrstwn)",20115,6956,171,169,159,499,0.07173663
Wilkes Barre-Scranton-Hztn,18656,2091,54,54,42,150,0.071736011
Nashville,38476,1408,39,32,30,101,0.071732955
Pittsburgh,15341,711,20,16,15,51,0.071729958
Portland-Auburn,4238,1199,39,28,19,86,0.071726439
Bismarck-Mnt-Dcknsn(Wlstn),59212,488,14,10,11,35,0.071721311
Kansas City,64623,488,12,13,10,35,0.071721311
Miami-Ft. Lauderdale,33315,13985,233,278,492,1003,0.0717197
Lincoln & Hastings-Krny,68532,739,25,18,10,53,0.071718539
Pittsburgh,16373,3472,93,73,83,249,0.07171659
Erie,16426,3751,112,86,71,269,0.07171421
Harrisonburg,24467,2008,56,48,40,144,0.071713147
"Charleston, SC",29446,1004,23,20,29,72,0.071713147
Kansas City,64656,251,7,5,6,18,0.071713147
Kansas City,65335,251,7,5,6,18,0.071713147
Boston (Manchester),3874,9301,205,216,246,667,0.071712719
Miami-Ft. Lauderdale,33154,15116,413,370,301,1084,0.071712093
Minneapolis-St. Paul,56310,5076,159,114,91,364,0.071710008
Greenville-N.Bern-Washngtn,27928,1534,43,35,32,110,0.071707953
Rockford,61089,767,23,13,19,55,0.071707953
Seattle-Tacoma,98077,13848,435,348,210,993,0.071707106
Seattle-Tacoma,98074,32145,1210,661,434,2305,0.071706331
Des Moines-Ames,50244,1813,48,41,41,130,0.071704357
"Portland, OR",97138,11924,276,298,281,855,0.071704126
New York,10925,4407,107,90,119,316,0.071704107
San Francisco-Oak-San Jose,95476,33026,856,806,706,2368,0.071701084
Phoenix (Prescott),86326,24714,641,580,551,1772,0.071700251
Baltimore,21047,13724,412,307,265,984,0.071699213
Great Falls,59460,265,11,6,2,19,0.071698113
Lincoln & Hastings-Krny,68523,2176,64,55,37,156,0.071691176
Lincoln & Hastings-Krny,68863,1088,35,24,19,78,0.071691176
Chicago,60035,30005,983,717,451,2151,0.071688052
Nashville,38559,1381,40,31,28,99,0.071687183
Minneapolis-St. Paul,55031,1939,55,42,42,139,0.071686436
La Crosse-Eau Claire,54768,6096,179,130,128,437,0.071686352
Bangor,4456,3055,70,65,84,219,0.071685761
Parkersburg,26169,558,14,12,14,40,0.071684588
Charlotte,28609,6696,164,166,150,480,0.071684588
"Tri-Cities, TN-VA",24375,1409,43,29,29,101,0.071682044
Albany-Schenectady-Troy,12173,1702,42,38,42,122,0.071680376
Nashville,38548,851,25,20,16,61,0.071680376
Greenville-N.Bern-Washngtn,27849,865,23,25,14,62,0.071676301
Tampa-St. Pete (Sarasota),33834,6376,189,155,113,457,0.071675031
Rochestr-Mason City-Austin,55932,2037,60,43,43,146,0.07167403
Bluefield-Beckley-Oak Hill,26261,2344,64,57,47,168,0.071672355
Sioux City,51357,586,15,14,13,42,0.071672355
Des Moines-Ames,50421,2944,93,59,59,211,0.071671196
Johnstown-Altoona-St Colge,17052,1479,36,34,36,106,0.071670047
Burlington-Plattsburgh,12985,1186,32,29,24,85,0.071669477
Ottumwa-Kirksville,63545,893,23,23,18,64,0.071668533
Marquette,49945,2693,75,61,57,193,0.071667286
Boston (Manchester),2379,7800,189,190,180,559,0.071666667
Chicago,60530,600,17,15,11,43,0.071666667
Chicago,60151,3949,110,90,83,283,0.071663712
Dallas-Ft. Worth,76472,1521,43,40,26,109,0.071663379
Nashville,42254,307,8,5,9,22,0.071661238
Des Moines-Ames,50559,307,10,7,5,22,0.071661238
Bismarck-Mnt-Dcknsn(Wlstn),58847,307,10,6,6,22,0.071661238
Kansas City,64074,614,16,14,14,44,0.071661238
Harrisburg-Lncstr-Leb-York,17361,5959,149,148,130,427,0.071656318
Louisville,40157,949,24,23,21,68,0.071654373
Bismarck-Mnt-Dcknsn(Wlstn),58792,321,11,7,5,23,0.07165109
"Springfield, MO",65630,642,20,16,10,46,0.07165109
Minneapolis-St. Paul,55069,5848,141,131,147,419,0.071648427
Kansas City,64673,2275,51,63,49,163,0.071648352
Charleston-Huntington,26681,1633,48,36,33,117,0.071647275
Detroit,48401,1312,30,34,30,94,0.071646341
Syracuse,13477,1326,33,28,34,95,0.071644042
Des Moines-Ames,50251,1326,42,25,28,95,0.071644042
Grand Junction-Montrose,81424,1005,25,24,23,72,0.071641791
Chicago,60069,9101,295,217,140,652,0.071640479
Harrisburg-Lncstr-Leb-York,17068,4425,118,100,99,317,0.071638418
Dayton,43348,1703,40,44,38,122,0.071638285
Greenville-N.Bern-Washngtn,27872,349,9,10,6,25,0.071633238
Charleston-Huntington,41563,349,11,8,6,25,0.071633238
Lansing,49246,3141,86,76,63,225,0.071633238
Greenwood-Greenville,38925,1787,40,38,50,128,0.071628428
Milwaukee,53235,9396,174,219,280,673,0.071626224
Wilkes Barre-Scranton-Hztn,16925,3267,89,77,68,234,0.071625344
San Diego,91934,726,17,13,22,52,0.071625344
Philadelphia,19064,25564,706,579,546,1831,0.071624159
Cedar Rapids-Wtrlo-IWC&Dub,52321,377,10,10,7,27,0.071618037
New York,7756,3044,24,60,134,218,0.071616294
Denver,69145,2681,61,60,71,192,0.071615069
Buffalo,14001,9370,241,220,210,671,0.071611526
Albuquerque-Santa Fe,88043,1564,45,36,31,112,0.071611253
Honolulu,96743,13699,366,341,274,981,0.071611067
Harrisburg-Lncstr-Leb-York,17980,3240,82,75,75,232,0.071604938
Burlington-Plattsburgh,5488,8156,226,168,190,584,0.071603727
Louisville,40023,6117,184,141,113,438,0.071603727
San Francisco-Oak-San Jose,95461,2863,76,72,57,205,0.071603213
Idaho Fals-Pocatllo(Jcksn),83013,419,7,10,13,30,0.071599045
Jonesboro,72444,1704,45,40,37,122,0.071596244
Davenport-R.Island-Moline,61329,1285,27,30,35,92,0.071595331
Topeka,66515,433,14,7,10,31,0.071593533
Minneapolis-St. Paul,55018,880,23,22,18,63,0.071590909
Lincoln & Hastings-Krny,69120,880,21,17,25,63,0.071590909
Pittsburgh,15027,2207,49,47,62,158,0.071590394
Missoula,59912,16665,477,361,355,1193,0.071587159
Lincoln & Hastings-Krny,68883,2277,72,46,45,163,0.071585419
Boston (Manchester),2176,29182,658,628,803,2089,0.071585224
Cleveland-Akron (Canton),44064,1830,50,45,36,131,0.071584699
Sioux City,51004,936,18,20,29,67,0.071581197
Madison,53955,6105,181,135,121,437,0.071580672
Buffalo,14709,1411,29,38,34,101,0.071580439
Sacramnto-Stkton-Modesto,95648,61051,1845,1371,1154,4370,0.071579499
Baltimore,21053,3367,109,85,47,241,0.071577072
Youngstown,16124,1956,55,41,44,140,0.071574642
Boston (Manchester),2532,13874,322,393,278,993,0.071572726
Johnstown-Altoona-St Colge,16661,992,27,23,21,71,0.071572581
"Jackson, TN",38361,992,29,24,18,71,0.071572581
"Columbus, OH",43031,13916,369,312,315,996,0.071572291
Boston (Manchester),1506,3507,93,86,72,251,0.071571143
New York,7757,5645,156,131,117,404,0.071567759
Kansas City,64096,1034,26,25,23,74,0.071566731
Shreveport,75657,7909,211,187,168,566,0.071564041
New York,8880,4835,99,111,136,346,0.071561531
Amarillo,79095,2194,70,34,53,157,0.071558797
Seattle-Tacoma,98065,16700,648,337,210,1195,0.071556886
Little Rock-Pine Bluff,71958,2236,62,50,48,160,0.071556351
Wilkes Barre-Scranton-Hztn,17889,2907,82,64,62,208,0.071551428
"Washington, DC (Hagrstwn)",17229,1174,28,31,25,84,0.071550256
Richmond-Petersburg,23123,1761,48,36,42,126,0.071550256
Omaha,51454,1272,38,28,25,91,0.071540881
New York,11363,6388,160,156,141,457,0.071540388
Pittsburgh,15427,1286,30,28,34,92,0.071539658
Dallas-Ft. Worth,76427,643,18,14,14,46,0.071539658
Philadelphia,19707,17543,518,427,310,1255,0.071538505
Savannah,30442,8541,221,176,214,611,0.071537291
Richmond-Petersburg,23841,3355,86,75,79,240,0.071535022
"Portland, OR",97053,3383,94,77,71,242,0.071534141
Dallas-Ft. Worth,75472,4068,110,97,84,291,0.071533923
Philadelphia,19520,6151,171,148,121,440,0.071533084
Myrtle Beach-Florence,29516,685,11,19,19,49,0.071532847
Denver,80653,685,20,17,12,49,0.071532847
Denver,80833,699,21,15,14,50,0.071530758
Champaign&Sprngfld-Decatur,62711,19042,514,455,393,1362,0.0715261
Rapid City,57626,755,25,15,14,54,0.071523179
Palm Springs,92253,39345,990,949,875,2814,0.071521159
"Columbus, OH",45735,1566,45,36,31,112,0.071519796
Wichita-Hutchinson Plus,67009,783,23,19,14,56,0.071519796
Johnstown-Altoona-St Colge,16841,5495,125,131,137,393,0.071519563
Sioux City,51007,797,27,15,15,57,0.071518193
Bluefield-Beckley-Oak Hill,24963,3999,108,91,87,286,0.071517879
Seattle-Tacoma,98292,25197,688,614,500,1802,0.07151645
Champaign&Sprngfld-Decatur,61840,825,25,19,15,59,0.071515152
Topeka,66548,853,31,15,15,61,0.071512309
Oklahoma City,73051,9775,269,229,201,699,0.071508951
Lincoln & Hastings-Krny,68340,895,26,20,18,64,0.07150838
"Washington, DC (Hagrstwn)",22656,6335,176,115,162,453,0.071507498
Shreveport,75574,1888,41,46,48,135,0.071504237
Utica,13326,4895,109,135,106,350,0.071501532
Flint-Saginaw-Bay City,48460,1958,55,46,39,140,0.071501532
"Springfield, MO",65692,979,29,24,17,70,0.071501532
Chattanooga,35748,7930,228,167,172,567,0.071500631
"Portland, OR",97017,3007,85,63,67,215,0.071499834
Dallas-Ft. Worth,76692,11301,312,266,230,808,0.071498098
Burlington-Plattsburgh,5822,2056,49,53,45,147,0.071498054
Kansas City,66072,1049,39,23,13,75,0.071496663
Indianapolis,46160,6336,180,142,131,453,0.071496212
Cleveland-Akron (Canton),44275,3175,81,69,77,227,0.071496063
Kansas City,64146,1063,19,21,36,76,0.071495767
Sioux City,50585,1077,32,23,22,77,0.071494893
"Portland, OR",97327,3273,96,68,70,234,0.071494042
Charlottesville,22935,1147,31,31,20,82,0.071490846
Binghamton,13783,2350,69,50,49,168,0.071489362
Bluefield-Beckley-Oak Hill,24868,1189,41,17,27,85,0.071488646
San Antonio,78861,14324,380,353,291,1024,0.071488411
Panama City,32420,2392,68,57,46,171,0.071488294
"Columbia, SC",29009,2434,60,57,57,174,0.071487264
Knoxville,37705,6127,182,135,121,438,0.071486861
Minneapolis-St. Paul,55364,14926,420,357,290,1067,0.071485998
Wheeling-Steubenville,26038,2658,76,60,54,190,0.071482318
Meridian,36907,1357,31,37,29,97,0.071481209
Bismarck-Mnt-Dcknsn(Wlstn),58421,2826,79,52,71,202,0.071479122
St. Louis,62231,7149,197,160,154,511,0.071478528
Harrisburg-Lncstr-Leb-York,17007,6170,183,139,119,441,0.071474878
"Portland, OR",97014,1553,47,29,35,111,0.071474565
Syracuse,13084,4687,117,101,117,335,0.071474291
Mobile-Pensacola (Ft Walt),32568,3232,76,86,69,231,0.071472772
Roanoke-Lynchburg,24128,1707,44,41,37,122,0.071470416
Syracuse,13160,1749,50,46,29,125,0.071469411
La Crosse-Eau Claire,54635,1749,50,33,42,125,0.071469411
Evansville,42325,1791,48,43,37,128,0.071468453
St. Louis,62870,1847,45,47,40,132,0.071467244
Bangor,4971,2057,54,42,51,147,0.071463296
Hartford & New Haven,6416,14665,359,340,349,1048,0.071462666
Tampa-St. Pete (Sarasota),34669,16751,452,361,384,1197,0.07145842
New York,8724,42166,996,971,1046,3013,0.071455675
"Washington, DC (Hagrstwn)",22580,5276,132,122,123,377,0.071455648
Minneapolis-St. Paul,56096,2771,81,61,56,198,0.071454349
Ft. Myers-Naples,33990,33784,809,819,786,2414,0.071453943
New York,7020,14121,239,352,418,1009,0.071453863
Burlington-Plattsburgh,5476,3233,80,75,76,231,0.071450665
"Tri-Cities, TN-VA",37656,3667,81,91,90,262,0.07144805
Minneapolis-St. Paul,56288,4605,132,103,94,329,0.071444083
Buffalo,16915,5571,148,116,134,398,0.071441393
Raleigh-Durham (Fayetvlle),27583,7069,201,143,161,505,0.071438676
Boston (Manchester),3233,42,1,1,1,3,0.071428571
Burlington-Plattsburgh,5083,238,6,6,5,17,0.071428571
Burlington-Plattsburgh,12903,1862,38,47,48,133,0.071428571
Burlington-Plattsburgh,12921,2576,70,47,67,184,0.071428571
Binghamton,13813,826,19,20,20,59,0.071428571
Buffalo,14069,658,18,13,16,47,0.071428571
Pittsburgh,15729,1456,38,36,30,104,0.071428571
Johnstown-Altoona-St Colge,15764,112,3,2,3,8,0.071428571
Wilkes Barre-Scranton-Hztn,17888,294,6,8,7,21,0.071428571
Roanoke-Lynchburg,24093,98,2,2,3,7,0.071428571
Bluefield-Beckley-Oak Hill,24731,126,3,2,4,9,0.071428571
Bluefield-Beckley-Oak Hill,24879,112,4,2,2,8,0.071428571
Bluefield-Beckley-Oak Hill,24945,1176,34,28,22,84,0.071428571
Bluefield-Beckley-Oak Hill,25854,966,29,24,16,69,0.071428571
Bluefield-Beckley-Oak Hill,25857,84,2,2,2,6,0.071428571
Bluefield-Beckley-Oak Hill,26690,476,13,11,10,34,0.071428571
Raleigh-Durham (Fayetvlle),28387,17850,406,381,488,1275,0.071428571
Mobile-Pensacola (Ft Walt),36550,210,5,5,5,15,0.071428571
Paducah-Cape Girard-Harsbg,42083,350,8,8,9,25,0.071428571
Indianapolis,46170,56,2,1,1,4,0.071428571
Evansville,47515,910,28,22,15,65,0.071428571
Marquette,49852,56,2,1,1,4,0.071428571
Des Moines-Ames,50522,686,23,16,10,49,0.071428571
Cedar Rapids-Wtrlo-IWC&Dub,50657,98,3,2,2,7,0.071428571
Des Moines-Ames,50849,2758,81,52,64,197,0.071428571
Milwaukee,53093,2212,65,46,47,158,0.071428571
Minneapolis-St. Paul,56343,952,34,20,14,68,0.071428571
Sioux Falls(Mitchell),57016,658,26,10,11,47,0.071428571
Fargo,58266,224,7,4,5,16,0.071428571
Fargo,58490,196,7,3,4,14,0.071428571
Bismarck-Mnt-Dcknsn(Wlstn),58654,280,9,5,6,20,0.071428571
Billings,59012,42,1,1,1,3,0.071428571
Billings,59082,42,1,1,1,3,0.071428571
Billings,59333,28,1,1,0,2,0.071428571
Great Falls,59444,252,5,6,7,18,0.071428571
Terre Haute,62423,602,20,12,11,43,0.071428571
St. Louis,63341,3948,115,106,61,282,0.071428571
Quincy-Hannibal-Keokuk,63443,336,10,8,6,24,0.071428571
Topeka,66425,476,16,8,10,34,0.071428571
Topeka,66554,616,20,12,12,44,0.071428571
Joplin-Pittsburg,66772,224,7,4,5,16,0.071428571
Topeka,66835,1134,34,24,23,81,0.071428571
Wichita-Hutchinson Plus,66850,210,6,4,5,15,0.071428571
Wichita-Hutchinson Plus,67155,140,5,3,2,10,0.071428571
Lincoln & Hastings-Krny,68854,728,24,14,14,52,0.071428571
Lincoln & Hastings-Krny,68973,434,13,10,8,31,0.071428571
Sioux Falls(Mitchell),69220,70,2,2,1,5,0.071428571
Little Rock-Pine Bluff,71722,56,1,2,1,4,0.071428571
Little Rock-Pine Bluff,72165,98,3,2,2,7,0.071428571
Little Rock-Pine Bluff,72828,56,2,1,1,4,0.071428571
Oklahoma City,73642,140,3,4,3,10,0.071428571
Oklahoma City,73719,154,4,3,4,11,0.071428571
Oklahoma City,73720,224,8,3,5,16,0.071428571
Amarillo,79239,98,2,3,2,7,0.071428571
Abilene-Sweetwater,79537,42,1,1,1,3,0.071428571
Denver,81237,84,3,2,1,6,0.071428571
Amarillo,88116,420,14,9,7,30,0.071428571
Albuquerque-Santa Fe,88213,42,1,1,1,3,0.071428571
Amarillo,88414,56,2,1,1,4,0.071428571
Los Angeles,92280,28,1,0,1,2,0.071428571
Spokane,99136,28,1,1,0,2,0.071428571
Spokane,99144,42,1,1,1,3,0.071428571
"Rochester, NY",14469,6217,153,151,140,444,0.071417082
Dayton,45315,5041,130,124,106,360,0.071414402
Rapid City,57769,4537,143,99,82,324,0.071412828
Myrtle Beach-Florence,29512,17882,453,395,429,1277,0.071412594
Wilkes Barre-Scranton-Hztn,18240,4005,91,97,98,286,0.071410737
Spokane,83861,7324,206,164,153,523,0.071409066
Boston (Manchester),2043,24661,790,591,380,1761,0.071408297
Portland-Auburn,4280,6848,177,160,152,489,0.07140771
Flint-Saginaw-Bay City,48650,6610,174,140,158,472,0.071406959
Boston (Manchester),1505,5196,148,116,107,371,0.071401078
Burlington-Plattsburgh,5667,2227,58,60,41,159,0.071396498
Binghamton,13830,4412,114,96,105,315,0.071396192
Milwaukee,53534,13082,364,291,279,934,0.071395811
Memphis,72335,16262,378,414,369,1161,0.071393433
New York,7823,7760,203,181,170,554,0.071391753
Pittsburgh,16341,1919,56,44,37,137,0.07139135
Pittsburgh,15864,1891,48,42,45,135,0.071390799
Harrisburg-Lncstr-Leb-York,17322,5533,149,114,132,395,0.071389843
Wichita-Hutchinson Plus,67740,1709,50,28,44,122,0.071386776
Billings,59047,14247,333,347,337,1017,0.071383449
Rochestr-Mason City-Austin,56009,1569,47,35,30,112,0.071383047
Hartford & New Haven,6455,3110,80,67,75,222,0.071382637
"Washington, DC (Hagrstwn)",21755,6192,169,143,130,442,0.071382429
Roanoke-Lynchburg,24184,4469,120,104,95,319,0.071380622
Baltimore,21120,6991,227,159,113,499,0.071377485
Chicago,60108,22768,531,538,556,1625,0.071372101
Wichita-Hutchinson Plus,67839,1261,39,23,28,90,0.071371927
Fargo,56535,1247,30,38,21,89,0.071371291
Myrtle Beach-Florence,28396,2466,58,69,49,176,0.071370641
Youngstown,44429,2438,60,52,62,174,0.071369975
Ft. Smith-Fay-Sprngdl-Rgrs,72773,1219,33,26,28,87,0.071369975
Roanoke-Lynchburg,24149,3517,104,80,67,251,0.071367643
Des Moines-Ames,50238,1163,45,17,21,83,0.071367154
Ottumwa-Kirksville,52556,11883,254,267,327,848,0.071362451
Panama City,32408,16956,400,401,409,1210,0.07136117
Paducah-Cape Girard-Harsbg,62990,1037,27,19,28,74,0.071359691
Springfield-Holyoke,1034,2032,52,46,47,145,0.071358268
Paducah-Cape Girard-Harsbg,63655,939,29,24,14,67,0.071352503
Indianapolis,46075,10904,292,225,261,778,0.071349963
Minneapolis-St. Paul,55084,1766,45,35,46,126,0.071347678
Panama City,32426,869,26,20,16,62,0.071346375
Harrisburg-Lncstr-Leb-York,17011,36612,826,843,943,2612,0.071342729
Chattanooga,30738,4149,103,97,96,296,0.071342492
San Francisco-Oak-San Jose,94574,8284,219,187,185,591,0.071342347
Hartford & New Haven,6092,3252,111,77,44,232,0.071340713
Ft. Wayne,46926,1584,50,37,26,113,0.071338384
Terre Haute,62480,785,17,21,18,56,0.07133758
Springfield-Holyoke,1378,771,24,14,17,55,0.071335927
Topeka,66528,757,27,15,12,54,0.071334214
Abilene-Sweetwater,76878,1444,39,42,22,103,0.07132964
Salisbury,21863,5033,117,116,126,359,0.071329227
Pittsburgh,15438,2117,48,46,57,151,0.07132735
"Springfield, MO",65571,2033,49,43,53,145,0.071323168
Atlanta,30143,27074,745,621,565,1931,0.071323041
Cedar Rapids-Wtrlo-IWC&Dub,52621,673,18,10,20,48,0.071322437
Madison,53577,1346,34,31,31,96,0.071322437
Monterey-Salinas,95018,8048,192,180,202,574,0.071322068
South Bend-Elkhart,49126,1332,23,37,35,95,0.071321321
Greenville-N.Bern-Washngtn,27847,645,15,20,11,46,0.071317829
Albuquerque-Santa Fe,87521,631,18,13,14,45,0.071315372
New York,7480,13897,345,325,321,991,0.071310355
Buffalo,14008,1192,31,30,24,85,0.071308725
Indianapolis,46950,589,16,13,13,42,0.071307301
Boston (Manchester),3049,8723,315,185,122,622,0.071305743
Birmingham (Ann and Tusc),36742,2286,54,52,57,163,0.071303587
Pittsburgh,26444,3380,96,80,65,241,0.071301775
Buffalo,14037,1108,27,26,26,79,0.071299639
New York,18405,2174,58,45,52,155,0.071297148
Albany-Schenectady-Troy,12061,9776,235,218,244,697,0.071297054
Wausau-Rhinelander,54406,3801,117,89,65,271,0.071297027
Alpena,49753,2160,57,43,54,154,0.071296296
Albany-Schenectady-Troy,12122,3633,89,83,87,259,0.071290944
Lincoln & Hastings-Krny,68927,1024,30,23,20,73,0.071289063
Indianapolis,46165,1529,37,37,35,109,0.071288424
Toledo,49235,2020,58,45,41,144,0.071287129
Shreveport,71971,505,16,12,8,36,0.071287129
Terre Haute,62454,10591,281,225,249,755,0.071286942
Charleston-Huntington,25252,996,30,21,20,71,0.071285141
Medford-Klamath Falls,96064,4419,120,97,98,315,0.071283096
Fargo,56750,2413,71,59,42,172,0.071280564
Charleston-Huntington,25320,5247,140,119,115,374,0.071278826
Davenport-R.Island-Moline,61453,477,11,11,12,34,0.071278826
Peoria-Bloomington,61759,1403,39,27,34,100,0.071275837
Charleston-Huntington,25676,1852,51,32,49,132,0.071274298
Champaign&Sprngfld-Decatur,60911,1389,39,33,27,99,0.071274298
Ottumwa-Kirksville,52530,898,24,26,14,64,0.071269488
Oklahoma City,73056,449,14,12,6,32,0.071269488
New York,8742,25875,657,612,575,1844,0.0712657
Indianapolis,47235,1754,53,36,36,125,0.071265678
Gainesville,32694,2189,59,45,52,156,0.071265418
Champaign&Sprngfld-Decatur,61856,7872,216,181,164,561,0.071265244
Terre Haute,62460,1305,36,28,29,93,0.071264368
Wilkes Barre-Scranton-Hztn,17764,2161,55,53,46,154,0.071263304
Sacramnto-Stkton-Modesto,95626,7718,193,173,184,550,0.071261985
"Springfield, MO",65543,421,10,9,11,30,0.071258907
Johnstown-Altoona-St Colge,15955,2498,62,58,58,178,0.071257006
Albany-Schenectady-Troy,1245,828,17,22,20,59,0.071256039
Boston (Manchester),1827,3312,102,69,65,236,0.071256039
Sioux City,68752,828,29,19,11,59,0.071256039
Great Falls,59425,3677,90,75,97,262,0.071253739
Evansville,47590,814,22,19,17,58,0.071253071
Rockford,61047,1628,46,33,37,116,0.071253071
Roanoke-Lynchburg,24557,7312,185,176,160,521,0.071252735
Wilmington,28450,2021,50,48,46,144,0.071251856
Spokane,83873,2021,52,39,53,144,0.071251856
Nashville,37330,7565,199,161,179,539,0.071249174
Ottumwa-Kirksville,52554,1193,38,17,30,85,0.071248952
Philadelphia,19035,3972,134,102,47,283,0.071248741
Honolulu,96781,1586,41,34,38,113,0.071248424
St. Louis,63441,1179,36,26,22,84,0.071246819
San Antonio,78879,393,11,9,8,28,0.071246819
Grand Rapids-Kalmzoo-B.Crk,49088,3916,109,84,86,279,0.07124617
Waco-Temple-Bryan,76571,9783,323,224,150,697,0.071246039
Champaign&Sprngfld-Decatur,60951,772,19,19,17,55,0.071243523
Ft. Wayne,46763,1909,54,44,38,136,0.071241488
Honolulu,96740,41016,1028,952,942,2922,0.071240492
Bowling Green,42207,1137,24,28,29,81,0.071240106
Charlotte,28698,2246,55,53,52,160,0.071237756
Wilkes Barre-Scranton-Hztn,18431,13055,297,305,328,930,0.071237074
Providence-New Bedford,2859,6612,170,155,146,471,0.07123412
Providence-New Bedford,2857,8620,205,210,199,614,0.071229698
Boston (Manchester),3840,3945,122,79,80,281,0.071229404
"Washington, DC (Hagrstwn)",20117,2836,79,62,61,202,0.07122708
Johnstown-Altoona-St Colge,15559,1769,53,35,38,126,0.071226682
Wilkes Barre-Scranton-Hztn,17824,3889,121,81,75,277,0.071226536
Ottumwa-Kirksville,63431,351,10,7,8,25,0.071225071
San Antonio,77994,351,8,9,8,25,0.071225071
Philadelphia,8620,11471,254,272,291,817,0.071223084
Pittsburgh,15724,2078,55,45,48,148,0.071222329
Miami-Ft. Lauderdale,33334,28699,613,668,763,2044,0.071221994
Providence-New Bedford,2817,6150,157,145,136,438,0.071219512
"Washington, DC (Hagrstwn)",22663,2050,56,43,47,146,0.071219512
Hartford & New Haven,6013,9534,270,237,172,679,0.071218796
Boston (Manchester),3440,2710,57,59,77,193,0.071217712
Rockford,61021,22579,544,541,523,1608,0.071216617
Dallas-Ft. Worth,76054,11964,316,251,285,852,0.071213641
St. Louis,62853,983,25,28,17,70,0.07121058
Seattle-Tacoma,98557,3904,105,79,94,278,0.071209016
Richmond-Petersburg,23063,6137,140,138,159,437,0.07120743
Albuquerque-Santa Fe,87930,646,19,11,16,46,0.07120743
Little Rock-Pine Bluff,72031,7078,206,165,133,504,0.071206556
Norfolk-Portsmth-Newpt Nws,23072,12457,312,282,293,887,0.071204945
New York,7838,2865,71,70,63,204,0.071204188
Waco-Temple-Bryan,76530,3160,99,67,59,225,0.071202532
Denver,81047,1573,46,37,29,112,0.071201526
La Crosse-Eau Claire,55947,7528,217,159,160,536,0.07120085
Norfolk-Portsmth-Newpt Nws,23442,1250,37,23,29,89,0.0712
Roanoke-Lynchburg,24380,2500,74,57,47,178,0.0712
Baltimore,21405,618,18,14,12,44,0.071197411
Pittsburgh,15043,2107,57,48,45,150,0.071191267
Pittsburgh,15131,7515,195,173,167,535,0.071190951
Joplin-Pittsburg,66733,2093,55,47,47,149,0.07118968
St. Louis,63965,2079,58,51,39,148,0.071188071
Panama City,32423,1180,38,27,19,84,0.071186441
Colorado Springs-Pueblo,81064,295,9,6,6,21,0.071186441
Idaho Fals-Pocatllo(Jcksn),83449,295,9,6,6,21,0.071186441
Elmira (Corning),14873,2346,66,51,50,167,0.071184996
Orlando-Daytona Bch-Melbrn,32953,24627,628,599,526,1753,0.071182036
Pittsburgh,16116,2585,69,62,53,184,0.071179884
Minneapolis-St. Paul,55327,6884,195,153,142,490,0.071179547
Waco-Temple-Bryan,76556,1433,42,36,24,102,0.071179344
San Antonio,78056,2290,65,57,41,163,0.071179039
Louisville,40068,2571,76,54,53,183,0.07117853
Indianapolis,46104,857,26,19,16,61,0.07117853
Charleston-Huntington,41616,562,16,11,13,40,0.071174377
Champaign&Sprngfld-Decatur,62536,843,27,17,16,60,0.071174377
Portland-Auburn,4551,829,31,13,15,59,0.071170084
Champaign&Sprngfld-Decatur,60963,1644,49,36,32,117,0.071167883
Rapid City,57790,1082,28,20,29,77,0.07116451
New York,8092,4553,117,104,103,324,0.071161871
Binghamton,13755,801,10,28,19,57,0.071161049
Roanoke-Lynchburg,24536,267,7,7,5,19,0.071161049
Norfolk-Portsmth-Newpt Nws,27956,267,7,5,7,19,0.071161049
Davenport-R.Island-Moline,52074,267,7,6,6,19,0.071161049
St. Louis,62284,534,17,12,9,38,0.071161049
Denver,82831,267,9,5,5,19,0.071161049
Topeka,66610,10933,351,252,175,778,0.071160706
Greensboro-H.Point-W.Salem,27311,3176,86,77,63,226,0.07115869
Ft. Wayne,46991,1588,35,41,37,113,0.07115869
Pittsburgh,16262,2642,65,59,64,188,0.071158213
Sioux City,51063,1054,26,26,23,75,0.071157495
Champaign&Sprngfld-Decatur,61942,1054,31,23,21,75,0.071157495
Lincoln & Hastings-Krny,68654,520,13,7,17,37,0.071153846
Springfield-Holyoke,1077,9403,253,208,208,669,0.071147506
Pittsburgh,16002,14941,370,342,351,1063,0.07114651
Roanoke-Lynchburg,24148,7815,210,175,171,556,0.071145234
Toledo,43443,1757,49,40,36,125,0.071143995
Boston (Manchester),2702,4259,119,95,89,303,0.071143461
New York,7739,6255,215,149,81,445,0.071143086
Bangor,4488,1223,33,25,29,87,0.071136549
Pittsburgh,16102,5609,138,121,140,399,0.071135675
"Portland, OR",97824,1701,60,31,30,121,0.071134627
Hartford & New Haven,6461,14817,349,334,371,1054,0.071134508
Johnstown-Altoona-St Colge,16623,478,12,10,12,34,0.071129707
Richmond-Petersburg,23023,478,12,13,9,34,0.071129707
Des Moines-Ames,50206,478,7,8,19,34,0.071129707
Minneapolis-St. Paul,56262,717,18,16,17,51,0.071129707
Dallas-Ft. Worth,75488,1195,37,26,22,85,0.071129707
Richmond-Petersburg,23882,2348,61,55,51,167,0.071124361
Green Bay-Appleton,54228,2812,82,65,53,200,0.071123755
Minneapolis-St. Paul,56338,1870,57,41,35,133,0.071122995
Hartford & New Haven,6424,12612,370,259,268,897,0.07112274
Eugene,97463,3965,107,93,82,282,0.07112232
Champaign&Sprngfld-Decatur,61877,1631,52,30,34,116,0.071122011
Pittsburgh,15679,3023,78,64,73,215,0.071121403
Boston (Manchester),3077,10996,261,251,270,782,0.07111677
Pittsburgh,26425,914,27,15,23,65,0.071115974
Flint-Saginaw-Bay City,48634,4106,103,100,89,292,0.071115441
Philadelphia,19083,37165,1029,853,761,2643,0.071115297
Quincy-Hannibal-Keokuk,63436,1139,41,25,15,81,0.071115013
Rochestr-Mason City-Austin,50459,2953,69,63,78,210,0.071114121
Burlington-Plattsburgh,5871,1589,45,35,33,113,0.071113908
West Palm Beach-Ft. Pierce,32962,27224,683,641,612,1936,0.071113723
Binghamton,13826,225,7,5,4,16,0.071111111
Charleston-Huntington,41534,225,5,5,6,16,0.071111111
Detroit,48159,2911,71,75,61,207,0.071109584
Atlanta,30627,2208,59,53,45,157,0.071105072
Chicago,60203,4149,122,96,77,295,0.07110147
Wheeling-Steubenville,45734,436,13,10,8,31,0.071100917
Davenport-R.Island-Moline,61412,1308,34,30,29,93,0.071100917
"Rochester, NY",14571,1294,31,31,30,92,0.071097372
Charlotte,28020,2574,66,62,55,183,0.071095571
Detroit,48179,2996,68,59,86,213,0.071094793
Traverse City-Cadillac,49346,6161,169,134,135,438,0.071092355
Charleston-Huntington,25534,211,5,6,4,15,0.071090047
Quincy-Hannibal-Keokuk,62375,422,12,10,8,30,0.071090047
Lincoln & Hastings-Krny,68365,211,6,3,6,15,0.071090047
Monroe-El Dorado,71661,211,6,5,4,15,0.071090047
Oklahoma City,73622,211,7,3,5,15,0.071090047
Traverse City-Cadillac,49730,2476,64,55,57,176,0.071082391
Bismarck-Mnt-Dcknsn(Wlstn),58521,619,19,14,11,44,0.071082391
Champaign&Sprngfld-Decatur,61778,619,19,15,10,44,0.071082391
Omaha,68050,619,17,13,14,44,0.071082391
Davenport-R.Island-Moline,61053,2462,58,59,58,175,0.071080422
Hartford & New Haven,6065,408,10,12,7,29,0.071078431
Johnstown-Altoona-St Colge,15535,2040,57,41,47,145,0.071078431
Fargo,56511,2209,71,51,35,157,0.071072884
Rochestr-Mason City-Austin,55971,2997,99,56,58,213,0.071071071
Cleveland-Akron (Canton),44202,22077,620,543,406,1569,0.071069439
Pittsburgh,16260,197,5,4,5,14,0.07106599
Bismarck-Mnt-Dcknsn(Wlstn),59252,197,7,4,3,14,0.07106599
Wichita-Hutchinson Plus,67132,394,12,10,6,28,0.07106599
New Orleans,70375,197,6,3,5,14,0.07106599
"Rochester, NY",14625,10301,220,250,262,732,0.071061062
"Columbus, OH",44849,2125,57,52,42,151,0.071058824
Wheeling-Steubenville,43913,1337,37,25,33,95,0.0710546
Burlington-Plattsburgh,5841,380,14,7,6,27,0.071052632
Monroe-El Dorado,71354,1520,35,41,32,108,0.071052632
Philadelphia,18051,3983,121,94,68,283,0.071051971
"Washington, DC (Hagrstwn)",21758,4884,151,115,81,347,0.071048321
Wichita-Hutchinson Plus,67876,1295,46,17,29,92,0.071042471
Lincoln & Hastings-Krny,68928,366,11,7,8,26,0.071038251
Boston (Manchester),1950,18498,509,434,371,1314,0.071034706
Baton Rouge,70762,1084,25,23,29,77,0.07103321
Omaha,68305,4153,112,90,93,295,0.071032988
Bangor,4605,14374,394,300,327,1021,0.071031028
Charlotte,28618,2154,59,47,47,153,0.071030641
Wilkes Barre-Scranton-Hztn,17820,5378,134,133,115,382,0.071030123
Tulsa,74051,1788,52,41,34,127,0.071029083
Oklahoma City,74831,887,25,24,14,63,0.07102593
Wilkes Barre-Scranton-Hztn,18847,5294,145,113,118,376,0.071023801
Johnstown-Altoona-St Colge,16879,352,10,7,8,25,0.071022727
Wilkes Barre-Scranton-Hztn,18632,352,11,8,6,25,0.071022727
Green Bay-Appleton,54241,14080,351,337,312,1000,0.071022727
St. Louis,62880,704,23,13,14,50,0.071022727
Springfield-Holyoke,1128,2633,70,54,63,187,0.071021648
Sioux Falls(Mitchell),57274,2633,84,53,50,187,0.071021648
Flint-Saginaw-Bay City,48661,10335,257,231,246,734,0.071020803
Baltimore,21161,5238,152,120,100,372,0.071019473
Tyler-Longview(Lfkn&Ncgd),75762,14306,378,313,325,1016,0.071019153
Oklahoma City,73564,521,11,15,11,37,0.071017274
Monroe-El Dorado,71343,6745,181,164,134,479,0.071015567
Minneapolis-St. Paul,56230,690,24,14,11,49,0.071014493
South Bend-Elkhart,49127,10660,281,260,216,757,0.071013133
Greenvll-Spart-Ashevll-And,28730,9970,275,229,204,708,0.071013039
Reno,89441,17687,549,395,312,1256,0.071012608
Minneapolis-St. Paul,56319,1366,36,30,31,97,0.071010249
Nashville,37031,4929,134,102,114,350,0.071008318
Albany-Schenectady-Troy,5252,338,12,7,5,24,0.071005917
"Jackson, TN",38348,845,23,16,21,60,0.071005917
Paducah-Cape Girard-Harsbg,42054,1014,28,22,22,72,0.071005917
Great Falls,59544,169,3,4,5,12,0.071005917
Shreveport,71455,169,4,5,3,12,0.071005917
Boston (Manchester),1541,3535,94,90,67,251,0.071004243
Minneapolis-St. Paul,55410,20788,545,465,466,1476,0.071002501
Paducah-Cape Girard-Harsbg,62888,1831,44,48,38,130,0.070999454
New York,7827,4141,96,102,96,294,0.070997344
Pittsburgh,15360,1817,45,41,43,129,0.070996147
Bluefield-Beckley-Oak Hill,24986,4437,103,91,121,315,0.070993915
St. Louis,63041,493,13,10,12,35,0.070993915
Dallas-Ft. Worth,76270,2296,67,53,43,163,0.070993031
"Portland, OR",98611,10818,297,253,218,768,0.07099279
Bangor,4921,1634,44,33,39,116,0.070991432
Shreveport,75639,2775,87,62,48,197,0.070990991
Norfolk-Portsmth-Newpt Nws,23874,1141,32,25,24,81,0.070990359
Cleveland-Akron (Canton),44233,8100,234,210,131,575,0.070987654
Great Falls,59416,324,9,6,8,23,0.070987654
Bangor,4667,1451,32,40,31,103,0.070985527
Pittsburgh,15431,4339,106,108,94,308,0.070984098
Orlando-Daytona Bch-Melbrn,32735,5142,136,119,110,365,0.070984053
"Columbus, GA (Opelika, AL)",39824,479,14,11,9,34,0.070981211
Denver,80825,479,18,9,7,34,0.070981211
Fresno-Visalia,93643,3184,95,73,58,226,0.070979899
"Washington, DC (Hagrstwn)",22835,11933,315,273,259,847,0.070979636
Richmond-Petersburg,23947,4086,119,87,84,290,0.070974058
Fargo,58045,2339,70,40,56,166,0.0709705
Pittsburgh,15083,930,26,23,17,66,0.070967742
Bluefield-Beckley-Oak Hill,25840,7285,196,174,147,517,0.070967742
Clarksburg-Weston,26224,155,4,4,3,11,0.070967742
Sioux Falls(Mitchell),56117,310,10,7,5,22,0.070967742
Minneapolis-St. Paul,56295,310,8,7,7,22,0.070967742
Great Falls,59546,155,4,3,4,11,0.070967742
Wichita-Hutchinson Plus,67734,155,5,3,3,11,0.070967742
Pittsburgh,16218,1071,29,25,22,76,0.070961718
St. Louis,62094,1071,31,24,21,76,0.070961718
St. Louis,62260,6877,168,169,151,488,0.070961175
Great Falls,59433,606,18,13,12,43,0.070957096
Little Rock-Pine Bluff,71949,1818,49,38,42,129,0.070957096
Norfolk-Portsmth-Newpt Nws,27935,1353,43,27,26,96,0.070953437
Peoria-Bloomington,61335,451,13,12,7,32,0.070953437
Columbia-Jefferson City,65083,451,13,10,9,32,0.070953437
South Bend-Elkhart,46939,1945,49,46,43,138,0.070951157
"Tri-Cities, TN-VA",37811,3735,100,84,81,265,0.070950469
Rapid City,57785,10458,285,236,221,742,0.070950469
San Francisco-Oak-San Jose,94618,16237,351,341,460,1152,0.070949067
Bangor,4416,5511,146,119,126,391,0.070949011
Burlington-Plattsburgh,5777,3270,69,72,91,232,0.070948012
Watertown,13083,2072,59,53,35,147,0.070945946
La Crosse-Eau Claire,54563,592,25,10,7,42,0.070945946
Baton Rouge,70759,1184,29,28,27,84,0.070945946
Anchorage,99603,11150,288,257,246,791,0.070941704
Sioux City,51010,437,16,7,8,31,0.070938215
Wichita Falls & Lawton,73481,874,29,19,14,62,0.070938215
New York,7004,8007,202,216,150,568,0.070937929
Oklahoma City,73664,1015,31,21,20,72,0.070935961
St. Louis,62218,1593,40,33,40,113,0.070935342
Roanoke-Lynchburg,24174,2312,56,53,55,164,0.070934256
Chattanooga,37333,578,18,13,10,41,0.070934256
San Francisco-Oak-San Jose,94930,8656,248,204,162,614,0.070933457
Orlando-Daytona Bch-Melbrn,32796,21034,526,483,483,1492,0.070932776
Pittsburgh,15445,2876,66,64,74,204,0.07093185
Wilkes Barre-Scranton-Hztn,17925,719,17,19,15,51,0.07093185
Philadelphia,18066,5893,157,145,116,418,0.070931614
Milwaukee,53118,6725,199,162,116,477,0.070929368
Evansville,47531,1001,33,22,16,71,0.070929071
Lincoln & Hastings-Krny,68714,1001,26,25,20,71,0.070929071
Binghamton,13733,4681,125,95,112,332,0.070925016
Springfield-Holyoke,1050,2397,59,50,61,170,0.070921986
Boston (Manchester),2639,3384,61,72,107,240,0.070921986
Johnstown-Altoona-St Colge,15778,141,4,3,3,10,0.070921986
Bismarck-Mnt-Dcknsn(Wlstn),58734,282,9,5,6,20,0.070921986
"Charleston, SC",29429,4484,130,100,88,318,0.070918822
Bangor,4912,973,28,28,13,69,0.070914697
Fresno-Visalia,93212,23282,651,543,457,1651,0.070913152
San Francisco-Oak-San Jose,95457,3187,90,56,80,226,0.070913084
Shreveport,71439,1523,43,34,31,108,0.070912672
Richmond-Petersburg,23047,2073,57,47,43,147,0.070911722
Grand Rapids-Kalmzoo-B.Crk,49034,2073,50,44,53,147,0.070911722
Des Moines-Ames,50115,2623,72,51,63,186,0.07091117
Philadelphia,8089,3582,74,86,94,254,0.070910106
San Francisco-Oak-San Jose,94925,10027,327,231,153,711,0.070908547
Minneapolis-St. Paul,55381,1918,46,53,37,136,0.070907195
Lincoln & Hastings-Krny,68817,409,12,11,6,29,0.070904645
Tallahassee-Thomasville,32348,11227,323,231,242,796,0.070900508
Springfield-Holyoke,1355,945,25,21,21,67,0.070899471
Fargo,56581,268,8,6,5,19,0.070895522
Chicago,60129,268,7,6,6,19,0.070895522
Monroe-El Dorado,71237,804,22,15,20,57,0.070895522
Dallas-Ft. Worth,75492,536,15,14,9,38,0.070895522
Norfolk-Portsmth-Newpt Nws,23437,4683,124,97,111,332,0.070894726
Binghamton,13746,2934,69,72,67,208,0.070892979
Wausau-Rhinelander,54482,8929,255,208,170,633,0.070892597
Louisville,47120,931,27,21,18,66,0.070891515
Omaha,68029,931,30,17,19,66,0.070891515
Burlington-Plattsburgh,5743,4246,105,99,97,301,0.07089025
Minneapolis-St. Paul,56678,1326,39,29,26,94,0.070889894
Cedar Rapids-Wtrlo-IWC&Dub,50602,1453,38,29,36,103,0.070887818
Springfield-Holyoke,1054,1848,46,42,43,131,0.070887446
Bangor,4660,1580,42,39,31,112,0.070886076
Wichita Falls & Lawton,79225,790,21,15,20,56,0.070886076
Philadelphia,19403,45680,932,1019,1287,3238,0.070884413
New York,12446,4712,119,110,105,334,0.070882852
Wausau-Rhinelander,54475,1439,36,35,31,102,0.070882557
"Charleston, SC",29482,1961,77,41,21,139,0.070882203
Albuquerque-Santa Fe,87553,1044,32,24,18,74,0.070881226
"Jackson, TN",38391,1171,31,28,24,83,0.07087959
Minneapolis-St. Paul,55302,7393,246,158,120,524,0.070877857
Omaha,68446,2723,80,67,46,193,0.070877708
Green Bay-Appleton,54153,7238,201,161,151,513,0.070875933
Pittsburgh,16248,3203,88,74,65,227,0.070871058
Mankato,56037,1792,50,40,37,127,0.070870536
Davenport-R.Island-Moline,61270,6886,191,142,155,488,0.070868429
Pittsburgh,15490,381,10,8,9,27,0.070866142
"Washington, DC (Hagrstwn)",20606,381,8,10,9,27,0.070866142
"Washington, DC (Hagrstwn)",21790,127,4,3,2,9,0.070866142
Des Moines-Ames,50168,889,28,22,13,63,0.070866142
Fargo,56744,381,12,8,7,27,0.070866142
Billings,59318,127,4,3,2,9,0.070866142
St. Louis,62892,254,7,6,5,18,0.070866142
Paducah-Cape Girard-Harsbg,63748,889,24,20,19,63,0.070866142
Amarillo,88419,127,4,2,3,9,0.070866142
Yakima-Pasco-Rchlnd-Knnwck,97839,381,14,9,4,27,0.070866142
Los Angeles,90272,22734,717,566,328,1611,0.070863025
Bangor,4941,1764,51,38,36,125,0.070861678
Chicago,60964,4657,121,95,114,330,0.070861069
Burlington-Plattsburgh,12967,1256,32,34,23,89,0.070859873
New York,12585,1002,24,21,26,71,0.070858283
Evansville,47638,3486,103,75,69,247,0.070854848
Sioux Falls(Mitchell),57067,494,10,15,10,35,0.070850202
Honolulu,96748,4446,132,99,84,315,0.070850202
Albuquerque-Santa Fe,87122,18871,551,436,350,1337,0.070849452
Pittsburgh,15618,2089,50,46,52,148,0.070847295
Fargo,56726,1228,36,29,22,87,0.070846906
New York,6784,3557,94,87,71,252,0.070846219
Johnstown-Altoona-St Colge,16647,734,21,18,13,52,0.070844687
Wilkes Barre-Scranton-Hztn,18447,10502,261,214,269,744,0.070843649
Portland-Auburn,4064,9613,152,272,257,681,0.070841569
Dallas-Ft. Worth,76639,1821,47,37,45,129,0.070840198
Norfolk-Portsmth-Newpt Nws,27818,1087,25,23,29,77,0.070837167
Buffalo,14054,1327,41,29,24,94,0.070836473
"Springfield, MO",65632,3007,68,69,76,213,0.070834719
Hartford & New Haven,6035,7440,218,161,148,527,0.070833333
Pittsburgh,15310,240,7,5,5,17,0.070833333
Johnstown-Altoona-St Colge,16861,240,6,6,5,17,0.070833333
Parkersburg,45773,240,5,7,5,17,0.070833333
Indianapolis,47357,1200,31,26,28,85,0.070833333
Greensboro-H.Point-W.Salem,27019,3586,81,87,86,254,0.070831009
Hartford & New Haven,6524,5238,133,138,100,371,0.070828561
Lansing,49259,2499,62,55,60,177,0.070828331
"Portland, OR",97109,593,16,14,12,42,0.070826307
"Portland, OR",97034,21321,692,505,313,1510,0.070822194
Sioux Falls(Mitchell),56141,353,10,6,9,25,0.07082153
Sioux Falls(Mitchell),57031,706,23,15,12,50,0.07082153
Nashville,38551,3869,113,87,74,274,0.070819333
Omaha,68037,2810,88,60,51,199,0.070818505
"Washington, DC (Hagrstwn)",26763,1638,47,37,32,116,0.070818071
Bangor,4463,2923,82,69,56,207,0.070817653
Ft. Wayne,46730,1398,35,35,29,99,0.070815451
Parkersburg,45768,1624,36,43,36,115,0.070812808
Indianapolis,46117,579,16,13,12,41,0.070811744
Lincoln & Hastings-Krny,68873,3460,101,58,86,245,0.070809249
New York,7035,10818,249,243,274,766,0.070807913
Albany-Schenectady-Troy,12140,1610,42,40,32,114,0.070807453
"Portland, OR",97133,6440,162,143,151,456,0.070807453
Chicago,60190,10861,281,240,248,769,0.070803793
Buffalo,14083,113,3,3,2,8,0.07079646
Minneapolis-St. Paul,56152,1356,30,29,37,96,0.07079646
Billings,59314,113,3,3,2,8,0.07079646
Columbia-Jefferson City,65244,452,13,10,9,32,0.07079646
Casper-Riverton,82643,339,12,8,4,24,0.07079646
Boston (Manchester),1940,13250,391,331,216,938,0.070792453
Nashville,38588,1229,33,29,25,87,0.07078926
"Albany, GA",31756,1003,27,23,21,71,0.070787637
Topeka,66060,1003,35,19,17,71,0.070787637
Idaho Fals-Pocatllo(Jcksn),83455,6555,200,131,133,464,0.07078566
"Washington, DC (Hagrstwn)",22644,2331,61,52,52,165,0.070785071
Roanoke-Lynchburg,24150,664,19,13,15,47,0.070783133
"Washington, DC (Hagrstwn)",22650,989,28,21,21,70,0.070778564
New York,12466,2854,46,68,88,202,0.070777856
La Crosse-Eau Claire,54526,876,32,19,11,62,0.070776256
Indianapolis,46068,2727,81,51,61,193,0.070773744
Ft. Myers-Naples,33920,10456,262,249,229,740,0.070772762
"Rochester, NY",14516,2176,61,50,43,154,0.070772059
Dallas-Ft. Worth,75476,1088,28,26,23,77,0.070772059
Minneapolis-St. Paul,55439,9029,286,235,118,639,0.070771957
Portland-Auburn,4093,8549,201,198,206,605,0.070768511
Traverse City-Cadillac,49633,4112,118,84,89,291,0.070768482
Wilkes Barre-Scranton-Hztn,17921,7136,190,153,162,505,0.070767937
Monterey-Salinas,93953,4211,184,70,44,298,0.070767039
Portland-Auburn,3887,2049,51,45,49,145,0.070766227
"Columbus, OH",45742,2685,73,62,55,190,0.070763501
Shreveport,71416,749,18,20,15,53,0.070761015
Seattle-Tacoma,98367,32179,874,713,690,2277,0.070760434
Cedar Rapids-Wtrlo-IWC&Dub,52654,1597,46,33,34,113,0.070757671
Portland-Auburn,4841,7222,126,172,213,511,0.070756023
Charleston-Huntington,41201,212,6,4,5,15,0.070754717
Des Moines-Ames,50845,848,25,14,21,60,0.070754717
Sioux Falls(Mitchell),57047,212,7,5,3,15,0.070754717
Amarillo,73844,212,6,5,4,15,0.070754717
Dallas-Ft. Worth,75218,23617,496,531,644,1671,0.070754118
Pittsburgh,15954,2007,47,51,44,142,0.070752367
Charleston-Huntington,25275,2106,58,42,49,149,0.070750237
"Springfield, MO",65786,2106,55,47,47,149,0.070750237
Philadelphia,18080,11873,309,255,276,840,0.070748758
San Francisco-Oak-San Jose,94065,13428,399,280,271,950,0.070747691
Pittsburgh,26547,2615,73,52,60,185,0.070745698
Norfolk-Portsmth-Newpt Nws,23089,5739,161,118,127,406,0.070744032
New York,7419,9485,221,208,242,671,0.070743279
Miami-Ft. Lauderdale,33010,45872,934,1152,1159,3245,0.070740321
Syracuse,13060,2799,71,63,64,198,0.07073955
"Washington, DC (Hagrstwn)",25411,12568,307,293,289,889,0.070735201
Seattle-Tacoma,98332,21220,588,489,424,1501,0.070735156
Champaign&Sprngfld-Decatur,61924,2163,63,48,42,153,0.07073509
Columbia-Jefferson City,65262,721,23,15,13,51,0.07073509
Pittsburgh,15116,14067,349,301,345,995,0.070732921
Wilkes Barre-Scranton-Hztn,17960,3789,99,88,81,268,0.070731064
Burlington-Plattsburgh,5354,2149,55,45,52,152,0.070730572
Peoria-Bloomington,61771,919,26,19,20,65,0.070729053
Wheeling-Steubenville,43716,1937,64,39,34,137,0.07072793
Kansas City,66080,1018,30,23,19,72,0.070726916
Burlington-Plattsburgh,12926,2135,58,40,53,151,0.070725995
Greensboro-H.Point-W.Salem,28665,2531,66,57,56,179,0.070723034
Idaho Fals-Pocatllo(Jcksn),83420,2616,83,57,45,185,0.070718654
Harrisburg-Lncstr-Leb-York,17214,1004,32,18,21,71,0.070717131
Philadelphia,18088,9121,243,203,199,645,0.07071593
Burlington-Plattsburgh,5770,1202,28,18,39,85,0.070715474
Monterey-Salinas,93950,14806,367,318,362,1047,0.070714575
Omaha,51652,1499,46,32,28,106,0.070713809
Providence-New Bedford,2879,21638,483,534,513,1530,0.070708938
Toledo,43558,13181,368,302,262,932,0.070707837
Pittsburgh,15688,495,13,10,12,35,0.070707071
Minneapolis-St. Paul,54826,792,22,16,18,56,0.070707071
Lincoln & Hastings-Krny,68934,198,6,4,4,14,0.070707071
Harrisburg-Lncstr-Leb-York,17020,8896,202,187,240,629,0.070705935
Monterey-Salinas,95073,9264,224,215,216,655,0.0707038
Philadelphia,8210,17270,432,402,387,1221,0.070700637
Idaho Fals-Pocatllo(Jcksn),83255,1075,40,22,14,76,0.070697674
Paducah-Cape Girard-Harsbg,38232,1952,44,45,49,138,0.070696721
Davenport-R.Island-Moline,61488,976,23,26,20,69,0.070696721
"Springfield, MO",65626,1655,36,43,38,117,0.070694864
Albany-Schenectady-Troy,12106,2235,48,59,51,158,0.070693512
Toledo,44844,679,18,16,14,48,0.070692194
Fargo,58458,1259,34,25,30,89,0.070691025
Abilene-Sweetwater,76834,4937,140,115,94,349,0.070690703
Sioux Falls(Mitchell),57028,3480,101,70,75,246,0.070689655
Detroit,48080,21715,421,483,631,1535,0.070688464
Sacramnto-Stkton-Modesto,95658,7045,194,172,132,498,0.070688432
Topeka,66440,2023,64,46,33,143,0.070687098
"Washington, DC (Hagrstwn)",22726,962,28,19,21,68,0.070686071
"Portland, OR",97065,962,24,25,19,68,0.070686071
"Rochester, NY",14475,382,11,11,5,27,0.070680628
"Washington, DC (Hagrstwn)",20645,764,30,14,10,54,0.070680628
Richmond-Petersburg,23140,6296,191,129,125,445,0.070679797
St. Louis,62899,1712,44,32,45,121,0.07067757
Wichita Falls & Lawton,76357,665,16,13,18,47,0.070676692
Hartford & New Haven,6037,18663,486,399,434,1319,0.070674597
Bismarck-Mnt-Dcknsn(Wlstn),59336,283,8,6,6,20,0.070671378
San Antonio,78122,283,7,6,7,20,0.070671378
"Portland, OR",97738,2165,59,46,48,153,0.070669746
Portland-Auburn,4268,5264,138,113,121,372,0.070668693
Boston (Manchester),1960,54989,1160,1257,1469,3886,0.070668679
Indianapolis,46951,2066,59,48,39,146,0.070667957
Duluth-Superior,55741,3099,94,76,49,219,0.070667957
Harrisburg-Lncstr-Leb-York,17363,9467,253,205,211,669,0.070666526
Wheeling-Steubenville,26146,934,25,20,21,66,0.070663812
Cedar Rapids-Wtrlo-IWC&Dub,50669,2335,68,49,48,165,0.070663812
Lincoln & Hastings-Krny,68466,1585,50,32,30,112,0.070662461
Hartford & New Haven,6420,4472,114,100,102,316,0.070661896
Marquette,49894,651,16,17,13,46,0.070660522
Syracuse,14882,3892,118,80,77,275,0.07065776
Ft. Smith-Fay-Sprngdl-Rgrs,72938,1203,36,26,23,85,0.070656692
Buffalo,14143,1387,35,26,37,98,0.070656092
Albany-Schenectady-Troy,12526,3694,86,83,92,261,0.070655116
Harrisburg-Lncstr-Leb-York,17963,9030,241,209,188,638,0.070653378
Buffalo,16740,920,27,18,20,65,0.070652174
Toledo,43522,3496,95,87,65,247,0.070652174
Des Moines-Ames,50038,184,6,4,3,13,0.070652174
Des Moines-Ames,50833,2293,60,50,52,162,0.070649804
"Springfield, MO",65444,1189,32,24,28,84,0.070647603
Syracuse,13480,3199,75,79,72,226,0.070647077
"Portland, OR",97107,1642,48,36,32,116,0.070645554
Honolulu,96814,26060,406,616,819,1841,0.070644666
Burlington-Plattsburgh,5089,5096,126,125,109,360,0.070643642
Boston (Manchester),1473,8466,244,186,168,598,0.070635483
Grand Rapids-Kalmzoo-B.Crk,49306,10859,311,264,192,767,0.070632655
Oklahoma City,74878,1345,39,30,26,95,0.07063197
Cincinnati,45684,2053,70,39,36,145,0.070628349
Paducah-Cape Girard-Harsbg,42045,2138,54,51,46,151,0.070626754
"Tri-Cities, TN-VA",24258,1246,31,27,30,88,0.070626003
St. Louis,62889,793,24,18,14,56,0.070617907
Wilkes Barre-Scranton-Hztn,18615,1671,41,35,42,118,0.070616397
Little Rock-Pine Bluff,72543,12221,308,297,258,863,0.070616153
Ft. Wayne,46941,1317,39,26,28,93,0.070615034
Buffalo,14728,963,24,25,19,68,0.070612669
Peoria-Bloomington,61441,963,26,20,22,68,0.070612669
"Tri-Cities, TN-VA",41764,524,14,12,11,37,0.070610687
St. Joseph,64448,1133,30,23,27,80,0.070609003
Indianapolis,47244,694,20,15,14,49,0.070605187
Harrisburg-Lncstr-Leb-York,17098,2422,61,47,63,171,0.070602808
Harrisburg-Lncstr-Leb-York,17051,4490,120,96,101,317,0.070601336
St. Louis,62422,949,23,23,21,67,0.070600632
Des Moines-Ames,50025,2918,71,66,69,206,0.070596299
Charlotte,28657,9576,251,219,206,676,0.07059315
Presque Isle,4471,595,19,11,12,42,0.070588235
Presque Isle,4780,680,22,14,12,48,0.070588235
Johnstown-Altoona-St Colge,15784,85,2,2,2,6,0.070588235
"Washington, DC (Hagrstwn)",22743,170,5,4,3,12,0.070588235
Richmond-Petersburg,23938,425,10,9,11,30,0.070588235
Evansville,42326,255,6,7,5,18,0.070588235
Wichita-Hutchinson Plus,67150,85,2,2,2,6,0.070588235
Lincoln & Hastings-Krny,68950,340,10,7,7,24,0.070588235
Amarillo,73937,170,4,3,5,12,0.070588235
Rapid City,82836,1020,34,23,15,72,0.070588235
Eureka,95536,2706,78,55,58,191,0.070583888
Sioux Falls(Mitchell),57223,1516,52,32,23,107,0.070580475
Paducah-Cape Girard-Harsbg,42021,1346,40,31,24,95,0.070579495
"Albany, GA",39862,1006,23,27,21,71,0.070576541
Miami-Ft. Lauderdale,33321,52257,1197,1250,1241,3688,0.070574277
Wheeling-Steubenville,43910,3259,91,74,65,230,0.070573796
Portland-Auburn,4543,2423,58,52,61,171,0.070573669
Bismarck-Mnt-Dcknsn(Wlstn),58790,1502,53,32,21,106,0.07057257
Bluefield-Beckley-Oak Hill,24630,5668,147,127,126,400,0.07057163
Bangor,4450,1332,36,21,37,94,0.070570571
Rochestr-Mason City-Austin,50653,581,16,13,12,41,0.070567986
Sioux Falls(Mitchell),57427,581,19,12,10,41,0.070567986
Dallas-Ft. Worth,76673,1162,33,28,21,82,0.070567986
Harrisburg-Lncstr-Leb-York,17584,10855,261,246,259,766,0.070566559
Denver,82334,411,15,7,7,29,0.070559611
Atlanta,30625,2792,76,62,59,197,0.070558739
Duluth-Superior,55769,2367,59,52,56,167,0.070553443
Harrisburg-Lncstr-Leb-York,17029,326,11,7,5,23,0.070552147
Fargo,58018,326,11,7,5,23,0.070552147
Wausau-Rhinelander,54454,1219,36,23,27,86,0.070549631
"Columbus, OH",45744,2594,64,65,54,183,0.070547417
"Washington, DC (Hagrstwn)",20630,567,15,13,12,40,0.070546737
Spokane,99159,1375,39,32,26,97,0.070545455
Cedar Rapids-Wtrlo-IWC&Dub,50606,808,26,20,11,57,0.070544554
Champaign&Sprngfld-Decatur,62461,808,19,20,18,57,0.070544554
Boston (Manchester),3268,1290,30,33,28,91,0.070542636
Pittsburgh,15063,10958,252,241,280,773,0.07054207
Lexington,42518,2977,73,62,75,210,0.070540813
Charleston-Huntington,41226,241,9,4,4,17,0.070539419
Fargo,58222,241,5,6,6,17,0.070539419
Columbia-Jefferson City,65232,241,7,4,6,17,0.070539419
Medford-Klamath Falls,97638,723,24,15,12,51,0.070539419
Cedar Rapids-Wtrlo-IWC&Dub,52073,1602,49,37,27,113,0.070536829
Jacksonville,31569,5487,152,133,102,387,0.070530344
"Columbia, SC",29133,794,20,18,18,56,0.070528967
Sioux Falls(Mitchell),57268,397,9,9,10,28,0.070528967
Wichita-Hutchinson Plus,67844,794,17,15,24,56,0.070528967
Green Bay-Appleton,54981,14874,361,353,335,1049,0.07052575
Flint-Saginaw-Bay City,48615,2765,73,64,58,195,0.070524412
Albuquerque-Santa Fe,87565,553,14,12,13,39,0.070524412
Phoenix (Prescott),85205,43689,1053,1012,1016,3081,0.070521184
Columbia-Jefferson City,65591,1574,47,37,27,111,0.070520966
Springfield-Holyoke,1379,865,28,20,13,61,0.070520231
Youngstown,44436,3375,81,79,78,238,0.070518519
Baltimore,20759,8069,287,168,114,569,0.070516793
Boston (Manchester),2132,28816,585,665,782,2032,0.07051638
Montgomery-Selma,36036,1872,50,38,44,132,0.070512821
Cedar Rapids-Wtrlo-IWC&Dub,52047,468,16,9,8,33,0.070512821
Sioux Falls(Mitchell),57246,156,4,4,3,11,0.070512821
Grand Junction-Montrose,81624,1248,37,29,22,88,0.070512821
Cedar Rapids-Wtrlo-IWC&Dub,52076,2099,56,52,40,148,0.070509767
Charleston-Huntington,41557,1631,41,38,36,115,0.07050889
Cleveland-Akron (Canton),44140,15559,495,355,247,1097,0.070505817
St. Louis,62061,1702,50,34,36,120,0.070505288
San Antonio,77964,8737,233,186,197,616,0.07050475
Sioux Falls(Mitchell),56128,2085,63,40,44,147,0.070503597
Lincoln & Hastings-Krny,68372,4014,124,69,90,283,0.070503239
Topeka,66508,4397,136,88,86,310,0.070502615
"Washington, DC (Hagrstwn)",20628,539,13,13,12,38,0.070500928
Burlington-Plattsburgh,3768,1688,51,38,30,119,0.07049763
Champaign&Sprngfld-Decatur,62518,383,12,9,6,27,0.070496084
St. Louis,63122,40998,1203,957,730,2890,0.070491243
Milwaukee,53036,3504,111,71,65,247,0.070490868
Harrisburg-Lncstr-Leb-York,17360,6611,195,140,131,466,0.07048858
Greenville-N.Bern-Washngtn,27924,2582,63,58,61,182,0.070487994
Flint-Saginaw-Bay City,48445,1291,38,29,24,91,0.070487994
"Washington, DC (Hagrstwn)",17238,1745,41,45,37,123,0.070487106
Boston (Manchester),2071,908,25,20,19,64,0.070484581
Omaha,51536,454,15,11,6,32,0.070484581
Hartford & New Haven,6447,6200,182,136,119,437,0.070483871
Madison,53555,8669,236,196,179,611,0.070481024
Wilkes Barre-Scranton-Hztn,18821,979,29,19,21,69,0.070480082
Watertown,13145,1731,44,46,32,122,0.070479492
Buffalo,16923,1348,32,34,29,95,0.070474777
Roanoke-Lynchburg,24577,4640,120,115,92,327,0.070474138
Sioux City,51529,1646,42,38,36,116,0.070473876
New York,12525,3363,84,77,76,237,0.070472792
New York,11697,4399,100,127,83,310,0.070470561
Buffalo,14134,298,9,6,6,21,0.070469799
Great Falls,59531,298,6,7,8,21,0.070469799
Albuquerque-Santa Fe,87042,3278,80,78,73,231,0.070469799
Rochestr-Mason City-Austin,55935,965,30,22,16,68,0.070466321
Bismarck-Mnt-Dcknsn(Wlstn),58552,1632,50,31,34,115,0.070465686
Chicago,60919,369,11,8,7,26,0.070460705
Sacramnto-Stkton-Modesto,95603,27746,673,635,647,1955,0.070460607
Wheeling-Steubenville,26060,1547,40,34,35,109,0.070458953
Knoxville,37866,2058,64,39,42,145,0.070456754
Boston (Manchester),1929,3747,117,82,65,264,0.070456365
Davenport-R.Island-Moline,61025,4400,122,94,94,310,0.070454545
Wichita Falls & Lawton,76360,2853,80,54,67,201,0.070452156
New York,7716,8460,201,197,198,596,0.070449173
Eugene,97431,2470,67,58,49,174,0.070445344
Minneapolis-St. Paul,55446,30806,987,647,536,2170,0.070440823
"Portland, OR",97754,23979,641,508,540,1689,0.070436632
Elmira (Corning),16914,2087,48,46,53,147,0.070436033
Tampa-St. Pete (Sarasota),33778,14368,371,325,316,1012,0.070434298
Cedar Rapids-Wtrlo-IWC&Dub,52223,1434,40,39,22,101,0.070432357
Waco-Temple-Bryan,77837,1434,38,31,32,101,0.070432357
Traverse City-Cadillac,49721,14327,365,330,314,1009,0.070426468
Pittsburgh,15615,71,2,1,2,5,0.070422535
Roanoke-Lynchburg,22976,213,4,6,5,15,0.070422535
Roanoke-Lynchburg,24322,213,5,5,5,15,0.070422535
Bluefield-Beckley-Oak Hill,24916,355,9,9,7,25,0.070422535
Clarksburg-Weston,26266,142,5,2,3,10,0.070422535
Rochestr-Mason City-Austin,50464,568,15,12,13,40,0.070422535
Sioux City,51005,1420,36,29,35,100,0.070422535
Bismarck-Mnt-Dcknsn(Wlstn),57660,71,1,2,2,5,0.070422535
Fargo,58069,142,4,3,3,10,0.070422535
Kansas City,64638,426,12,9,9,30,0.070422535
Omaha,68321,355,11,8,6,25,0.070422535
Jonesboro,72569,355,9,8,8,25,0.070422535
Greensboro-H.Point-W.Salem,24171,7796,189,171,189,549,0.070420729
Des Moines-Ames,50171,2755,74,57,63,194,0.070417423
Hartford & New Haven,6763,2187,47,56,51,154,0.070416095
Honolulu,96708,11049,267,229,282,778,0.070413612
Fargo,58474,2528,79,42,57,178,0.070411392
Boston (Manchester),2343,11291,263,239,293,795,0.070410061
Wausau-Rhinelander,54538,3011,76,64,72,212,0.070408502
Roanoke-Lynchburg,24350,1179,25,31,27,83,0.070398643
Portland-Auburn,3906,5270,137,133,101,371,0.070398482
Medford-Klamath Falls,96044,1037,29,23,21,73,0.070395371
Boston (Manchester),1938,14774,366,335,339,1040,0.070393935
Sioux Falls(Mitchell),57330,483,15,9,10,34,0.070393375
Quincy-Hannibal-Keokuk,62354,1307,32,29,31,92,0.070390207
Albany-Schenectady-Troy,12164,412,6,7,16,29,0.07038835
Hartford & New Haven,6481,1165,34,24,24,82,0.070386266
Joplin-Pittsburg,74370,3424,99,71,71,241,0.070385514
Cedar Rapids-Wtrlo-IWC&Dub,52079,753,15,14,24,53,0.070385126
Cedar Rapids-Wtrlo-IWC&Dub,52156,753,21,18,14,53,0.070385126
Bismarck-Mnt-Dcknsn(Wlstn),58843,753,25,15,13,53,0.070385126
Elmira (Corning),14871,4433,115,113,84,312,0.070381232
Lexington,41314,3751,101,86,77,264,0.070381232
Wilkes Barre-Scranton-Hztn,17961,6593,160,166,138,464,0.070377673
Dallas-Ft. Worth,76239,1222,34,30,22,86,0.070376432
Miami-Ft. Lauderdale,33040,34742,711,801,933,2445,0.070375914
St. Joseph,64401,1549,43,35,31,109,0.070367979
Jacksonville,32187,1748,53,32,38,123,0.070366133
Burlington-Plattsburgh,5155,739,21,13,18,52,0.070365359
St. Louis,62019,469,14,11,8,33,0.070362473
Pittsburgh,15829,1066,26,25,24,75,0.070356473
New York,11976,2658,68,69,50,187,0.070353649
Austin,78070,25344,734,583,466,1783,0.070351957
Burlington-Plattsburgh,5459,1791,42,32,52,126,0.070351759
"Washington, DC (Hagrstwn)",22736,597,17,12,13,42,0.070351759
"Washington, DC (Hagrstwn)",26739,796,20,18,18,56,0.070351759
Peoria-Bloomington,61532,398,8,11,9,28,0.070351759
Lincoln & Hastings-Krny,68627,597,18,7,17,42,0.070351759
Chicago,60021,5487,139,126,121,386,0.070348095
"Tri-Cities, TN-VA",37618,12808,332,283,286,901,0.070346658
Seattle-Tacoma,98019,12936,411,303,196,910,0.07034632
Wilkes Barre-Scranton-Hztn,17938,2374,68,48,51,167,0.070345409
Burlington-Plattsburgh,12956,1450,37,31,34,102,0.070344828
Harrisburg-Lncstr-Leb-York,17018,4350,128,93,85,306,0.070344828
Lincoln & Hastings-Krny,68428,1450,48,32,22,102,0.070344828
"Columbia, SC",29127,9226,251,202,196,649,0.070344678
"Charleston, SC",29468,1777,57,33,35,125,0.070343275
Des Moines-Ames,50061,2303,78,52,32,162,0.070343031
"Portland, OR",97343,526,17,11,9,37,0.070342205
Grand Rapids-Kalmzoo-B.Crk,49050,1379,37,34,26,97,0.070340827
St. Louis,63128,29116,701,715,632,2048,0.070339332
Bluefield-Beckley-Oak Hill,25832,4123,123,92,75,290,0.070337133
Minneapolis-St. Paul,55785,327,9,6,8,23,0.070336391
"Washington, DC (Hagrstwn)",21530,1493,36,32,37,105,0.070328198
Burlington-Plattsburgh,5772,583,18,11,12,41,0.070325901
Detroit,48009,21614,620,472,428,1520,0.070324789
Hartford & New Haven,6405,28326,584,653,755,1992,0.070324084
Columbia-Jefferson City,65014,2261,58,56,45,159,0.070322866
Minneapolis-St. Paul,56260,839,23,19,17,59,0.070321812
Denver,80238,32025,1107,577,568,2252,0.070320062
Providence-New Bedford,2916,8177,163,199,213,575,0.070319188
New York,10605,19824,485,466,443,1394,0.070318805
St. Louis,63124,10865,342,263,159,764,0.070317533
Burlington-Plattsburgh,5640,128,4,3,2,9,0.0703125
New York,11977,3200,75,76,74,225,0.0703125
Utica,13488,128,4,3,2,9,0.0703125
Charleston-Huntington,25051,128,4,3,2,9,0.0703125
Meridian,36910,128,3,3,3,9,0.0703125
Albuquerque-Santa Fe,87823,512,14,12,10,36,0.0703125
Albuquerque-Santa Fe,87828,256,7,6,5,18,0.0703125
Sacramnto-Stkton-Modesto,95972,128,4,1,4,9,0.0703125
Traverse City-Cadillac,49431,17252,455,389,369,1213,0.070310689
Denver,80033,29313,541,644,876,2061,0.070310101
"Portland, OR",97378,9060,235,204,198,637,0.070309051
Portland-Auburn,4989,4068,113,85,88,286,0.070304818
Evansville,47575,1266,33,28,28,89,0.070300158
Hartford & New Haven,6791,5505,157,117,113,387,0.070299728
Tampa-St. Pete (Sarasota),33764,28479,538,672,792,2002,0.070297412
Pittsburgh,26410,882,24,14,24,62,0.070294785
Green Bay-Appleton,49886,441,11,11,9,31,0.070294785
San Antonio,76849,3528,85,73,90,248,0.070294785
"Columbus, OH",43076,9759,249,229,208,686,0.070294088
Denver,80007,19248,640,432,281,1353,0.070293017
Baltimore,21048,10798,274,256,229,759,0.070290795
Waco-Temple-Bryan,75846,2447,65,56,51,172,0.070290151
Paducah-Cape Girard-Harsbg,62828,1380,38,27,32,97,0.070289855
Wilkes Barre-Scranton-Hztn,18832,1693,36,38,45,119,0.070289427
Sioux Falls(Mitchell),56165,313,9,6,7,22,0.07028754
Evansville,62818,313,7,8,7,22,0.07028754
Norfolk-Portsmth-Newpt Nws,27944,11681,298,270,253,821,0.070285078
Madison,53968,2433,66,54,51,171,0.0702836
Davenport-R.Island-Moline,61085,3116,96,64,59,219,0.070282413
Detroit,48441,3799,100,84,83,267,0.070281653
Omaha,51467,498,11,11,13,35,0.070281124
Madison,53954,6972,196,162,132,490,0.070281124
Johnstown-Altoona-St Colge,16833,5222,116,124,127,367,0.070279586
New Orleans,70355,868,27,17,17,61,0.070276498
New Orleans,70431,6133,163,141,127,431,0.070275558
Charleston-Huntington,25270,925,28,19,18,65,0.07027027
Cincinnati,41064,2035,58,39,46,143,0.07027027
Baton Rouge,70761,740,18,17,17,52,0.07027027
Oklahoma City,74636,185,6,3,4,13,0.07027027
Waco-Temple-Bryan,76678,185,6,4,3,13,0.07027027
Utica,13439,3686,85,82,92,259,0.070265871
Grand Rapids-Kalmzoo-B.Crk,49026,2149,51,50,50,151,0.07026524
South Bend-Elkhart,46538,3985,106,85,89,280,0.070263488
Buffalo,14427,2078,59,44,43,146,0.070259865
Butte-Bozeman,59634,5864,200,130,82,412,0.070259209
Cincinnati,45168,1708,49,30,41,120,0.070257611
Cedar Rapids-Wtrlo-IWC&Dub,52765,427,11,8,11,30,0.070257611
Ft. Smith-Fay-Sprngdl-Rgrs,72959,3046,86,73,55,214,0.070256074
Roanoke-Lynchburg,24085,2249,69,42,47,158,0.070253446
"Columbia, SC",29166,911,21,19,24,64,0.07025247
New York,11968,15160,377,348,340,1065,0.07025066
Presque Isle,4787,484,15,11,8,34,0.070247934
Pittsburgh,15413,484,11,12,11,34,0.070247934
Columbia-Jefferson City,65068,783,22,17,16,55,0.070242656
Shreveport,75571,2406,63,56,50,169,0.070241064
Rapid City,57552,541,18,9,11,38,0.070240296
"Springfield, MO",65588,2164,53,55,44,152,0.070240296
Austin,78632,1082,31,22,23,76,0.070240296
Greensboro-H.Point-W.Salem,24133,2221,55,52,49,156,0.070238631
Traverse City-Cadillac,49614,3118,88,70,61,219,0.070237332
Philadelphia,19504,5624,139,120,136,395,0.070234708
Salisbury,19931,299,8,7,6,21,0.070234114
"Columbus, OH",43342,3289,86,65,80,231,0.070234114
Harrisonburg,24431,2506,62,55,59,176,0.070231445
Yuma-El Centro,92225,20931,531,510,429,1470,0.070230758
Des Moines-Ames,52574,655,16,17,13,46,0.070229008
Cleveland-Akron (Canton),44903,30002,748,703,656,2107,0.070228651
Bluefield-Beckley-Oak Hill,25971,1011,30,22,19,71,0.070227498
Sioux Falls(Mitchell),56186,356,12,8,5,25,0.070224719
Fargo,56722,356,8,9,8,25,0.070224719
Sioux Falls(Mitchell),57438,1424,43,22,35,100,0.070224719
Oklahoma City,73666,356,12,8,5,25,0.070224719
Sioux City,51025,2008,40,52,49,141,0.070219124
Boston (Manchester),1833,8445,238,198,157,593,0.070219065
Lima,45877,2122,58,52,39,149,0.070216777
Youngstown,44441,1766,50,39,35,124,0.070215176
Fargo,58081,883,30,19,13,62,0.070215176
Peoria-Bloomington,61477,470,14,9,10,33,0.070212766
Omaha,68648,470,13,10,10,33,0.070212766
Pittsburgh,15666,15852,363,364,386,1113,0.070211961
Ft. Smith-Fay-Sprngdl-Rgrs,72952,2407,74,54,41,169,0.070211882
Hartford & New Haven,6074,26919,793,569,528,1890,0.070210632
Cleveland-Akron (Canton),44149,19955,525,480,396,1401,0.070207968
Minneapolis-St. Paul,54843,12805,349,286,264,899,0.07020695
Nashville,38454,1282,35,30,25,90,0.070202808
Greenville-N.Bern-Washngtn,28580,11254,293,254,243,790,0.070197263
Portland-Auburn,4219,1624,42,36,36,114,0.070197044
Bangor,4943,1624,42,37,35,114,0.070197044
Oklahoma City,73009,926,27,18,20,65,0.070194384
Los Angeles,91207,10243,234,210,275,719,0.070194279
Greensboro-H.Point-W.Salem,27022,1439,39,30,32,101,0.07018763
Portland-Auburn,4258,2935,81,64,61,206,0.070187394
Albany-Schenectady-Troy,12018,7537,206,172,151,529,0.070187077
Miami-Ft. Lauderdale,33139,35705,442,796,1268,2506,0.070186248
New York,11935,3491,83,93,69,245,0.070180464
Los Angeles,90278,41422,1043,916,948,2907,0.070180098
St. Louis,62298,17798,498,382,369,1249,0.070176424
Boston (Manchester),3441,285,8,6,6,20,0.070175439
Syracuse,13141,741,18,17,17,52,0.070175439
"Rochester, NY",14479,114,3,3,2,8,0.070175439
"Washington, DC (Hagrstwn)",17223,342,8,7,9,24,0.070175439
Norfolk-Portsmth-Newpt Nws,23050,627,12,14,18,44,0.070175439
Charleston-Huntington,25005,171,5,4,3,12,0.070175439
Davenport-R.Island-Moline,52207,342,11,7,6,24,0.070175439
Green Bay-Appleton,54964,1254,35,26,27,88,0.070175439
Bismarck-Mnt-Dcknsn(Wlstn),57634,171,3,4,5,12,0.070175439
Bismarck-Mnt-Dcknsn(Wlstn),58795,228,7,5,4,16,0.070175439
Wichita-Hutchinson Plus,67583,912,25,19,20,64,0.070175439
Abilene-Sweetwater,76828,171,5,4,3,12,0.070175439
Salt Lake City,83220,57,2,1,1,4,0.070175439
San Francisco-Oak-San Jose,94044,39490,904,925,942,2771,0.070169663
Charleston-Huntington,26147,1639,45,36,34,115,0.070164735
Buffalo,14055,1468,39,29,35,103,0.070163488
Fargo,58042,1468,56,29,18,103,0.070163488
Charleston-Huntington,26335,1411,32,39,28,99,0.070163005
Elmira (Corning),17765,1240,37,24,26,87,0.07016129
Sioux Falls(Mitchell),57442,1796,49,41,36,126,0.070155902
Pittsburgh,15352,784,20,17,18,55,0.070153061
"Washington, DC (Hagrstwn)",26845,784,24,16,15,55,0.070153061
Chattanooga,37308,2851,77,63,60,200,0.070150824
Bangor,4634,1953,47,48,42,137,0.07014849
Los Angeles,92662,2452,50,57,65,172,0.070146819
Albany-Schenectady-Troy,1238,5959,126,152,140,418,0.070145998
Portland-Auburn,4572,5289,133,120,118,371,0.070145585
Wheeling-Steubenville,45767,2281,63,47,50,160,0.070144673
Wichita-Hutchinson Plus,67557,556,19,11,9,39,0.070143885
Omaha,68065,1611,52,30,31,113,0.070142768
Missoula,59825,2666,66,62,59,187,0.070142536
Spokane,99114,12874,346,282,275,903,0.07014137
Syracuse,14847,2438,64,55,52,171,0.070139459
Dallas-Ft. Worth,75844,5318,140,121,112,373,0.07013915
Detroit,48025,14614,451,350,224,1025,0.070138224
Peoria-Bloomington,61748,2709,81,62,47,190,0.070136582
Indianapolis,47352,884,24,18,20,62,0.070135747
Omaha,68346,442,13,10,8,31,0.070135747
Pittsburgh,15451,827,22,18,18,58,0.070133011
Minneapolis-St. Paul,56228,827,26,12,20,58,0.070133011
"Washington, DC (Hagrstwn)",23015,4791,120,118,98,336,0.070131497
Greenvll-Spart-Ashevll-And,28762,6588,144,135,183,462,0.070127505
Wilkes Barre-Scranton-Hztn,17922,4934,130,107,109,346,0.070125659
Charlottesville,22940,1041,27,26,20,73,0.07012488
Lincoln & Hastings-Krny,68825,984,29,23,17,69,0.070121951
San Francisco-Oak-San Jose,94530,25786,504,575,729,1808,0.070115567
Hartford & New Haven,6477,14120,381,338,271,990,0.070113314
Pittsburgh,26374,1412,37,29,33,99,0.070113314
Lincoln & Hastings-Krny,68977,271,8,4,7,19,0.070110701
Sherman-Ada,74558,271,8,7,4,19,0.070110701
Oklahoma City,74850,271,7,6,6,19,0.070110701
Salt Lake City,84027,542,18,12,8,38,0.070110701
"Rochester, NY",14526,21709,598,505,419,1522,0.070109171
Johnstown-Altoona-St Colge,16865,1840,41,49,39,129,0.070108696
Quincy-Hannibal-Keokuk,62326,2325,62,52,49,163,0.070107527
Indianapolis,47358,970,30,18,20,68,0.070103093
Hartford & New Haven,6422,7047,190,170,134,494,0.070100752
Pittsburgh,26570,3438,90,73,78,241,0.070098895
Madison,53541,913,19,21,24,64,0.070098576
Minneapolis-St. Paul,56361,2468,78,52,43,173,0.070097245
Pittsburgh,15237,44583,1073,984,1068,3125,0.070093982
Missoula,59837,428,14,7,9,30,0.070093458
Spokane,99176,214,6,4,5,15,0.070093458
Denver,80005,28405,804,615,572,1991,0.070093293
"Springfield, MO",65606,2882,75,65,62,202,0.070090215
Pittsburgh,15089,6449,154,146,152,452,0.070088386
Terre Haute,62479,799,27,17,12,56,0.07008761
Tulsa,74425,1384,37,25,35,97,0.070086705
Baltimore,21678,1969,55,41,42,138,0.070086338
Marquette,49807,3025,93,71,48,212,0.070082645
Evansville,62833,371,11,9,6,26,0.070080863
Topeka,66543,742,26,15,11,52,0.070080863
Sioux City,51034,1641,40,40,35,115,0.07007922
Omaha,68023,2911,89,61,54,204,0.070079011
Seattle-Tacoma,98596,7592,206,161,165,532,0.070073762
Champaign&Sprngfld-Decatur,61928,685,18,12,18,48,0.070072993
Pittsburgh,16323,14899,364,325,355,1044,0.070071817
Minneapolis-St. Paul,56453,842,24,18,17,59,0.070071259
Minneapolis-St. Paul,54889,2997,79,72,59,210,0.07007007
Omaha,68003,5609,151,120,122,393,0.070065965
Roanoke-Lynchburg,24136,3297,74,80,77,231,0.070063694
"Columbus, GA (Opelika, AL)",36374,942,26,21,19,66,0.070063694
Nashville,37019,785,19,20,16,55,0.070063694
Terre Haute,47861,471,14,11,8,33,0.070063694
Davenport-R.Island-Moline,61473,1570,33,42,35,110,0.070063694
Paducah-Cape Girard-Harsbg,62238,628,18,17,9,44,0.070063694
Waco-Temple-Bryan,76519,628,17,14,13,44,0.070063694
Providence-New Bedford,2715,3811,122,76,69,267,0.070060352
New York,7023,7565,228,188,114,530,0.070059484
Denver,80731,1513,42,34,30,106,0.070059484
Richmond-Petersburg,23942,1199,27,26,31,84,0.070058382
Dayton,43360,1870,54,39,38,131,0.070053476
Burlington-Plattsburgh,12883,4668,115,101,111,327,0.070051414
Buffalo,14026,985,20,23,26,69,0.070050761
Bangor,4923,414,12,9,8,29,0.070048309
Sioux Falls(Mitchell),57522,414,10,11,8,29,0.070048309
Portland-Auburn,4357,3512,83,75,88,246,0.070045558
Harrisburg-Lncstr-Leb-York,17339,5725,167,118,116,401,0.070043668
Wilkes Barre-Scranton-Hztn,18218,2527,60,59,58,177,0.07004353
Burlington-Plattsburgh,5473,1442,33,28,40,101,0.070041609
Mobile-Pensacola (Ft Walt),32541,20203,445,467,503,1415,0.070039103
Bluefield-Beckley-Oak Hill,25978,514,13,12,11,36,0.070038911
Cedar Rapids-Wtrlo-IWC&Dub,52165,871,20,25,16,61,0.070034443
Bismarck-Mnt-Dcknsn(Wlstn),58746,1485,48,27,29,104,0.07003367
New York,7075,9981,208,225,266,699,0.070033063
Wilkes Barre-Scranton-Hztn,18636,1328,30,31,32,93,0.07003012
Philadelphia,19562,2042,49,42,52,143,0.070029383
Indianapolis,46058,2142,60,48,42,150,0.070028011
Detroit,49240,9068,256,204,175,635,0.070026467
Cincinnati,45174,2285,78,56,26,160,0.070021882
Davenport-R.Island-Moline,61480,1014,25,23,23,71,0.070019724
Minneapolis-St. Paul,55391,15696,479,354,266,1099,0.070017839
"Tri-Cities, TN-VA",24228,6313,163,142,137,442,0.070014256
New York,8850,8327,213,194,176,583,0.07001321
Sioux Falls(Mitchell),56129,757,17,23,13,53,0.07001321
Kansas City,64439,1614,37,33,43,113,0.070012392
Lincoln & Hastings-Krny,68343,957,30,20,17,67,0.070010449
Wilkes Barre-Scranton-Hztn,18621,4757,125,104,104,333,0.070002102
Charlottesville,22722,200,6,4,4,14,0.07
Bluefield-Beckley-Oak Hill,24637,3300,94,70,67,231,0.07
Birmingham (Ann and Tusc),35053,3000,75,70,65,210,0.07
Indianapolis,46171,1700,46,36,37,119,0.07
Flint-Saginaw-Bay City,48841,900,21,18,24,63,0.07
Rochestr-Mason City-Austin,56045,900,27,23,13,63,0.07
Minneapolis-St. Paul,56685,100,3,2,2,7,0.07
Lubbock,79220,100,3,3,1,7,0.07
Amarillo,79248,1400,36,31,31,98,0.07
San Francisco-Oak-San Jose,94021,100,2,2,3,7,0.07
Portland-Auburn,4346,1843,36,49,44,129,0.069994574
Rochestr-Mason City-Austin,50466,1743,57,27,38,122,0.069994263
Medford-Klamath Falls,97527,36603,935,830,797,2562,0.069994263
"Columbus, GA (Opelika, AL)",36048,1143,27,27,26,80,0.069991251
Quincy-Hannibal-Keokuk,63447,1043,28,24,21,73,0.069990412
Erie,16505,16046,402,368,353,1123,0.069986289
Beaumont-Port Arthur,77616,643,19,13,13,45,0.069984448
Richmond-Petersburg,23958,3458,98,74,70,242,0.069982649
Shreveport,71046,1086,28,24,24,76,0.069981584
"Washington, DC (Hagrstwn)",20105,40554,1569,779,490,2838,0.069980766
Green Bay-Appleton,53063,1529,40,38,29,107,0.069980379
Portland-Auburn,4049,4044,105,83,95,283,0.069980218
Monroe-El Dorado,71234,4187,114,94,85,293,0.069978505
Wichita-Hutchinson Plus,67565,443,11,10,10,31,0.069977427
Butte-Bozeman,59711,9546,248,233,187,668,0.069976954
Charleston-Huntington,25239,1672,47,38,32,117,0.069976077
Portland-Auburn,4861,2701,63,63,63,189,0.069974084
Lexington,42519,2844,70,70,59,199,0.069971871
Billings,59453,343,10,8,6,24,0.069970845
Boston (Manchester),1721,18708,474,402,433,1309,0.069970066
Austin,78734,22624,661,501,421,1583,0.069969943
Charlotte,28640,4745,126,101,105,332,0.069968388
St. Louis,63629,929,24,27,14,65,0.069967707
Portland-Auburn,4282,5960,166,125,126,417,0.069966443
Dallas-Ft. Worth,75763,5989,165,137,117,419,0.069961596
Wichita-Hutchinson Plus,67730,1801,48,31,47,126,0.069961133
Cedar Rapids-Wtrlo-IWC&Dub,52248,1701,52,33,34,119,0.069958848
Sioux Falls(Mitchell),57536,486,12,12,10,34,0.069958848
Columbia-Jefferson City,65280,243,7,4,6,17,0.069958848
Little Rock-Pine Bluff,72051,486,15,9,10,34,0.069958848
Honolulu,96727,6118,161,137,130,428,0.069957502
Charleston-Huntington,45620,872,20,20,21,61,0.069954128
"Washington, DC (Hagrstwn)",20135,2802,78,63,55,196,0.069950036
Minneapolis-St. Paul,56296,1930,48,45,42,135,0.069948187
Billings,59024,386,12,8,7,27,0.069948187
Youngstown,44514,22005,518,524,497,1539,0.06993865
St. Louis,63631,815,24,17,16,57,0.06993865
Tallahassee-Thomasville,32331,4218,117,105,73,295,0.069938359
Peoria-Bloomington,61540,2731,61,56,74,191,0.069937752
Des Moines-Ames,51449,2059,48,42,54,144,0.069936863
Hartford & New Haven,6237,5219,120,112,133,365,0.069936769
"Washington, DC (Hagrstwn)",25421,143,4,3,3,10,0.06993007
Fargo,56548,715,22,16,12,50,0.06993007
St. Louis,63620,1144,36,23,21,80,0.06993007
Johnstown-Altoona-St Colge,16828,4419,115,92,102,309,0.069925322
Louisville,47281,1473,40,37,26,103,0.069925322
Champaign&Sprngfld-Decatur,62675,5892,165,123,124,412,0.069925322
Tampa-St. Pete (Sarasota),34243,30848,572,763,822,2157,0.069923496
Chicago,60561,22497,515,542,516,1573,0.069920434
Atlanta,36278,4448,112,99,100,311,0.069919065
Syracuse,13144,1230,38,27,21,86,0.069918699
Phoenix (Prescott),86046,7895,212,171,169,552,0.069917669
"Springfield, MO",65809,12358,371,278,215,864,0.069914226
New York,12580,4091,98,99,89,286,0.069909558
Memphis,38030,329,9,8,6,23,0.069908815
Lincoln & Hastings-Krny,68866,987,24,15,30,69,0.069908815
New York,7856,5021,90,120,141,351,0.069906393
Pittsburgh,26588,2618,68,61,54,183,0.069900688
Dallas-Ft. Worth,75770,2990,85,69,55,209,0.069899666
"Charleston, SC",29436,4764,124,116,93,333,0.069899244
Fargo,56757,887,28,18,16,62,0.069898534
Norfolk-Portsmth-Newpt Nws,23061,23035,612,507,491,1610,0.06989364
Cedar Rapids-Wtrlo-IWC&Dub,52164,186,5,5,3,13,0.069892473
Evansville,47725,19330,631,434,286,1351,0.069891361
Dallas-Ft. Worth,76621,973,30,20,18,68,0.069886948
Buffalo,14031,10360,282,235,207,724,0.06988417
Indianapolis,47868,2762,74,63,56,193,0.069876901
Minneapolis-St. Paul,56386,644,16,16,13,45,0.069875776
Eugene,97471,32029,821,702,715,2238,0.069874177
Indianapolis,46064,19106,548,392,395,1335,0.069873338
Burlington-Plattsburgh,3605,1102,30,21,26,77,0.069872958
Boston (Manchester),1778,14255,452,321,223,996,0.069870221
Atlanta,30536,9933,251,223,220,694,0.069868116
Ft. Myers-Naples,34119,37099,997,907,688,2592,0.069867112
Baltimore,20776,3335,94,76,63,233,0.069865067
"Tri-Cities, TN-VA",37713,1460,36,34,32,102,0.069863014
Boston (Manchester),3044,4695,114,109,105,328,0.069861555
Greenvll-Spart-Ashevll-And,28787,22559,585,480,511,1576,0.069861253
Bluefield-Beckley-Oak Hill,25951,4738,122,109,100,331,0.069860701
Roanoke-Lynchburg,24095,4323,111,93,98,302,0.069858894
Augusta-Aiken,29847,5597,137,130,124,391,0.069858853
Green Bay-Appleton,54499,2863,68,66,66,200,0.069856794
Cedar Rapids-Wtrlo-IWC&Dub,52322,2405,69,47,52,168,0.06985447
Lincoln & Hastings-Krny,68326,272,8,6,5,19,0.069852941
Corpus Christi,78022,4352,122,82,100,304,0.069852941
Tallahassee-Thomasville,32071,4252,109,103,85,297,0.069849483
St. Louis,63347,3121,85,65,68,218,0.069849407
Binghamton,13849,4567,115,99,105,319,0.069848916
Wichita-Hutchinson Plus,67119,1446,43,32,26,101,0.069847856
Toledo,43504,1174,35,23,24,82,0.069846678
Ottumwa-Kirksville,52540,1489,37,36,31,104,0.069845534
Davenport-R.Island-Moline,52650,945,31,11,24,66,0.06984127
Baton Rouge,70772,630,17,14,13,44,0.06984127
Oklahoma City,73625,945,27,20,19,66,0.06984127
Denver,82210,315,8,7,7,22,0.06984127
Green Bay-Appleton,54229,4124,116,95,77,288,0.069835112
Buffalo,14040,2105,49,48,50,147,0.069833729
Burlington-Plattsburgh,5482,8106,245,192,129,566,0.069824821
New York,12775,2535,72,45,60,177,0.069822485
"Washington, DC (Hagrstwn)",22520,5514,142,124,119,385,0.069822271
Buffalo,14101,1733,51,38,32,121,0.069821119
Minneapolis-St. Paul,56652,444,10,10,11,31,0.06981982
Wilkes Barre-Scranton-Hztn,17931,5371,126,131,118,375,0.0698194
Seattle-Tacoma,98166,22315,518,491,549,1558,0.069818508
Duluth-Superior,55705,3237,87,79,60,226,0.069817732
Philadelphia,8242,4297,106,82,112,300,0.069816151
Seattle-Tacoma,98328,11015,329,235,205,769,0.06981389
Tallahassee-Thomasville,32333,11316,283,237,270,790,0.069812655
"Washington, DC (Hagrstwn)",21555,1547,37,33,38,108,0.06981254
Tampa-St. Pete (Sarasota),33868,14582,367,311,340,1018,0.069812097
Bismarck-Mnt-Dcknsn(Wlstn),58784,3137,92,63,64,219,0.069811922
Spokane,99103,530,15,10,12,37,0.069811321
"Columbus, GA (Opelika, AL)",36860,1103,28,25,24,77,0.06980961
Sioux Falls(Mitchell),57270,573,24,9,7,40,0.069808028
Philadelphia,8088,24210,663,543,484,1690,0.069805865
Buffalo,14102,1232,30,30,26,86,0.069805195
Omaha,68647,616,15,15,13,43,0.069805195
Abilene-Sweetwater,79504,3080,81,71,63,215,0.069805195
Detroit,48114,21376,585,490,417,1492,0.069797904
Great Falls,59486,1576,40,38,32,110,0.069796954
Minneapolis-St. Paul,55032,3453,108,72,61,241,0.069794382
Norfolk-Portsmth-Newpt Nws,27929,2708,69,65,55,189,0.069793205
Green Bay-Appleton,54230,4542,136,90,91,317,0.069793043
Wilmington,28425,11034,301,240,229,770,0.069784303
Madison,53960,3382,102,71,63,236,0.069781195
Johnstown-Altoona-St Colge,15928,1949,50,39,47,136,0.069779374
Philadelphia,19541,3898,102,94,76,272,0.069779374
Burlington-Plattsburgh,5648,430,15,9,6,30,0.069767442
Albany-Schenectady-Troy,13360,387,6,13,8,27,0.069767442
Buffalo,16941,43,1,1,1,3,0.069767442
Roanoke-Lynchburg,24084,10879,237,242,280,759,0.069767442
Charleston-Huntington,25193,301,8,7,6,21,0.069767442
Greensboro-H.Point-W.Salem,27314,1118,29,19,30,78,0.069767442
Montgomery-Selma,36089,8084,206,180,178,564,0.069767442
Mobile-Pensacola (Ft Walt),36473,258,5,5,8,18,0.069767442
Meridian,36913,43,1,1,1,3,0.069767442
Knoxville,37727,2408,60,56,52,168,0.069767442
Memphis,38603,2408,63,51,54,168,0.069767442
Minneapolis-St. Paul,56287,86,3,1,2,6,0.069767442
Rockford,61044,172,4,4,4,12,0.069767442
Champaign&Sprngfld-Decatur,61863,903,29,18,16,63,0.069767442
Paducah-Cape Girard-Harsbg,63781,860,19,23,18,60,0.069767442
Paducah-Cape Girard-Harsbg,63782,172,4,4,4,12,0.069767442
"Springfield, MO",72640,215,5,5,5,15,0.069767442
Beaumont-Port Arthur,77624,602,19,12,11,42,0.069767442
Rapid City,82835,344,10,6,8,24,0.069767442
San Francisco-Oak-San Jose,95463,43,1,1,1,3,0.069767442
Miami-Ft. Lauderdale,33160,45509,991,1069,1115,3175,0.06976642
Mobile-Pensacola (Ft Walt),36542,19510,437,445,479,1361,0.069759098
Seattle-Tacoma,98822,2351,66,50,48,164,0.06975755
"Washington, DC (Hagrstwn)",20137,1749,55,39,28,122,0.069754145
Seattle-Tacoma,98584,41290,1068,906,906,2880,0.069750545
Duluth-Superior,55802,2509,33,82,60,175,0.069748904
Champaign&Sprngfld-Decatur,62571,1190,33,28,22,83,0.069747899
"Washington, DC (Hagrstwn)",22742,1864,48,38,44,130,0.069742489
Peoria-Bloomington,61764,13536,330,318,296,944,0.069739953
Albuquerque-Santa Fe,81326,2538,61,59,57,177,0.069739953
Orlando-Daytona Bch-Melbrn,32732,5177,153,113,95,361,0.069731505
Traverse City-Cadillac,49760,631,16,17,11,44,0.069730586
Youngstown,16148,16220,375,396,360,1131,0.06972873
Lincoln & Hastings-Krny,68339,1678,55,39,23,117,0.069725864
Albany-Schenectady-Troy,12513,545,17,10,11,38,0.069724771
Paducah-Cape Girard-Harsbg,62897,545,14,13,11,38,0.069724771
Buffalo,14787,4561,118,108,92,318,0.069721552
Omaha,68061,2510,72,48,55,175,0.069721116
Topeka,66538,3428,80,75,84,239,0.069719953
Cedar Rapids-Wtrlo-IWC&Dub,50666,961,25,21,21,67,0.069719043
Charleston-Huntington,41619,459,9,13,10,32,0.069716776
Omaha,50864,1836,48,34,46,128,0.069716776
Sioux Falls(Mitchell),57263,459,12,11,9,32,0.069716776
Johnstown-Altoona-St Colge,15942,2252,61,55,41,157,0.069715808
Bangor,4942,1291,42,29,19,90,0.0697134
Jonesboro,72459,1291,40,27,23,90,0.0697134
West Palm Beach-Ft. Pierce,32967,29435,783,676,593,2052,0.069712927
"Columbia, SC",29030,1664,41,31,44,116,0.069711538
Cleveland-Akron (Canton),44280,6068,163,137,123,423,0.069709954
Burlington-Plattsburgh,3752,789,16,18,21,55,0.069708492
Denver,80743,1162,30,20,31,81,0.069707401
Minneapolis-St. Paul,55013,7546,209,169,148,526,0.069705804
St. Joseph,64430,746,20,16,16,52,0.069705094
Spokane,99113,746,18,13,21,52,0.069705094
Richmond-Petersburg,22514,2568,62,56,61,179,0.06970405
Pittsburgh,15424,2396,59,50,58,167,0.069699499
"Columbus, OH",43140,23587,577,577,490,1644,0.069699411
"Tri-Cities, TN-VA",41776,1363,37,29,29,95,0.069699193
Minneapolis-St. Paul,56178,1650,48,32,35,115,0.06969697
Burlington-Plattsburgh,3284,947,27,23,16,66,0.06969377
"Washington, DC (Hagrstwn)",21710,4965,161,113,72,346,0.069687815
Charlotte,28615,1966,55,42,40,137,0.069684639
Topeka,66521,1593,48,33,30,111,0.069679849
Binghamton,12155,1751,42,42,38,122,0.069674472
Wheeling-Steubenville,43933,1708,45,38,36,119,0.069672131
Rapid City,57649,244,8,5,4,17,0.069672131
Wichita-Hutchinson Plus,67459,244,7,5,5,17,0.069672131
Champaign&Sprngfld-Decatur,61817,2311,62,56,43,161,0.069666811
Denver,69343,2268,70,47,41,158,0.069664903
Greensboro-H.Point-W.Salem,24076,1091,26,25,25,76,0.069660862
Pittsburgh,16112,1493,38,34,32,104,0.069658406
San Francisco-Oak-San Jose,95466,1249,35,25,27,87,0.069655725
San Antonio,77963,5958,148,133,134,415,0.069654246
Madison,53964,3618,100,74,78,252,0.069651741
Quincy-Hannibal-Keokuk,63439,201,5,4,5,14,0.069651741
Ft. Smith-Fay-Sprngdl-Rgrs,72951,1005,25,25,20,70,0.069651741
Albuquerque-Santa Fe,88042,603,19,9,14,42,0.069651741
Burlington-Plattsburgh,3782,3446,84,74,82,240,0.069645966
San Francisco-Oak-San Jose,95448,16268,398,376,359,1133,0.069645931
Billings,82433,761,23,18,12,53,0.069645204
Fargo,56542,2800,77,62,56,195,0.069642857
Davenport-R.Island-Moline,61272,1479,43,36,24,103,0.06964165
Wichita-Hutchinson Plus,67441,919,27,16,21,64,0.069640914
Portland-Auburn,4856,3834,124,81,62,267,0.069640063
Philadelphia,8345,718,15,17,18,50,0.069637883
Buffalo,14059,8932,213,219,190,622,0.069637259
"Columbus, OH",43732,1752,43,43,36,122,0.069634703
Columbia-Jefferson City,63363,1752,49,40,33,122,0.069634703
Buffalo,14025,3303,88,64,78,230,0.069633666
Pittsburgh,15078,517,14,11,11,36,0.069632495
Dallas-Ft. Worth,76634,7353,188,161,163,512,0.069631443
Los Angeles,93514,13988,353,305,316,974,0.069631112
Kansas City,64423,675,20,15,12,47,0.06962963
Wilkes Barre-Scranton-Hztn,17983,1508,42,28,35,105,0.069628647
Fargo,56737,833,24,18,16,58,0.069627851
Lincoln & Hastings-Krny,68520,3332,92,79,61,232,0.069627851
Pittsburgh,15014,3289,83,68,78,229,0.069626026
Philadelphia,19031,5343,146,118,108,372,0.069623807
Indianapolis,47952,2686,68,68,51,187,0.069620253
Sioux Falls(Mitchell),56138,948,32,17,17,66,0.069620253
Sioux Falls(Mitchell),57233,158,5,2,4,11,0.069620253
Milwaukee,53038,4338,124,94,84,302,0.069617335
New York,11021,18257,483,405,383,1271,0.069617133
Green Bay-Appleton,49858,11707,267,272,276,815,0.069616469
Missoula,59844,747,26,16,10,52,0.06961178
Pittsburgh,15050,2313,58,55,48,161,0.069606572
Charleston-Huntington,41651,431,10,11,9,30,0.069605568
Nashville,42151,431,12,7,11,30,0.069605568
Fargo,56760,431,11,8,11,30,0.069605568
Philadelphia,8108,17944,372,384,493,1249,0.069605439
Bangor,4453,704,20,15,14,49,0.069602273
"Lafayette, LA",70542,2931,83,66,55,204,0.069600819
Clarksburg-Weston,26271,273,7,7,5,19,0.06959707
Charleston-Huntington,26676,546,16,12,10,38,0.06959707
Little Rock-Pine Bluff,72860,273,8,6,5,19,0.06959707
New York,12449,3463,69,79,93,241,0.069592839
Wichita-Hutchinson Plus,67107,3190,88,73,61,222,0.069592476
Nashville,38477,2759,72,62,58,192,0.069590431
Buffalo,14727,4972,131,112,103,346,0.069589702
Idaho Fals-Pocatllo(Jcksn),83213,1437,44,31,25,100,0.069589422
Buffalo,14006,8967,214,202,208,624,0.069588491
Los Angeles,91436,14773,429,312,287,1028,0.069586408
Indianapolis,46071,3334,88,73,71,232,0.069586083
Greensboro-H.Point-W.Salem,28649,891,22,19,21,62,0.069584736
Harrisonburg,24472,2630,67,65,51,183,0.069581749
Sacramnto-Stkton-Modesto,95370,27378,665,622,618,1905,0.069581416
Albany-Schenectady-Troy,12037,3708,80,86,92,258,0.069579288
Fresno-Visalia,93626,3464,99,74,68,241,0.069572748
Johnstown-Altoona-St Colge,15753,575,17,12,11,40,0.069565217
Des Moines-Ames,50167,805,26,16,14,56,0.069565217
Sioux City,50562,460,12,8,12,32,0.069565217
Rapid City,57737,115,4,2,2,8,0.069565217
Fargo,58013,115,3,3,2,8,0.069565217
Joplin-Pittsburg,66741,230,6,6,4,16,0.069565217
Chico-Redding,96029,115,3,3,2,8,0.069565217
West Palm Beach-Ft. Pierce,33487,21577,379,539,583,1501,0.069564814
Wilkes Barre-Scranton-Hztn,17857,7547,202,164,159,525,0.069564065
Wausau-Rhinelander,54443,2372,67,50,48,165,0.069561551
Des Moines-Ames,50006,1452,40,33,28,101,0.069559229
Boston (Manchester),3458,6915,149,171,161,481,0.06955893
Evansville,47564,1337,35,30,28,93,0.069558714
Dallas-Ft. Worth,76531,4773,123,125,84,332,0.06955793
Buffalo,14740,1107,29,25,23,77,0.069557362
Greensboro-H.Point-W.Salem,27009,3091,78,70,67,215,0.069556778
Albuquerque-Santa Fe,87571,12249,290,283,279,852,0.069556699
Harrisburg-Lncstr-Leb-York,17224,1869,49,35,46,130,0.069555912
Cedar Rapids-Wtrlo-IWC&Dub,52347,1524,43,35,28,106,0.069553806
Des Moines-Ames,50538,532,14,9,14,37,0.069548872
West Palm Beach-Ft. Pierce,33467,59772,1528,1443,1186,4157,0.069547614
Eugene,97457,10353,265,239,216,720,0.069545059
Providence-New Bedford,2827,2502,66,56,52,174,0.069544365
Greenvll-Spart-Ashevll-And,28702,417,11,10,8,29,0.069544365
Minneapolis-St. Paul,56590,417,14,9,6,29,0.069544365
Syracuse,13080,3523,83,83,79,245,0.069543003
Knoxville,37723,1136,30,26,23,79,0.069542254
Salt Lake City,83127,4199,116,86,90,292,0.069540367
Eugene,97442,1927,36,48,50,134,0.069538142
Cleveland-Akron (Canton),44030,15905,413,349,344,1106,0.069537881
"Washington, DC (Hagrstwn)",17215,302,7,7,7,21,0.069536424
Augusta-Aiken,30821,906,22,20,21,63,0.069536424
West Palm Beach-Ft. Pierce,32968,17157,443,398,352,1193,0.069534301
Philadelphia,18077,2373,66,60,39,165,0.069532238
Pittsburgh,16346,2560,72,49,57,178,0.06953125
Denver,81224,4099,101,94,90,285,0.069529153
Norfolk-Portsmth-Newpt Nws,27923,676,17,15,15,47,0.069526627
Ft. Wayne,47373,2100,50,46,50,146,0.06952381
Casper-Riverton,82637,3711,102,78,78,258,0.06952304
Salt Lake City,84317,2661,74,63,48,185,0.069522736
Pittsburgh,16028,1798,54,38,33,125,0.069521691
Buffalo,14033,1985,49,43,46,138,0.069521411
Johnstown-Altoona-St Colge,16860,374,8,7,11,26,0.069518717
Nashville,38452,935,23,19,23,65,0.069518717
Rapid City,57521,187,6,4,3,13,0.069518717
Wichita-Hutchinson Plus,66843,187,5,4,4,13,0.069518717
Wichita-Hutchinson Plus,67519,187,6,4,3,13,0.069518717
Ft. Smith-Fay-Sprngdl-Rgrs,72950,374,11,7,8,26,0.069518717
"Tri-Cities, TN-VA",24374,633,18,13,13,44,0.069510269
Lubbock,79244,633,18,10,16,44,0.069510269
Spokane,99328,3683,100,79,77,256,0.069508553
Albany-Schenectady-Troy,12451,1525,38,36,32,106,0.069508197
Boston (Manchester),3470,5050,120,114,117,351,0.06950495
Abilene-Sweetwater,79561,705,16,16,17,49,0.069503546
Los Angeles,93513,1928,48,46,40,134,0.069502075
Baltimore,21661,2446,69,60,41,170,0.069501226
Albuquerque-Santa Fe,88119,1482,46,32,25,103,0.069500675
Clarksburg-Weston,26638,259,8,5,5,18,0.069498069
Knoxville,40927,518,16,12,8,36,0.069498069
"Washington, DC (Hagrstwn)",26743,1367,33,27,35,95,0.069495245
Salisbury,21872,590,16,12,13,41,0.069491525
Chattanooga,30757,1511,35,35,35,105,0.069490404
Peoria-Bloomington,61459,331,9,7,7,23,0.069486405
Lincoln & Hastings-Krny,68368,662,20,15,11,46,0.069486405
"Portland, OR",99356,331,11,6,6,23,0.069486405
Burlington-Plattsburgh,5679,3382,92,67,76,235,0.069485512
Miami-Ft. Lauderdale,33180,34384,865,754,770,2389,0.069479991
Nashville,37074,10881,274,238,244,756,0.069478908
Rockford,61051,1353,26,33,35,94,0.06947524
Pittsburgh,15612,475,12,10,11,33,0.069473684
Cedar Rapids-Wtrlo-IWC&Dub,52591,2922,77,57,69,203,0.069472964
Cleveland-Akron (Canton),44824,3829,105,91,70,266,0.069469835
New Orleans,70445,11300,317,253,215,785,0.069469027
Monterey-Salinas,95003,25004,633,574,530,1737,0.069468885
"Tri-Cities, TN-VA",41840,1166,31,23,27,81,0.069468268
Pittsburgh,15486,2404,67,49,51,167,0.069467554
Buffalo,14731,1238,29,27,30,86,0.069466882
Denver,80720,2649,62,53,69,184,0.069460174
Knoxville,38577,1195,30,29,24,83,0.069456067
Honolulu,96815,29618,380,725,952,2057,0.06945101
Los Angeles,93532,2275,52,55,51,158,0.069450549
Albuquerque-Santa Fe,87740,7027,178,153,157,488,0.069446421
Knoxville,40818,144,5,3,2,10,0.069444444
Charleston-Huntington,41606,504,13,13,9,35,0.069444444
Green Bay-Appleton,54928,360,10,8,7,25,0.069444444
Fargo,56594,432,12,10,8,30,0.069444444
Great Falls,59545,72,1,2,2,5,0.069444444
Topeka,66527,216,8,3,4,15,0.069444444
Jonesboro,72470,288,8,5,7,20,0.069444444
Sioux Falls(Mitchell),57252,4983,117,114,115,346,0.069436083
Rochestr-Mason City-Austin,56072,2434,68,60,41,169,0.069433032
"Springfield, MO",64738,1282,41,17,31,89,0.069422777
Twin Falls,83311,605,19,14,9,42,0.069421488
Cedar Rapids-Wtrlo-IWC&Dub,52031,5085,129,118,106,353,0.069419862
Wilkes Barre-Scranton-Hztn,17834,3342,73,75,84,232,0.069419509
Elmira (Corning),14810,10992,272,249,242,763,0.069414119
Portland-Auburn,3818,3573,89,88,71,248,0.06940946
Sioux City,51035,1556,35,31,42,108,0.06940874
San Francisco-Oak-San Jose,94555,36955,1099,786,680,2565,0.06940874
Davenport-R.Island-Moline,61238,3314,92,62,76,230,0.069402535
Wilkes Barre-Scranton-Hztn,16926,951,21,18,27,66,0.069400631
Boston (Manchester),3446,6585,157,131,169,457,0.069400152
Charleston-Huntington,25241,1513,36,34,35,105,0.069398546
Fargo,58012,2709,101,55,32,188,0.069398302
"Washington, DC (Hagrstwn)",26710,2003,51,41,47,139,0.069395906
St. Joseph,64459,562,13,13,13,39,0.069395018
Sioux City,68768,562,24,7,8,39,0.069395018
Traverse City-Cadillac,49799,2493,66,57,50,173,0.069394304
Lexington,41397,245,6,7,4,17,0.069387755
Lincoln & Hastings-Krny,68325,245,7,5,5,17,0.069387755
Madison,53588,4093,100,93,91,284,0.069386758
Santabarbra-Sanmar-Sanluob,93420,30251,748,688,663,2099,0.069386136
Greenvll-Spart-Ashevll-And,28790,3214,82,70,71,223,0.069383945
Flint-Saginaw-Bay City,48759,3214,81,72,70,223,0.069383945
Kansas City,66209,20178,506,440,454,1400,0.069382496
Johnstown-Altoona-St Colge,15857,12526,303,271,295,869,0.069375699
Birmingham (Ann and Tusc),35972,1211,29,26,29,84,0.069364162
Paducah-Cape Girard-Harsbg,42032,173,6,3,3,12,0.069364162
Omaha,51541,346,8,10,6,24,0.069364162
Fargo,58058,173,6,3,3,12,0.069364162
New York,7826,5710,166,120,110,396,0.069352014
Toledo,43452,13151,326,316,270,912,0.069348339
Rochestr-Mason City-Austin,50476,721,13,20,17,50,0.069348128
Shreveport,75568,3014,84,59,66,209,0.069343066
Spokane,83822,2192,56,50,46,152,0.069343066
San Francisco-Oak-San Jose,95494,274,8,6,5,19,0.069343066
Eureka,95511,274,4,6,9,19,0.069343066
Kansas City,64455,375,11,7,8,26,0.069333333
Odessa-Midland,79718,851,26,19,14,59,0.0693302
Minneapolis-St. Paul,56440,1327,36,30,26,92,0.069329314
Omaha,68307,476,13,12,8,33,0.069327731
Syracuse,14867,5337,136,105,129,370,0.069327337
Buffalo,16948,1529,38,36,32,106,0.069326357
St. Louis,62017,1053,27,24,22,73,0.069325736
San Francisco-Oak-San Jose,95458,3159,75,76,68,219,0.069325736
Milwaukee,53015,2409,69,47,51,167,0.069323371
Parkersburg,26133,1255,33,29,25,87,0.069322709
Buffalo,14004,12421,305,277,279,861,0.06931809
Yakima-Pasco-Rchlnd-Knnwck,99361,1861,44,40,45,129,0.069317571
Fargo,56580,1183,40,26,16,82,0.0693153
Portland-Auburn,4085,2972,67,67,72,206,0.069313594
Bangor,4435,1010,27,27,16,70,0.069306931
Charleston-Huntington,26412,303,8,5,8,21,0.069306931
Baltimore,21093,38900,1014,908,774,2696,0.069305913
Portland-Auburn,4010,1645,38,39,37,114,0.069300912
Springfield-Holyoke,1036,4849,114,107,115,336,0.069292638
Binghamton,13756,433,10,11,9,30,0.069284065
Bowling Green,42273,433,11,6,13,30,0.069284065
Kansas City,64434,433,13,10,7,30,0.069284065
Charleston-Huntington,26651,8992,230,198,195,623,0.069283808
Wausau-Rhinelander,54470,1963,60,36,40,136,0.069281712
Reno,89403,18028,448,380,421,1249,0.069281118
"Washington, DC (Hagrstwn)",26717,1097,31,26,19,76,0.069279854
St. Louis,63072,3291,84,80,64,228,0.069279854
Burlington-Plattsburgh,5830,1429,38,32,29,99,0.069279216
Chattanooga,35745,332,9,9,5,23,0.069277108
Sioux Falls(Mitchell),56142,895,21,19,22,62,0.069273743
Topeka,67432,5731,168,118,111,397,0.069272378
Providence-New Bedford,2814,7579,202,174,149,525,0.069270352
Burlington-Plattsburgh,5680,2281,65,48,45,158,0.069267865
Pittsburgh,15143,22609,646,528,392,1566,0.069264452
Harrisburg-Lncstr-Leb-York,17321,2310,64,62,34,160,0.069264069
Topeka,66070,2541,79,46,51,176,0.069264069
Lincoln & Hastings-Krny,68635,462,15,8,9,32,0.069264069
Phoenix (Prescott),86335,5198,139,116,105,360,0.069257407
Omaha,68017,1776,51,33,39,123,0.069256757
Savannah,31305,4520,94,113,106,313,0.069247788
Traverse City-Cadillac,49665,4159,116,90,82,288,0.069247415
Roanoke-Lynchburg,22922,1964,53,39,44,136,0.069246436
Bluefield-Beckley-Oak Hill,24850,1733,48,38,34,120,0.069244085
Pittsburgh,15037,10486,273,222,231,726,0.069235171
Minneapolis-St. Paul,55041,7742,184,184,168,536,0.069232756
New York,7939,130,4,3,2,9,0.069230769
New York,12791,130,4,3,2,9,0.069230769
Lincoln & Hastings-Krny,68982,520,12,9,15,36,0.069230769
Boston (Manchester),1741,5157,175,113,69,357,0.069226294
"Portland, OR",97883,2557,68,50,59,177,0.069221744
Panama City,32413,16151,309,377,432,1118,0.06922172
Boston (Manchester),2360,63509,1498,1438,1460,4396,0.069218536
Macon,31096,6877,154,171,151,476,0.069216228
Rochestr-Mason City-Austin,55954,1517,42,30,33,105,0.069215557
Clarksburg-Weston,26408,2644,71,55,57,183,0.069213313
Panama City,32424,6704,182,159,123,464,0.069212411
Topeka,66414,2803,76,60,58,194,0.069211559
Green Bay-Appleton,54930,1965,58,43,35,136,0.069211196
Flint-Saginaw-Bay City,48729,1546,44,34,29,107,0.069210867
Quincy-Hannibal-Keokuk,62378,708,26,14,9,49,0.06920904
Columbia-Jefferson City,65256,1864,53,39,37,129,0.069206009
Dallas-Ft. Worth,75410,5592,155,131,101,387,0.069206009
Sherman-Ada,74567,289,8,7,5,20,0.069204152
"Portland, OR",97119,4653,130,103,89,322,0.069202665
La Crosse-Eau Claire,54653,1026,32,20,19,71,0.06920078
Greensboro-H.Point-W.Salem,24091,7587,185,168,172,525,0.069197311
Quincy-Hannibal-Keokuk,62338,1373,45,29,21,95,0.069191551
Charlotte,28127,7790,198,186,155,539,0.069191271
Hartford & New Haven,6480,9351,221,228,198,647,0.069190461
Fairbanks,99737,4625,131,106,83,320,0.069189189
Seattle-Tacoma,98024,5377,184,117,71,372,0.06918356
New York,12762,318,7,8,7,22,0.06918239
Fargo,58352,318,8,4,10,22,0.06918239
Paducah-Cape Girard-Harsbg,62967,318,8,7,7,22,0.06918239
Paducah-Cape Girard-Harsbg,62969,159,4,3,4,11,0.06918239
Milwaukee,53137,1619,41,37,34,112,0.069178505
Philadelphia,18054,4698,127,104,94,325,0.069178374
Pittsburgh,15102,30359,731,636,733,2100,0.069172239
"Springfield, MO",65752,506,14,10,11,35,0.06916996
Charleston-Huntington,25248,2877,67,73,59,199,0.069169274
Little Rock-Pine Bluff,72016,3094,85,76,53,214,0.069166128
Clarksburg-Weston,26254,347,12,6,6,24,0.069164265
Boston (Manchester),1564,8097,220,185,155,560,0.069161418
"Tri-Cities, TN-VA",24656,2834,67,68,61,196,0.069160198
Grand Junction-Montrose,81524,2487,81,51,40,172,0.06915963
Wilkes Barre-Scranton-Hztn,18801,7678,174,176,181,531,0.069158635
Knoxville,37725,19623,485,433,439,1357,0.069153544
Philadelphia,8230,5900,157,135,116,408,0.069152542
Sioux City,51448,564,13,11,15,39,0.069148936
Ottumwa-Kirksville,63547,376,10,9,7,26,0.069148936
Denver,80801,188,5,4,4,13,0.069148936
Eureka,95514,188,2,5,6,13,0.069148936
Paducah-Cape Girard-Harsbg,42031,3124,83,65,68,216,0.069142125
Houston,75862,9806,256,228,194,678,0.069141342
Shreveport,75554,1186,30,27,25,82,0.069139966
Chicago,60053,24342,601,529,553,1683,0.069139758
Elmira (Corning),16901,10414,276,238,206,720,0.069137699
Chattanooga,37338,3486,90,69,82,241,0.069133678
Omaha,51544,622,17,11,15,43,0.069131833
Bowling Green,42722,839,20,17,21,58,0.069129917
Minneapolis-St. Paul,54772,1056,30,21,22,73,0.069128788
Wheeling-Steubenville,43943,3472,87,72,81,240,0.069124424
Cedar Rapids-Wtrlo-IWC&Dub,52720,868,23,21,16,60,0.069124424
Great Falls,59261,434,9,9,12,30,0.069124424
"Columbia, SC",29080,2561,55,62,60,177,0.069113627
Davenport-R.Island-Moline,61240,5860,162,127,116,405,0.069112628
Duluth-Superior,49938,7278,191,144,168,503,0.069112394
Corpus Christi,77990,709,20,16,13,49,0.069111425
Greenvll-Spart-Ashevll-And,29643,3082,92,60,61,213,0.069110967
Mobile-Pensacola (Ft Walt),36456,1664,42,38,35,115,0.069110577
Shreveport,71447,1201,26,31,26,83,0.069109076
Minneapolis-St. Paul,55310,1476,35,30,37,102,0.069105691
Sioux Falls(Mitchell),57272,246,7,6,4,17,0.069105691
Nashville,37016,1013,22,24,24,70,0.069101678
"Springfield, MO",65653,5398,139,123,111,373,0.069099667
Boston (Manchester),2563,10637,256,240,239,735,0.06909843
Cleveland-Akron (Canton),44039,36630,985,809,737,2531,0.069096369
Greenvll-Spart-Ashevll-And,28709,2171,62,42,46,150,0.069092584
Houston,77351,39411,1040,805,878,2723,0.069092385
Minneapolis-St. Paul,56220,2721,82,50,56,188,0.069092245
Roanoke-Lynchburg,24167,275,8,5,6,19,0.069090909
Sherman-Ada,74727,2591,72,58,49,179,0.069085295
Madison,53911,1462,40,28,33,101,0.069083447
Boston (Manchester),3234,4864,127,97,112,336,0.069078947
Billings,59078,304,8,8,5,21,0.069078947
Dallas-Ft. Worth,76474,304,9,6,6,21,0.069078947
Champaign&Sprngfld-Decatur,61847,1245,30,25,31,86,0.069076305
Detroit,48118,13391,382,309,234,925,0.069076245
Madison,53941,3156,85,66,67,218,0.069074778
Rapid City,57793,2085,64,42,38,144,0.069064748
New York,8005,28394,672,608,681,1961,0.069063887
Minneapolis-St. Paul,56137,1086,29,27,19,75,0.069060773
Albany-Schenectady-Troy,12184,7501,193,167,158,518,0.069057459
Grand Rapids-Kalmzoo-B.Crk,49349,8399,209,194,177,580,0.06905584
Burlington-Plattsburgh,3750,782,25,17,12,54,0.069053708
Knoxville,38571,15510,392,344,335,1071,0.069052224
Albany-Schenectady-Troy,12154,2636,64,63,55,182,0.069044006
Missoula,59937,16410,397,337,399,1133,0.069043266
New York,12758,4157,110,99,78,287,0.069040173
"Portland, OR",97345,507,15,11,9,35,0.069033531
Memphis,72326,2057,48,45,49,142,0.069032572
San Diego,92128,47427,1142,1049,1083,3274,0.069032408
Buffalo,14525,2738,72,58,59,189,0.069028488
Seattle-Tacoma,98244,3332,89,65,76,230,0.069027611
Johnstown-Altoona-St Colge,16822,2231,55,47,52,154,0.069027342
Ft. Smith-Fay-Sprngdl-Rgrs,72928,565,15,15,9,39,0.069026549
"Rochester, NY",14572,4752,121,114,93,328,0.069023569
Wausau-Rhinelander,54921,1217,32,25,27,84,0.069022186
New Orleans,70426,5955,144,137,130,411,0.069017632
Albany-Schenectady-Troy,12833,4289,125,85,86,296,0.069013756
Columbia-Jefferson City,65264,739,22,16,13,51,0.069012179
St. Louis,62031,797,19,19,17,55,0.069008783
Spokane,83543,797,29,17,9,55,0.069008783
Portland-Auburn,4217,3246,82,63,79,224,0.06900801
"Charleston, SC",29472,12376,327,286,241,854,0.069004525
Macon,31044,2464,63,56,51,170,0.068993506
"Jackson, TN",38371,1319,24,31,36,91,0.06899166
Tampa-St. Pete (Sarasota),34219,36193,1094,778,625,2497,0.068991241
Burlington-Plattsburgh,5751,1406,39,29,29,97,0.068990043
Traverse City-Cadillac,49720,9074,194,224,208,626,0.068988318
St. Louis,63023,4914,112,107,120,339,0.068986569
"Washington, DC (Hagrstwn)",20015,15891,424,341,331,1096,0.068969857
San Francisco-Oak-San Jose,94114,32073,341,669,1202,2212,0.068967668
Portland-Auburn,4050,232,4,8,4,16,0.068965517
Bangor,4497,348,8,9,7,24,0.068965517
Syracuse,13354,3712,91,82,83,256,0.068965517
Syracuse,13483,174,5,3,4,12,0.068965517
Charleston-Huntington,25261,203,5,3,6,14,0.068965517
Savannah,29932,261,7,6,5,18,0.068965517
Savannah,31518,725,18,19,13,50,0.068965517
Des Moines-Ames,50128,319,9,8,5,22,0.068965517
Rochestr-Mason City-Austin,50435,609,22,11,9,42,0.068965517
Sioux Falls(Mitchell),57021,261,9,5,4,18,0.068965517
Rapid City,57766,290,9,7,4,20,0.068965517
Fargo,58219,29,1,1,0,2,0.068965517
Bismarck-Mnt-Dcknsn(Wlstn),58620,145,5,3,2,10,0.068965517
Bismarck-Mnt-Dcknsn(Wlstn),58640,1479,42,32,28,102,0.068965517
Champaign&Sprngfld-Decatur,61830,493,14,12,8,34,0.068965517
St. Joseph,64422,261,6,5,7,18,0.068965517
Kansas City,64433,87,3,2,1,6,0.068965517
Kansas City,64458,174,6,3,3,12,0.068965517
Sioux Falls(Mitchell),69219,116,3,2,3,8,0.068965517
Cheyenne-Scottsbluff,69331,87,2,2,2,6,0.068965517
Little Rock-Pine Bluff,72577,638,14,14,16,44,0.068965517
Reno,96128,319,9,7,6,22,0.068965517
Spokane,99130,841,24,16,18,58,0.068965517
Des Moines-Ames,50324,5467,136,105,136,377,0.06895921
Las Vegas,89135,34036,925,767,655,2347,0.068956399
Minneapolis-St. Paul,56470,11094,305,228,232,765,0.068956193
Seattle-Tacoma,98177,21886,580,475,454,1509,0.068948186
Tulsa,67361,1784,49,39,35,123,0.068946188
Sacramnto-Stkton-Modesto,95683,6730,196,174,94,464,0.068945022
Cedar Rapids-Wtrlo-IWC&Dub,52032,1436,40,27,32,99,0.068941504
Greenwood-Greenville,38923,1349,37,26,30,93,0.068939956
Sherman-Ada,74574,1146,33,22,24,79,0.068935428
Boston (Manchester),1834,6760,181,165,120,466,0.068934911
Pittsburgh,16123,2060,52,48,42,142,0.068932039
St. Louis,63017,43218,1083,954,942,2979,0.068929613
Harrisburg-Lncstr-Leb-York,17538,7283,227,152,123,502,0.06892764
Flint-Saginaw-Bay City,48770,1770,49,36,37,122,0.068926554
Amarillo,79083,2104,59,42,44,145,0.06891635
Davenport-R.Island-Moline,52739,682,18,15,14,47,0.068914956
Buffalo,14013,1335,31,24,37,92,0.068913858
Syracuse,13308,3889,106,75,87,268,0.068912317
La Crosse-Eau Claire,55974,2554,65,59,52,176,0.068911511
Johnstown-Altoona-St Colge,15522,11348,268,262,252,782,0.068910821
"Jackson, TN",38327,624,15,14,14,43,0.068910256
Madison,53820,2496,64,46,62,172,0.068910256
Sioux Falls(Mitchell),57471,624,17,13,13,43,0.068910256
Albany-Schenectady-Troy,12470,595,14,14,13,41,0.068907563
Birmingham (Ann and Tusc),35461,1756,40,37,44,121,0.068906606
Boston (Manchester),1860,6850,157,166,149,472,0.068905109
Hartford & New Haven,6793,1074,34,24,16,74,0.068901304
Shreveport,75570,10842,255,256,236,747,0.068898727
Charlotte,29014,1495,34,36,33,103,0.068896321
Sioux Falls(Mitchell),57376,987,33,18,17,68,0.068895643
Dallas-Ft. Worth,75438,958,24,24,18,66,0.068893528
Sioux City,68739,2787,78,52,62,192,0.068891281
Traverse City-Cadillac,49650,3426,102,72,62,236,0.068884997
Augusta-Aiken,29836,421,12,10,7,29,0.06888361
Spokane,83524,1205,25,25,33,83,0.068879668
Minneapolis-St. Paul,54014,2381,65,54,45,164,0.068878622
"Washington, DC (Hagrstwn)",22027,2352,71,54,37,162,0.068877551
Omaha,68414,392,12,8,7,27,0.068877551
Lincoln & Hastings-Krny,68925,392,11,9,7,27,0.068877551
Boston (Manchester),1930,30348,649,686,755,2090,0.0688678
Sioux Falls(Mitchell),57026,1394,45,22,29,96,0.068866571
Tampa-St. Pete (Sarasota),33770,25921,504,602,679,1785,0.068863084
Bluefield-Beckley-Oak Hill,24957,334,9,7,7,23,0.068862275
Fargo,58218,639,19,11,14,44,0.06885759
La Crosse-Eau Claire,54658,2440,58,51,59,168,0.068852459
Seattle-Tacoma,98392,3355,81,74,76,231,0.068852459
Kansas City,64457,276,8,7,4,19,0.06884058
Oklahoma City,74825,1932,50,48,35,133,0.06884058
Dallas-Ft. Worth,76436,276,8,6,5,19,0.06884058
Houston,77335,2426,62,55,50,167,0.068837593
Erie,16442,2949,82,58,63,203,0.068836894
Cleveland-Akron (Canton),44880,2586,74,58,46,178,0.068832173
Tampa-St. Pete (Sarasota),33771,28461,523,654,782,1959,0.068831032
Biloxi-Gulfport,39561,2281,58,49,50,157,0.068829461
Boston (Manchester),3220,7410,195,160,155,510,0.068825911
Green Bay-Appleton,54112,2223,60,54,39,153,0.068825911
Tulsa,67355,247,8,5,4,17,0.068825911
Wichita-Hutchinson Plus,67862,247,8,5,4,17,0.068825911
"Portland, OR",97039,494,17,8,9,34,0.068825911
"Tri-Cities, TN-VA",24603,959,25,22,19,66,0.068821689
Chicago,60549,712,19,16,14,49,0.068820225
Toledo,43450,3502,92,79,70,241,0.068817818
Minneapolis-St. Paul,56211,465,12,8,12,32,0.068817204
Champaign&Sprngfld-Decatur,61862,465,12,12,8,32,0.068817204
Seattle-Tacoma,98828,2543,71,59,45,175,0.068816359
Louisville,40468,1831,55,37,34,126,0.068814855
Kansas City,66020,1584,36,39,34,109,0.068813131
Joplin-Pittsburg,66724,901,19,19,24,62,0.068812431
Buffalo,16750,436,10,10,10,30,0.068807339
Wilkes Barre-Scranton-Hztn,18456,436,10,10,10,30,0.068807339
Lincoln & Hastings-Krny,66964,218,6,5,4,15,0.068807339
Oklahoma City,73559,436,9,12,9,30,0.068807339
Idaho Fals-Pocatllo(Jcksn),83277,218,8,4,3,15,0.068807339
Reno,89425,436,13,6,11,30,0.068807339
San Antonio,77975,1715,54,34,30,118,0.068804665
Miami-Ft. Lauderdale,33009,42178,808,1007,1087,2902,0.068803642
Baltimore,21919,3183,90,63,66,219,0.068803016
Cleveland-Akron (Canton),44089,15654,384,352,341,1077,0.068800307
Flint-Saginaw-Bay City,48609,11788,271,267,273,811,0.068798778
Hartford & New Haven,6498,6919,143,174,159,476,0.068796069
Ft. Smith-Fay-Sprngdl-Rgrs,74435,2791,79,63,50,192,0.068792547
Salt Lake City,84521,596,20,8,13,41,0.068791946
"Portland, OR",97048,7152,179,154,159,492,0.068791946
Wausau-Rhinelander,53910,3358,91,82,58,231,0.068790947
Knoxville,37843,3736,95,81,81,257,0.06879015
Minneapolis-St. Paul,56240,974,23,17,27,67,0.068788501
Quincy-Hannibal-Keokuk,63454,974,27,20,20,67,0.068788501
Marquette,49876,1163,31,26,23,80,0.068787618
Chicago,60714,30064,645,671,752,2068,0.068786589
Greenville-N.Bern-Washngtn,28581,189,4,5,4,13,0.068783069
Sioux City,50527,189,5,4,4,13,0.068783069
Evansville,62446,378,7,8,11,26,0.068783069
Cedar Rapids-Wtrlo-IWC&Dub,50675,2239,65,41,48,154,0.068780706
Houston,77442,1672,45,35,35,115,0.068779904
Burlington-Plattsburgh,5156,9102,226,179,221,626,0.068776093
Milwaukee,53011,2312,59,52,48,159,0.068771626
Greenvll-Spart-Ashevll-And,28736,887,17,22,22,61,0.068771139
Pittsburgh,15531,3897,95,84,89,268,0.068770849
Minneapolis-St. Paul,56161,349,8,8,8,24,0.068767908
Topeka,66094,349,9,7,8,24,0.068767908
Phoenix (Prescott),86322,13117,341,259,302,902,0.068765724
Burlington-Plattsburgh,5150,858,18,21,20,59,0.068764569
Wichita-Hutchinson Plus,67450,509,15,11,9,35,0.068762279
New York,11362,18295,379,432,447,1258,0.068761957
Wichita-Hutchinson Plus,67672,2196,68,41,42,151,0.068761384
Clarksburg-Weston,26288,3374,89,82,61,232,0.068761114
"Washington, DC (Hagrstwn)",22308,13598,475,296,164,935,0.068760112
Youngstown,44423,2167,59,45,45,149,0.068758653
Dallas-Ft. Worth,76471,1818,40,50,35,125,0.068756876
Sioux Falls(Mitchell),57265,160,4,4,3,11,0.06875
Quincy-Hannibal-Keokuk,63430,640,17,12,15,44,0.06875
St. Louis,63654,640,17,15,12,44,0.06875
Charleston-Huntington,25003,2371,62,55,46,163,0.068747364
New York,12440,1731,31,39,49,119,0.068746389
West Palm Beach-Ft. Pierce,34994,18343,398,415,448,1261,0.068745571
Providence-New Bedford,2812,1251,34,27,25,86,0.068745004
Toledo,43432,1251,33,31,22,86,0.068745004
Las Vegas,89179,11201,312,212,246,770,0.068743862
Des Moines-Ames,50143,611,15,14,13,42,0.068739771
Sioux Falls(Mitchell),56144,1222,31,24,29,84,0.068739771
New York,7737,4117,92,90,101,283,0.068739373
Bismarck-Mnt-Dcknsn(Wlstn),58368,3506,109,64,68,241,0.068739304
Youngstown,44410,16396,397,367,363,1127,0.068736277
Little Rock-Pine Bluff,72565,902,23,19,20,62,0.068736142
"Portland, OR",97720,4350,115,85,99,299,0.068735632
Johnstown-Altoona-St Colge,16648,14985,381,330,319,1030,0.068735402
Madison,54666,2488,72,40,59,171,0.068729904
Kansas City,64061,3594,106,69,72,247,0.068725654
Shreveport,75563,3827,100,78,85,263,0.068722237
New York,12723,1557,44,29,34,107,0.068721901
Houston,77360,6228,167,130,131,428,0.068721901
Philadelphia,19096,15250,458,331,259,1048,0.068721311
Salt Lake City,84775,422,9,11,9,29,0.068720379
Nashville,37059,1528,37,30,38,105,0.068717277
Norfolk-Portsmth-Newpt Nws,23888,2081,60,41,42,143,0.068716963
Pittsburgh,16056,4817,118,101,112,331,0.068714968
Philadelphia,19529,2736,64,64,60,188,0.06871345
Lincoln & Hastings-Krny,68461,684,23,16,8,47,0.06871345
Hartford & New Haven,6419,6040,165,145,105,415,0.068708609
Norfolk-Portsmth-Newpt Nws,23350,3624,87,83,79,249,0.068708609
Philadelphia,18074,6433,157,156,129,442,0.068708223
New York,8884,8005,192,163,195,550,0.068707058
Sacramnto-Stkton-Modesto,95713,9461,218,233,199,650,0.068703097
Buffalo,14041,131,3,3,3,9,0.06870229
Little Rock-Pine Bluff,72838,131,4,3,2,9,0.06870229
Oklahoma City,73650,786,28,16,10,54,0.06870229
Orlando-Daytona Bch-Melbrn,32713,25254,640,551,544,1735,0.068701988
Seattle-Tacoma,98443,5575,140,120,123,383,0.068699552
Charlotte,28694,7817,189,181,167,537,0.068696431
"Charleston, SC",29437,2562,62,56,58,176,0.068696331
Burlington-Plattsburgh,5842,626,19,12,12,43,0.068690096
Denver,82201,6435,166,129,147,442,0.068686869
Pittsburgh,15332,8270,189,184,195,568,0.068681983
Duluth-Superior,54854,961,26,19,21,66,0.06867846
St. Louis,62838,1427,43,31,24,98,0.068675543
Davenport-R.Island-Moline,61261,830,22,17,18,57,0.068674699
Cedar Rapids-Wtrlo-IWC&Dub,50680,1063,36,20,17,73,0.068673565
Billings,59064,233,7,5,4,16,0.068669528
Denver,69030,233,5,5,6,16,0.068669528
Oklahoma City,73655,801,22,19,14,55,0.06866417
Hartford & New Haven,6525,9015,274,205,140,619,0.068663339
Pittsburgh,15321,1675,43,35,37,115,0.068656716
Baltimore,21077,335,8,7,8,23,0.068656716
Paducah-Cape Girard-Harsbg,62985,670,17,15,14,46,0.068656716
Joplin-Pittsburg,66773,670,17,16,13,46,0.068656716
Wichita Falls & Lawton,73531,335,9,8,6,23,0.068656716
Boston (Manchester),2476,17479,456,388,356,1200,0.068653813
Louisville,40178,772,23,13,17,53,0.06865285
Des Moines-Ames,50071,874,21,20,19,60,0.068649886
Wheeling-Steubenville,43946,1850,50,38,39,127,0.068648649
New York,8087,26250,610,565,627,1802,0.068647619
Bangor,4422,1515,30,34,40,104,0.068646865
Pittsburgh,15692,1078,28,25,21,74,0.06864564
Reno,89415,3540,78,72,93,243,0.068644068
Lincoln & Hastings-Krny,68370,1821,47,34,44,125,0.068643602
Kansas City,64481,947,30,18,17,65,0.068637804
Duluth-Superior,55734,5886,146,128,130,404,0.068637445
Madison,53518,1355,39,27,27,93,0.068634686
Elmira (Corning),14826,1865,47,43,38,128,0.068632708
Utica,13810,1020,27,21,22,70,0.068627451
Pittsburgh,15018,714,21,15,13,49,0.068627451
Pittsburgh,15611,306,7,7,7,21,0.068627451
Des Moines-Ames,50278,816,26,19,11,56,0.068627451
Billings,59351,204,5,5,4,14,0.068627451
Peoria-Bloomington,61731,204,6,4,4,14,0.068627451
Lincoln & Hastings-Krny,68821,102,2,3,2,7,0.068627451
Los Angeles,93526,714,18,14,17,49,0.068627451
Toledo,49253,3235,81,71,70,222,0.06862442
Norfolk-Portsmth-Newpt Nws,27938,1399,43,29,24,96,0.068620443
Monroe-El Dorado,71368,1297,38,27,24,89,0.068619892
San Francisco-Oak-San Jose,94070,32382,927,714,581,2222,0.068618368
Norfolk-Portsmth-Newpt Nws,23405,991,29,21,18,68,0.068617558
Milwaukee,53046,1574,38,37,33,108,0.068614994
Boston (Manchester),2180,24339,489,541,640,1670,0.068614158
Orlando-Daytona Bch-Melbrn,32709,2638,59,62,60,181,0.068612585
Green Bay-Appleton,54427,1166,29,22,29,80,0.068610635
Pittsburgh,26519,1647,40,34,39,113,0.068609593
Bismarck-Mnt-Dcknsn(Wlstn),58562,379,11,8,7,26,0.068601583
St. Louis,62297,379,11,8,7,26,0.068601583
Baton Rouge,70789,379,8,10,8,26,0.068601583
Baton Rouge,39638,2930,78,70,53,201,0.068600683
Bluefield-Beckley-Oak Hill,24892,1793,61,33,29,123,0.068600112
Portland-Auburn,4091,933,20,19,25,64,0.068595927
Pittsburgh,15750,277,6,7,6,19,0.068592058
Minneapolis-St. Paul,56326,1662,52,24,38,114,0.068592058
Sioux City,68004,831,22,16,19,57,0.068592058
Cedar Rapids-Wtrlo-IWC&Dub,50619,2114,67,39,39,145,0.06859035
Panama City,32466,5963,149,135,125,409,0.068589636
Pittsburgh,16249,1910,56,37,38,131,0.068586387
Knoxville,37742,6357,156,142,138,436,0.068585811
Wheeling-Steubenville,26585,452,12,10,9,31,0.068584071
Pittsburgh,15225,1079,20,20,34,74,0.06858202
Rochestr-Mason City-Austin,50438,4039,106,82,89,277,0.068581332
Minneapolis-St. Paul,54757,3310,98,63,66,227,0.06858006
Portland-Auburn,4574,1604,37,34,39,110,0.068578554
Louisville,47116,977,24,22,21,67,0.068577277
Philadelphia,19075,7612,207,169,146,522,0.068575933
Kansas City,64084,1502,35,29,39,103,0.068575233
Johnstown-Altoona-St Colge,16662,5527,144,132,103,379,0.068572462
Wilkes Barre-Scranton-Hztn,18823,175,4,4,4,12,0.068571429
Topeka,66943,525,15,9,12,36,0.068571429
Albuquerque-Santa Fe,87044,350,10,7,7,24,0.068571429
"Portland, OR",97148,3865,106,84,75,265,0.068564036
Pittsburgh,15238,13564,370,311,249,930,0.068563845
Bakersfield,93561,35049,936,793,674,2403,0.068561157
Des Moines-Ames,50517,1021,23,22,25,70,0.068560235
Colorado Springs-Pueblo,81057,423,13,11,5,29,0.06855792
"Springfield, MO",72542,3953,104,93,74,271,0.068555527
Tucson (Sierra Vista),85645,2013,53,44,41,138,0.068554396
Colorado Springs-Pueblo,80133,2509,63,57,52,172,0.068553208
Evansville,47640,919,28,17,18,63,0.068552775
Portland-Auburn,3882,1911,35,51,45,131,0.068550497
Milwaukee,53139,2903,86,54,59,199,0.068549776
Salt Lake City,84023,248,8,5,4,17,0.068548387
Kansas City,66208,21795,557,481,456,1494,0.068547832
Dothan,36310,6536,153,148,147,448,0.068543452
Chicago,60464,9819,224,267,182,673,0.068540585
Tulsa,74369,1780,45,37,40,122,0.068539326
Boston (Manchester),3057,2568,67,66,43,176,0.068535826
Burlington-Plattsburgh,5650,1284,41,28,19,88,0.068535826
Fargo,56519,321,9,7,6,22,0.068535826
Champaign&Sprngfld-Decatur,61872,642,18,14,12,44,0.068535826
Pittsburgh,15473,4217,100,100,89,289,0.068532132
Norfolk-Portsmth-Newpt Nws,27939,3181,85,68,65,218,0.068531908
Burlington-Plattsburgh,12953,12491,301,278,277,856,0.068529341
Salt Lake City,83120,394,10,9,8,27,0.068527919
Hartford & New Haven,6235,2043,55,42,43,140,0.068526676
Elmira (Corning),16936,2116,53,44,48,145,0.06852552
Tampa-St. Pete (Sarasota),34974,23539,561,520,532,1613,0.068524576
Nashville,37080,7501,181,157,176,514,0.068524197
"Tri-Cities, TN-VA",37688,1007,23,21,25,69,0.068520357
Birmingham (Ann and Tusc),35541,3561,79,66,99,244,0.068520079
Los Angeles,92314,10508,266,230,224,720,0.068519223
Burlington-Plattsburgh,5076,613,17,12,13,42,0.068515498
Minneapolis-St. Paul,54749,1226,30,28,26,84,0.068515498
Little Rock-Pine Bluff,72530,1985,50,46,40,136,0.068513854
Spokane,83801,8889,261,185,163,609,0.068511644
New York,7921,7809,164,155,216,535,0.068510693
Burlington-Plattsburgh,5361,905,22,21,19,62,0.068508287
"Washington, DC (Hagrstwn)",26866,905,29,23,10,62,0.068508287
Tampa-St. Pete (Sarasota),33782,22917,485,545,540,1570,0.068508094
New York,7444,11050,257,267,233,757,0.068506787
Buffalo,14170,2175,57,50,42,149,0.068505747
Seattle-Tacoma,98116,28626,502,567,892,1961,0.068504157
Roanoke-Lynchburg,24566,1270,37,30,20,87,0.068503937
Bismarck-Mnt-Dcknsn(Wlstn),58621,1270,38,20,29,87,0.068503937
Bluefield-Beckley-Oak Hill,25969,1343,33,29,30,92,0.068503351
Kansas City,66227,9416,319,202,124,645,0.068500425
Boston (Manchester),2770,5708,147,131,113,391,0.06850035
Albany-Schenectady-Troy,12165,146,4,3,3,10,0.068493151
Pittsburgh,16332,146,4,3,3,10,0.068493151
Norfolk-Portsmth-Newpt Nws,23438,1898,47,39,44,130,0.068493151
Clarksburg-Weston,26321,365,8,8,9,25,0.068493151
Terre Haute,47457,73,2,2,1,5,0.068493151
Sioux Falls(Mitchell),57036,730,26,14,10,50,0.068493151
Sioux Falls(Mitchell),57470,146,5,2,3,10,0.068493151
Paducah-Cape Girard-Harsbg,63763,219,3,6,6,15,0.068493151
Topeka,66856,1533,36,35,34,105,0.068493151
Lincoln & Hastings-Krny,66966,511,14,11,10,35,0.068493151
Shreveport,71072,1314,35,28,27,90,0.068493151
Wichita Falls & Lawton,76373,146,5,3,2,10,0.068493151
Denver,80822,292,8,4,8,20,0.068493151
Chico-Redding,96028,1606,47,33,30,110,0.068493151
Wilkes Barre-Scranton-Hztn,17814,4541,123,102,86,311,0.068487117
Indianapolis,46914,4819,120,105,105,330,0.068478938
Phoenix (Prescott),85255,45606,1233,1081,809,3123,0.068477832
Roanoke-Lynchburg,24954,3461,79,71,87,237,0.068477319
Dallas-Ft. Worth,76475,847,16,21,21,58,0.068476978
Philadelphia,19086,12267,372,265,203,840,0.0684764
Des Moines-Ames,50519,628,20,12,11,43,0.068471338
Wichita Falls & Lawton,73562,555,15,13,10,38,0.068468468
Macon,31078,3257,81,72,70,223,0.068467915
Cincinnati,45111,482,16,12,5,33,0.06846473
Missoula,59834,2527,74,57,42,173,0.068460625
"Columbus, OH",43149,2454,70,49,49,168,0.068459658
Boston (Manchester),3841,6471,181,145,117,443,0.06845928
Bangor,4922,1154,33,25,21,79,0.068457539
Lansing,48821,6004,137,131,143,411,0.068454364
Madison,53816,789,25,17,12,54,0.068441065
Champaign&Sprngfld-Decatur,60962,526,14,11,11,36,0.068441065
Lexington,41722,1242,30,29,26,85,0.068438003
St. Joseph,64494,979,22,25,20,67,0.068437181
Watertown,13622,2411,79,53,33,165,0.068436333
Lincoln & Hastings-Krny,67661,2981,69,60,75,204,0.068433412
New York,8530,7511,163,169,182,514,0.068432965
Birmingham (Ann and Tusc),35054,4121,101,89,92,282,0.068429993
Tampa-St. Pete (Sarasota),34211,29417,710,636,667,2013,0.068429819
Davenport-R.Island-Moline,61472,643,15,13,16,44,0.068429238
Topeka,66846,3259,100,60,63,223,0.068425898
Albany-Schenectady-Troy,12816,4633,126,100,91,317,0.068422189
Portland-Auburn,4032,9383,261,217,164,642,0.068421614
Pittsburgh,15464,1330,33,27,31,91,0.068421053
Des Moines-Ames,52581,380,10,9,7,26,0.068421053
St. Louis,62431,950,28,19,18,65,0.068421053
Kansas City,64492,1710,54,32,31,117,0.068421053
Little Rock-Pine Bluff,72135,2660,61,67,54,182,0.068421053
Eureka,95554,1140,24,27,27,78,0.068421053
Des Moines-Ames,50109,3654,134,70,46,250,0.068418172
Marquette,54151,3508,92,85,63,240,0.068415051
Hartford & New Haven,6712,8946,227,203,182,612,0.068410463
Davenport-R.Island-Moline,61337,497,14,10,10,34,0.068410463
Oklahoma City,73771,497,10,14,10,34,0.068410463
Eugene,97423,7002,164,163,152,479,0.068409026
Buffalo,16950,3567,85,83,76,244,0.068404822
Pittsburgh,16037,5102,133,116,100,349,0.068404547
Richmond-Petersburg,23091,307,8,7,6,21,0.068403909
Burlington-Plattsburgh,12962,5088,128,100,120,348,0.068396226
"Washington, DC (Hagrstwn)",20609,1082,24,24,26,74,0.068391867
Birmingham (Ann and Tusc),36738,541,16,9,12,37,0.068391867
Phoenix (Prescott),85254,48851,1224,1109,1008,3341,0.06839164
Knoxville,37763,15967,387,353,352,1092,0.068391057
Syracuse,13112,1974,58,44,33,135,0.068389058
Charleston-Huntington,26662,658,19,14,12,45,0.068389058
Orlando-Daytona Bch-Melbrn,34488,11537,260,256,273,789,0.068388663
New York,10520,15178,374,361,303,1038,0.068388457
Hartford & New Haven,6375,3612,73,73,101,247,0.068383167
"Springfield, MO",72554,2720,68,56,62,186,0.068382353
Pittsburgh,15462,351,8,8,8,24,0.068376068
Shreveport,71427,234,5,6,5,16,0.068376068
Waco-Temple-Bryan,76869,117,3,2,3,8,0.068376068
Wichita-Hutchinson Plus,67669,1799,55,28,40,123,0.068371317
Albany-Schenectady-Troy,12058,1492,39,31,32,102,0.068364611
Waco-Temple-Bryan,76656,2326,69,40,50,159,0.068357696
Tampa-St. Pete (Sarasota),33825,25543,622,573,551,1746,0.068355322
San Francisco-Oak-San Jose,95449,1463,35,34,31,100,0.0683527
Wilkes Barre-Scranton-Hztn,17859,2809,75,60,57,192,0.068351727
Jacksonville,32181,2692,68,52,64,184,0.068350669
"Portland, OR",97812,951,29,20,16,65,0.068349106
Las Vegas,89043,1229,30,28,26,84,0.068348251
Nashville,37137,2780,71,60,59,190,0.068345324
Lincoln & Hastings-Krny,68663,556,14,12,12,38,0.068345324
Sacramnto-Stkton-Modesto,95252,15349,391,329,329,1049,0.068343215
Des Moines-Ames,50511,6731,173,151,136,460,0.068340514
Pittsburgh,16235,1156,31,25,23,79,0.0683391
Traverse City-Cadillac,49411,1756,39,42,39,120,0.06833713
Milwaukee,53557,439,12,8,10,30,0.06833713
Green Bay-Appleton,54967,439,12,7,11,30,0.06833713
St. Louis,62877,439,12,10,8,30,0.06833713
Wichita-Hutchinson Plus,66939,439,14,7,9,30,0.06833713
Chattanooga,37350,2078,64,45,33,142,0.068334937
Ft. Myers-Naples,33952,32327,728,747,734,2209,0.068332972
Des Moines-Ames,51646,761,19,16,17,52,0.068331143
Colorado Springs-Pueblo,81058,761,21,18,13,52,0.068331143
Raleigh-Durham (Fayetvlle),27831,2810,66,63,63,192,0.068327402
"Portland, OR",97385,4142,113,97,73,283,0.068324481
Pittsburgh,15957,322,10,6,6,22,0.068322981
Ottumwa-Kirksville,52560,322,5,9,8,22,0.068322981
Sioux Falls(Mitchell),57217,322,8,7,7,22,0.068322981
Sioux Falls(Mitchell),57369,2576,66,42,68,176,0.068322981
Paducah-Cape Girard-Harsbg,63823,1127,24,25,28,77,0.068322981
Ft. Smith-Fay-Sprngdl-Rgrs,72841,161,5,3,3,11,0.068322981
Green Bay-Appleton,54201,5196,136,96,123,355,0.068321786
Flint-Saginaw-Bay City,48756,4069,104,89,85,278,0.068321455
Greenville-N.Bern-Washngtn,28460,13964,328,222,404,954,0.068318533
Minneapolis-St. Paul,56278,2635,53,59,68,180,0.068311195
Boston (Manchester),1952,9208,185,208,236,629,0.068310165
Pittsburgh,15024,8403,192,188,194,574,0.068308937
Davenport-R.Island-Moline,52064,732,20,15,15,50,0.068306011
Champaign&Sprngfld-Decatur,62444,366,10,9,6,25,0.068306011
Sioux City,68736,571,15,12,12,39,0.068301226
"Portland, OR",97876,776,27,10,16,53,0.068298969
Milwaukee,53151,32051,781,725,683,2189,0.068297401
Minneapolis-St. Paul,55088,1596,51,33,25,109,0.068295739
Traverse City-Cadillac,49309,2006,55,44,38,137,0.068295115
Boston (Manchester),2338,7702,181,169,176,526,0.06829395
Fargo,58008,205,7,4,3,14,0.068292683
Kansas City,64639,205,5,5,4,14,0.068292683
"Springfield, MO",65589,205,6,4,4,14,0.068292683
Omaha,68070,820,26,14,16,56,0.068292683
Buffalo,14807,2841,70,64,60,194,0.068285815
Johnstown-Altoona-St Colge,15541,3588,93,75,77,245,0.068283166
Billings,59063,2065,58,46,37,141,0.068280872
Chattanooga,37373,3720,89,90,75,254,0.06827957
Burlington-Plattsburgh,5142,703,18,16,14,48,0.068278805
Omaha,51465,703,15,15,18,48,0.068278805
St. Joseph,66008,249,9,4,4,17,0.068273092
Lubbock,79738,249,7,6,4,17,0.068273092
Wausau-Rhinelander,54489,1538,41,29,35,105,0.068270481
Bismarck-Mnt-Dcknsn(Wlstn),58523,3618,108,67,72,247,0.068269762
"Washington, DC (Hagrstwn)",22654,791,17,20,17,54,0.068268015
Pittsburgh,16317,1084,30,26,18,74,0.068265683
Rochestr-Mason City-Austin,50628,1377,45,21,28,94,0.068264343
Knoxville,37722,5933,144,122,139,405,0.068262262
Norfolk-Portsmth-Newpt Nws,23310,5772,134,136,124,394,0.068260568
Duluth-Superior,54525,293,7,4,9,20,0.068259386
Lincoln & Hastings-Krny,68303,293,9,6,5,20,0.068259386
Lake Charles,70660,1758,45,42,33,120,0.068259386
Medford-Klamath Falls,97524,16408,432,345,343,1120,0.068259386
Shreveport,75669,630,14,14,15,43,0.068253968
Clarksburg-Weston,26568,337,7,7,9,23,0.068249258
"Springfield, MO",65464,337,9,8,6,23,0.068249258
Greenvll-Spart-Ashevll-And,28768,7107,194,146,145,485,0.068242578
Johnstown-Altoona-St Colge,16692,762,21,17,14,52,0.06824147
Fargo,56758,381,13,7,6,26,0.06824147
Johnstown-Altoona-St Colge,16635,11855,293,266,250,809,0.068241248
Roanoke-Lynchburg,24324,1949,50,43,40,133,0.068240123
Oklahoma City,73832,806,19,22,14,55,0.068238213
Topeka,66871,1231,33,29,22,84,0.068237206
"Washington, DC (Hagrstwn)",22643,425,12,10,7,29,0.068235294
Los Angeles,92397,5452,149,124,99,372,0.068231842
Norfolk-Portsmth-Newpt Nws,23035,1407,29,30,37,96,0.068230277
Quincy-Hannibal-Keokuk,63472,469,12,9,11,32,0.068230277
Pittsburgh,15639,1920,48,39,44,131,0.068229167
Harrisonburg,24440,2477,63,56,50,169,0.068227695
Chicago,60421,4016,87,91,96,274,0.068227092
Denver,69131,513,14,12,9,35,0.068226121
Chicago,60062,42140,1218,988,669,2875,0.068224964
Des Moines-Ames,50846,1114,32,23,21,76,0.068222621
Dallas-Ft. Worth,76844,3269,90,72,61,223,0.06821658
Boston (Manchester),3826,2712,61,56,68,185,0.068215339
Cedar Rapids-Wtrlo-IWC&Dub,52760,689,24,13,10,47,0.068214804
Los Angeles,91024,10819,294,244,200,738,0.068213328
Pittsburgh,16157,3064,79,70,60,209,0.068211488
Buffalo,14729,777,16,15,22,53,0.068211068
Mobile-Pensacola (Ft Walt),36768,777,20,17,16,53,0.068211068
"Springfield, MO",72675,1554,32,39,35,106,0.068211068
Cleveland-Akron (Canton),44656,2595,59,59,59,177,0.068208092
San Diego,91905,1730,41,40,37,118,0.068208092
Memphis,38076,909,21,20,21,62,0.068206821
"Washington, DC (Hagrstwn)",20674,997,22,21,25,68,0.068204614
Madison,53503,2038,63,47,29,139,0.068204122
Sioux Falls(Mitchell),56149,1173,26,23,31,80,0.068201194
Yakima-Pasco-Rchlnd-Knnwck,97886,1261,35,24,27,86,0.068199841
Detroit,48001,11701,279,247,272,798,0.068199299
Tallahassee-Thomasville,32052,7464,180,157,172,509,0.068193998
Dallas-Ft. Worth,75426,4634,120,98,98,316,0.068191627
Burlington-Plattsburgh,5461,4781,157,97,72,326,0.068186572
Bangor,4666,1144,32,24,22,78,0.068181818
Pittsburgh,15440,264,8,6,4,18,0.068181818
Wilkes Barre-Scranton-Hztn,17982,308,7,8,6,21,0.068181818
"Washington, DC (Hagrstwn)",21540,88,2,2,2,6,0.068181818
"Washington, DC (Hagrstwn)",22641,264,7,5,6,18,0.068181818
Harrisonburg,22820,220,5,5,5,15,0.068181818
Greenwood-Greenville,38914,528,13,13,10,36,0.068181818
Charleston-Huntington,41540,352,8,11,5,24,0.068181818
Des Moines-Ames,50848,308,9,5,7,21,0.068181818
Des Moines-Ames,52593,132,4,2,3,9,0.068181818
Bismarck-Mnt-Dcknsn(Wlstn),57645,132,2,3,4,9,0.068181818
Fargo,58464,176,5,3,4,12,0.068181818
Bismarck-Mnt-Dcknsn(Wlstn),58642,308,7,7,7,21,0.068181818
Great Falls,59436,1980,53,38,44,135,0.068181818
Missoula,59875,3828,107,74,80,261,0.068181818
St. Louis,62053,440,15,11,4,30,0.068181818
Evansville,62843,132,4,3,2,9,0.068181818
Columbia-Jefferson City,65246,88,2,2,2,6,0.068181818
Wichita-Hutchinson Plus,67051,352,11,6,7,24,0.068181818
Wichita-Hutchinson Plus,67102,44,1,1,1,3,0.068181818
Oklahoma City,74045,440,15,8,7,30,0.068181818
Waco-Temple-Bryan,76680,264,8,6,4,18,0.068181818
Spokane,83874,88,2,2,2,6,0.068181818
Salt Lake City,84773,308,7,8,6,21,0.068181818
Los Angeles,92676,1848,38,42,46,126,0.068181818
Reno,96117,220,6,5,4,15,0.068181818
Rochestr-Mason City-Austin,50636,1907,48,35,47,130,0.0681699
Albany-Schenectady-Troy,12062,1643,38,35,39,112,0.068167985
Davenport-R.Island-Moline,61046,2890,77,67,53,197,0.06816609
Philadelphia,19372,2274,44,54,57,155,0.068161829
Milwaukee,53076,4108,129,81,70,280,0.068159688
Boston (Manchester),1775,7101,228,153,103,484,0.068159414
Green Bay-Appleton,54947,2685,83,59,41,183,0.068156425
Richmond-Petersburg,23974,4857,126,107,98,331,0.068149063
Burlington-Plattsburgh,12912,2069,43,53,45,141,0.068148864
Charleston-Huntington,26679,1937,53,35,44,132,0.068146618
Honolulu,96750,3610,90,77,79,246,0.068144044
Binghamton,13757,1130,29,26,22,77,0.068141593
Davenport-R.Island-Moline,52753,6384,187,137,111,435,0.068139098
Louisville,40107,2084,51,46,45,142,0.068138196
Baton Rouge,70776,6076,122,148,144,414,0.068136932
Dallas-Ft. Worth,76463,499,12,11,11,34,0.068136273
Binghamton,13809,1365,34,32,27,93,0.068131868
Grand Rapids-Kalmzoo-B.Crk,49012,3508,82,85,72,239,0.068129989
Johnstown-Altoona-St Colge,16657,1277,36,27,24,87,0.068128426
Sioux Falls(Mitchell),57020,1688,56,34,25,115,0.068127962
"Portland, OR",97358,2510,73,54,44,171,0.06812749
Pittsburgh,16055,8852,260,179,164,603,0.068120199
Shreveport,75652,15958,374,364,349,1087,0.068116305
"Columbia, SC",29015,1292,32,26,30,88,0.068111455
Jacksonville,32061,323,8,7,7,22,0.068111455
Omaha,51631,323,5,6,11,22,0.068111455
Portland-Auburn,4927,3509,98,72,69,239,0.068110573
Minneapolis-St. Paul,56232,2217,64,47,40,151,0.068110059
Tulsa,74471,1483,34,34,33,101,0.068105192
Oklahoma City,73090,1072,31,21,21,73,0.068097015
Norfolk-Portsmth-Newpt Nws,27950,2100,52,39,52,143,0.068095238
Orlando-Daytona Bch-Melbrn,32940,53397,1492,1172,972,3636,0.068093713
Harrisburg-Lncstr-Leb-York,17266,514,15,10,10,35,0.068093385
Detroit,48456,749,20,15,16,51,0.068090788
Charlotte,28101,705,20,11,17,48,0.068085106
"Washington, DC (Hagrstwn)",21776,5964,141,127,138,406,0.068075117
Bluefield-Beckley-Oak Hill,25976,2556,61,59,54,174,0.068075117
Des Moines-Ames,50039,426,14,8,7,29,0.068075117
Birmingham (Ann and Tusc),36080,2424,64,46,55,165,0.068069307
Davenport-R.Island-Moline,52754,1190,26,29,26,81,0.068067227
Duluth-Superior,55616,7199,177,161,152,490,0.068065009
San Angelo,76935,1719,57,32,28,117,0.068062827
Columbia-Jefferson City,65041,5304,129,116,116,361,0.06806184
Traverse City-Cadillac,49868,4070,106,86,85,277,0.068058968
Boston (Manchester),3848,6465,148,153,139,440,0.068058778
Austin,78608,911,25,19,18,62,0.06805708
Albany-Schenectady-Troy,12157,4129,82,101,98,281,0.068055219
Orlando-Daytona Bch-Melbrn,32926,24099,543,543,554,1640,0.068052616
Roanoke-Lynchburg,24360,5599,153,121,107,381,0.068047866
Knoxville,37887,6716,158,157,142,457,0.068046456
Albany-Schenectady-Troy,12885,4365,103,103,91,297,0.068041237
Waco-Temple-Bryan,76629,1940,49,45,38,132,0.068041237
Salt Lake City,84072,485,16,10,7,33,0.068041237
Syracuse,13076,2234,58,44,50,152,0.068039391
Hartford & New Haven,6441,5556,144,127,107,378,0.068034557
Cleveland-Akron (Canton),44026,11054,273,260,219,752,0.068029673
Boston (Manchester),3291,147,4,3,3,10,0.068027211
Bluefield-Beckley-Oak Hill,24884,588,18,10,12,40,0.068027211
Clarksburg-Weston,26276,441,10,12,8,30,0.068027211
Pittsburgh,26521,294,5,8,7,20,0.068027211
Cedar Rapids-Wtrlo-IWC&Dub,50667,735,23,13,14,50,0.068027211
Shreveport,71002,147,3,3,4,10,0.068027211
Huntsville-Decatur (Flor),38488,2264,64,48,42,154,0.068021201
Austin,77853,1132,35,19,23,77,0.068021201
Fargo,56585,985,27,22,18,67,0.068020305
St. Louis,63056,1779,49,39,33,121,0.068015739
Champaign&Sprngfld-Decatur,61777,941,24,20,20,64,0.068012752
Lincoln & Hastings-Krny,68862,2823,73,50,69,192,0.068012752
Los Angeles,92327,397,8,8,11,27,0.068010076
Wichita-Hutchinson Plus,67550,5191,128,109,116,353,0.068002312
Bangor,4650,250,7,6,4,17,0.068
Wilkes Barre-Scranton-Hztn,17934,250,6,4,7,17,0.068
Greenville-N.Bern-Washngtn,27885,750,19,22,10,51,0.068
Bismarck-Mnt-Dcknsn(Wlstn),58725,250,8,4,5,17,0.068
Spokane,83546,500,15,13,6,34,0.068
Richmond-Petersburg,23148,1456,40,28,31,99,0.067994505
Buffalo,14716,2412,57,56,51,164,0.067993367
Savannah,30455,603,16,12,13,41,0.067993367
Portland-Auburn,4105,12649,397,272,191,860,0.067989564
Paducah-Cape Girard-Harsbg,38226,353,9,8,7,24,0.067988669
Atlanta,30537,1515,39,31,33,103,0.067986799
Burlington-Plattsburgh,5658,1618,43,39,28,110,0.067985167
"Portland, OR",97820,912,22,20,20,62,0.067982456
Spokane,98855,6356,194,125,113,432,0.067967275
Wilkes Barre-Scranton-Hztn,18619,206,6,4,4,14,0.067961165
Roanoke-Lynchburg,24131,103,3,2,2,7,0.067961165
Bluefield-Beckley-Oak Hill,25173,412,12,9,7,28,0.067961165
Indianapolis,46959,103,3,2,2,7,0.067961165
Quincy-Hannibal-Keokuk,52657,103,2,2,3,7,0.067961165
Bismarck-Mnt-Dcknsn(Wlstn),58542,206,7,4,3,14,0.067961165
Lincoln & Hastings-Krny,67664,206,4,5,5,14,0.067961165
Cheyenne-Scottsbluff,69125,309,7,6,8,21,0.067961165
San Antonio,78021,103,2,3,2,7,0.067961165
Harrisonburg,22830,1604,33,35,41,109,0.067955112
Philadelphia,19803,22927,605,515,438,1558,0.067954813
Philadelphia,19422,20971,563,481,381,1425,0.06795098
Los Angeles,92539,4783,116,105,104,325,0.067948986
Buffalo,14011,7403,199,156,148,503,0.067945428
Denver,69156,574,16,14,9,39,0.067944251
St. Louis,62243,5593,148,125,107,380,0.06794207
Sioux City,51350,368,7,10,8,25,0.067934783
Pittsburgh,15717,9892,218,220,234,672,0.067933684
Greenwood-Greenville,38929,1266,31,28,27,86,0.06793049
Baton Rouge,70753,633,17,13,13,43,0.06793049
"Tri-Cities, TN-VA",24290,1796,40,38,44,122,0.067928731
Little Rock-Pine Bluff,71638,3489,91,69,77,237,0.067927773
Davenport-R.Island-Moline,52768,1384,37,27,30,94,0.067919075
Tampa-St. Pete (Sarasota),34688,8039,216,198,132,546,0.067918895
Chico-Redding,96073,4579,130,116,65,311,0.06791876
Wilkes Barre-Scranton-Hztn,17981,2562,58,62,54,174,0.067915691
Sioux Falls(Mitchell),57433,427,11,9,9,29,0.067915691
Sacramnto-Stkton-Modesto,95372,1870,49,43,35,127,0.067914439
Oklahoma City,73654,589,16,15,9,40,0.067911715
Green Bay-Appleton,54171,4344,124,96,75,295,0.067909761
Wheeling-Steubenville,43942,2415,57,48,59,164,0.067908903
Syracuse,14886,6480,160,150,130,440,0.067901235
Pittsburgh,15322,1944,54,36,42,132,0.067901235
Richmond-Petersburg,23161,162,4,4,3,11,0.067901235
Lincoln & Hastings-Krny,67647,162,3,4,4,11,0.067901235
Sioux Falls(Mitchell),69218,324,9,6,7,22,0.067901235
Los Angeles,93563,162,5,3,3,11,0.067901235
Portland-Auburn,4578,4595,117,99,96,312,0.067899891
Fargo,56527,869,27,17,15,59,0.067894131
Fargo,56578,869,26,17,16,59,0.067894131
Lexington,42544,5921,136,122,144,402,0.067893937
Greenvll-Spart-Ashevll-And,28018,5052,124,113,106,343,0.067893903
Little Rock-Pine Bluff,72560,9132,250,184,186,620,0.067893123
Bismarck-Mnt-Dcknsn(Wlstn),58630,707,17,18,13,48,0.067892504
Wilkes Barre-Scranton-Hztn,17860,2239,63,42,47,152,0.06788745
Harrisburg-Lncstr-Leb-York,17015,23333,574,531,479,1584,0.067886684
Portland-Auburn,4287,3123,90,65,57,212,0.067883445
Cedar Rapids-Wtrlo-IWC&Dub,52140,604,14,13,14,41,0.067880795
Albany-Schenectady-Troy,12150,825,18,21,17,56,0.067878788
Boston (Manchester),3225,4022,118,77,78,273,0.067876678
Pittsburgh,26764,4361,97,95,104,296,0.067874341
Boston (Manchester),3608,2873,59,74,62,195,0.067873303
Portland-Auburn,3883,221,6,5,4,15,0.067873303
Buffalo,14736,221,6,6,3,15,0.067873303
Pittsburgh,15363,663,10,19,16,45,0.067873303
Johnstown-Altoona-St Colge,16827,5113,127,116,104,347,0.067866223
Norfolk-Portsmth-Newpt Nws,23866,2004,53,45,38,136,0.067864271
Syracuse,13030,3787,90,74,93,257,0.067863744
"Washington, DC (Hagrstwn)",20184,781,19,17,17,53,0.067861716
Milwaukee,53035,2402,67,51,45,163,0.067860117
Duluth-Superior,54820,899,24,19,18,61,0.06785317
Wilkes Barre-Scranton-Hztn,18229,8548,221,193,166,580,0.067852129
Buffalo,14846,619,16,11,15,42,0.067851373
Minneapolis-St. Paul,56169,619,19,14,9,42,0.067851373
St. Louis,62471,10214,231,233,229,693,0.067848052
Birmingham (Ann and Tusc),35143,3464,71,71,93,235,0.067840647
Wichita-Hutchinson Plus,67567,398,13,5,9,27,0.067839196
Denver,69141,398,11,9,7,27,0.067839196
Dallas-Ft. Worth,76631,516,14,11,10,35,0.067829457
Minneapolis-St. Paul,55795,1607,51,35,23,109,0.067828251
Johnstown-Altoona-St Colge,16838,1725,43,41,33,117,0.067826087
Omaha,68018,575,20,12,7,39,0.067826087
Lincoln & Hastings-Krny,68626,634,20,11,12,43,0.067823344
Portland-Auburn,4276,5942,135,127,141,403,0.067822282
Marquette,49831,693,20,16,11,47,0.067821068
Milwaukee,53092,21837,621,499,361,1481,0.067820671
Denver,81132,2787,68,61,60,189,0.067814855
Dothan,36316,1917,49,41,40,130,0.067814293
Phoenix (Prescott),86409,30777,711,668,708,2087,0.067810378
"Springfield, MO",65661,2566,79,50,45,174,0.067809821
Tampa-St. Pete (Sarasota),33704,16002,294,373,418,1085,0.067804024
Springfield-Holyoke,1521,2655,66,57,57,180,0.06779661
Boston (Manchester),3810,2183,54,48,46,148,0.06779661
Norfolk-Portsmth-Newpt Nws,23068,236,6,5,5,16,0.06779661
Terre Haute,47573,59,1,2,1,4,0.06779661
Sioux City,50515,295,8,7,5,20,0.06779661
Sioux Falls(Mitchell),57247,413,14,7,7,28,0.06779661
Sioux Falls(Mitchell),57528,708,21,11,16,48,0.06779661
Fargo,58007,118,3,3,2,8,0.06779661
Fargo,58382,118,4,2,2,8,0.06779661
Bismarck-Mnt-Dcknsn(Wlstn),58765,236,8,4,4,16,0.06779661
Ottumwa-Kirksville,63567,118,4,2,2,8,0.06779661
Wichita-Hutchinson Plus,67564,236,6,6,4,16,0.06779661
New Orleans,70358,944,24,19,21,64,0.06779661
Memphis,72429,295,7,6,7,20,0.06779661
San Angelo,76874,59,1,1,2,4,0.06779661
San Angelo,76951,1416,47,28,21,96,0.06779661
Denver,82058,59,1,1,2,4,0.06779661
Billings,59327,2493,59,58,52,169,0.067789811
Toledo,43527,2316,61,50,46,157,0.067789292
Minneapolis-St. Paul,55127,19045,461,410,420,1291,0.067786821
Minneapolis-St. Paul,56244,1726,51,30,36,117,0.06778679
Duluth-Superior,55751,1431,43,32,22,97,0.067784766
Wichita-Hutchinson Plus,67003,2331,48,54,56,158,0.067782068
Los Angeles,93023,20463,489,466,432,1387,0.067780873
Hartford & New Haven,6382,10697,236,244,245,725,0.067776012
Albany-Schenectady-Troy,12027,4692,129,103,86,318,0.067774936
Norfolk-Portsmth-Newpt Nws,27932,11730,307,251,237,795,0.067774936
Tampa-St. Pete (Sarasota),33865,782,22,17,14,53,0.067774936
Hartford & New Haven,6023,1446,37,31,30,98,0.067773167
Bismarck-Mnt-Dcknsn(Wlstn),58785,1446,50,26,22,98,0.067773167
Little Rock-Pine Bluff,72055,723,20,16,13,49,0.067773167
Buffalo,14750,4825,116,107,104,327,0.067772021
New York,12487,3320,76,72,77,225,0.067771084
Burlington-Plattsburgh,5445,3807,102,86,70,258,0.067769898
Rockford,61042,546,16,11,10,37,0.067765568
Richmond-Petersburg,22947,5047,135,105,102,342,0.067763028
South Bend-Elkhart,49095,2007,55,42,39,136,0.06776283
Youngstown,44454,915,18,17,27,62,0.067759563
Lincoln & Hastings-Krny,68341,915,27,17,18,62,0.067759563
Raleigh-Durham (Fayetvlle),27712,22211,593,499,413,1505,0.067759218
Elmira (Corning),16935,1284,33,28,26,87,0.067757009
Cedar Rapids-Wtrlo-IWC&Dub,50635,1284,34,26,27,87,0.067757009
"Springfield, MO",72634,5210,127,110,116,353,0.067754319
San Antonio,78025,5210,129,117,107,353,0.067754319
Youngstown,44451,3439,83,84,66,233,0.067752254
"Springfield, MO",65479,369,10,8,7,25,0.067750678
Lincoln & Hastings-Krny,68322,369,11,7,7,25,0.067750678
Sioux City,51523,310,9,5,7,21,0.067741935
Kansas City,64646,310,6,6,9,21,0.067741935
Spokane,83535,1240,41,24,19,84,0.067741935
Providence-New Bedford,2777,17124,442,368,350,1160,0.067741182
Kansas City,64622,561,9,16,13,38,0.067736185
Eugene,97487,9434,253,201,185,639,0.067733729
Davenport-R.Island-Moline,61262,1063,29,25,18,72,0.067732832
"Washington, DC (Hagrstwn)",20690,753,16,16,19,51,0.067729084
Houston,77331,7028,176,152,148,476,0.067729084
Eureka,95528,1004,28,18,22,68,0.067729084
Greenville-N.Bern-Washngtn,28584,14145,379,308,271,958,0.067727112
Richmond-Petersburg,24599,694,17,13,17,47,0.067723343
Indianapolis,46039,694,17,12,18,47,0.067723343
Detroit,48169,20599,480,489,426,1395,0.067721734
Raleigh-Durham (Fayetvlle),27231,2023,57,42,38,137,0.067721206
Detroit,48027,3116,73,70,68,211,0.067715019
Dallas-Ft. Worth,76432,1344,32,35,24,91,0.067708333
Wilkes Barre-Scranton-Hztn,17744,2954,68,69,63,200,0.067704807
Richmond-Petersburg,23141,8818,239,180,178,597,0.067702427
Tampa-St. Pete (Sarasota),34240,21286,600,462,379,1441,0.067697078
Charleston-Huntington,25264,325,10,7,5,22,0.067692308
Minneapolis-St. Paul,56248,650,17,15,12,44,0.067692308
Charlotte,28693,1433,38,30,29,97,0.067690161
Minneapolis-St. Paul,55704,1108,30,26,19,75,0.067689531
Albany-Schenectady-Troy,12193,2024,49,41,47,137,0.067687747
Richmond-Petersburg,23840,1699,41,38,36,115,0.067686875
Greenville-N.Bern-Washngtn,27810,3339,85,76,65,226,0.067684936
St. Louis,63334,7860,194,162,176,532,0.067684478
Augusta-Aiken,30817,7402,180,162,159,501,0.06768441
Orlando-Daytona Bch-Melbrn,32934,19739,468,455,413,1336,0.067683267
Lincoln & Hastings-Krny,66935,2497,70,52,47,169,0.067681217
Seattle-Tacoma,98380,5260,150,116,90,356,0.067680608
Los Angeles,90277,36776,800,809,880,2489,0.067680009
Boston (Manchester),3042,7698,189,158,174,521,0.067679917
"Springfield, MO",72513,2911,79,64,54,197,0.067674339
Fargo,58216,133,3,4,2,9,0.067669173
Bismarck-Mnt-Dcknsn(Wlstn),58755,133,4,3,2,9,0.067669173
Bismarck-Mnt-Dcknsn(Wlstn),59258,133,3,3,3,9,0.067669173
Lincoln & Hastings-Krny,68667,133,5,1,3,9,0.067669173
Lincoln & Hastings-Krny,69157,133,3,3,3,9,0.067669173
Denver,80812,399,11,8,8,27,0.067669173
San Francisco-Oak-San Jose,94074,399,7,10,10,27,0.067669173
Boston (Manchester),3046,3148,89,72,52,213,0.067662008
La Crosse-Eau Claire,54754,1611,47,31,31,109,0.067659839
Little Rock-Pine Bluff,72087,1685,48,34,32,114,0.067655786
Denver,81639,2631,66,54,58,178,0.067654884
Greensboro-H.Point-W.Salem,27016,1626,35,35,40,110,0.067650677
Des Moines-Ames,50571,340,13,2,8,23,0.067647059
Lincoln & Hastings-Krny,68846,340,9,8,6,23,0.067647059
Corpus Christi,78349,340,9,7,7,23,0.067647059
Wheeling-Steubenville,43915,1567,37,36,33,106,0.067645182
Austin,78619,5869,185,126,86,397,0.067643551
Houston,77880,1848,57,40,28,125,0.067640693
Kansas City,66079,754,18,17,16,51,0.067639257
Orlando-Daytona Bch-Melbrn,32744,4184,91,91,101,283,0.067638623
Wausau-Rhinelander,54407,1715,53,35,28,116,0.067638484
Macon,30413,1242,30,29,25,84,0.06763285
Champaign&Sprngfld-Decatur,61851,414,11,9,8,28,0.06763285
Quincy-Hannibal-Keokuk,62357,207,5,5,4,14,0.06763285
Johnstown-Altoona-St Colge,15901,3327,68,72,85,225,0.067628494
Pittsburgh,16034,1804,52,36,34,122,0.067627494
Chattanooga,28905,3475,83,72,80,235,0.067625899
Omaha,51640,1390,34,36,24,94,0.067625899
Lincoln & Hastings-Krny,68922,1183,33,20,27,80,0.067624683
Hartford & New Haven,6068,1745,49,45,24,118,0.067621777
Burlington-Plattsburgh,5032,2588,75,48,52,175,0.067619784
"Columbus, GA (Opelika, AL)",31836,843,21,21,15,57,0.067615658
Hartford & New Haven,6756,3165,78,72,64,214,0.067614534
San Francisco-Oak-San Jose,95437,14228,341,305,316,962,0.067613157
Hartford & New Haven,6058,1701,42,44,29,115,0.06760729
Albany-Schenectady-Troy,12017,355,9,8,7,24,0.067605634
Charleston-Huntington,25047,355,9,8,7,24,0.067605634
Fargo,56584,1420,39,27,30,96,0.067605634
Kansas City,64486,355,9,9,6,24,0.067605634
Albany-Schenectady-Troy,12033,7958,209,172,157,538,0.067604926
Syracuse,13071,1006,28,19,21,68,0.067594433
Clarksburg-Weston,26343,577,16,11,12,39,0.067590988
Kansas City,66026,725,21,14,14,49,0.067586207
Fairbanks,99780,1746,51,31,36,118,0.067583047
Ottumwa-Kirksville,52536,1021,32,21,16,69,0.067580803
Burlington-Plattsburgh,5673,2856,73,69,51,193,0.067577031
West Palm Beach-Ft. Pierce,33496,23840,555,572,484,1611,0.067575503
Albany-Schenectady-Troy,12053,4040,86,95,92,273,0.067574257
New York,18336,4484,112,92,99,303,0.067573595
Youngstown,44401,2649,64,64,51,179,0.067572669
Charleston-Huntington,26141,370,9,8,8,25,0.067567568
Sioux Falls(Mitchell),57278,888,32,18,10,60,0.067567568
Bismarck-Mnt-Dcknsn(Wlstn),58844,148,5,3,2,10,0.067567568
"Springfield, MO",65660,222,6,4,5,15,0.067567568
Amarillo,73946,74,2,1,2,5,0.067567568
Casper-Riverton,82229,74,2,1,2,5,0.067567568
"Washington, DC (Hagrstwn)",23117,11249,280,234,246,760,0.067561561
Hartford & New Haven,6039,2250,73,51,28,152,0.067555556
Indianapolis,47354,1051,27,22,22,71,0.06755471
"Columbus, OH",43337,977,27,22,17,66,0.067553736
Wausau-Rhinelander,54423,2502,72,56,41,169,0.067545963
"Columbus, OH",43331,4338,101,94,98,293,0.067542646
Portland-Auburn,4046,8380,204,189,173,566,0.067541766
Des Moines-Ames,50577,459,13,10,8,31,0.067538126
Knoxville,37886,4975,125,104,107,336,0.067537688
"Washington, DC (Hagrstwn)",23024,9728,249,192,216,657,0.067537007
Burlington-Plattsburgh,5763,2532,63,57,51,171,0.067535545
"Rochester, NY",13156,2073,42,46,52,140,0.067534973
Sioux Falls(Mitchell),57261,385,13,6,7,26,0.067532468
Greenvll-Spart-Ashevll-And,28766,1392,35,25,34,94,0.067528736
St. Louis,62245,1866,51,38,37,126,0.067524116
Richmond-Petersburg,23821,1807,39,34,49,122,0.067515219
Abilene-Sweetwater,76823,2755,76,53,57,186,0.067513612
Savannah,31546,8606,214,191,176,581,0.067511039
Philadelphia,19539,5214,118,119,115,352,0.067510549
Cedar Rapids-Wtrlo-IWC&Dub,52249,948,24,20,20,64,0.067510549
"Portland, OR",98620,8162,207,185,159,551,0.067507964
Chicago,60418,10162,196,218,272,686,0.067506396
Portland-Auburn,4257,2785,60,67,61,188,0.067504488
Charlottesville,22936,5659,146,133,103,382,0.067503092
"Washington, DC (Hagrstwn)",17211,400,9,8,10,27,0.0675
"Washington, DC (Hagrstwn)",22610,2178,56,46,45,147,0.067493113
Portland-Auburn,4354,1541,39,33,32,104,0.067488644
Richmond-Petersburg,23069,3734,91,81,80,252,0.067487949
New York,7463,9839,264,218,182,664,0.067486533
Evansville,47588,489,14,12,7,33,0.067484663
Anchorage,99664,5216,132,103,117,352,0.067484663
Cleveland-Akron (Canton),44131,20777,479,443,480,1402,0.067478462
Los Angeles,92624,7158,170,153,160,483,0.067476949
"Springfield, MO",65655,2964,87,66,47,200,0.067476383
Burlington-Plattsburgh,12936,578,11,13,15,39,0.067474048
Knoxville,37367,11249,245,255,259,759,0.067472664
Burlington-Plattsburgh,5853,415,9,9,10,28,0.06746988
Champaign&Sprngfld-Decatur,60946,415,12,9,7,28,0.06746988
Wichita-Hutchinson Plus,66845,1171,24,21,34,79,0.067463706
Monroe-El Dorado,71336,1423,42,20,34,96,0.067463106
Dallas-Ft. Worth,76649,756,19,12,20,51,0.067460317
Des Moines-Ames,50480,845,12,24,21,57,0.067455621
Dallas-Ft. Worth,75163,2372,54,54,52,160,0.067453626
Cincinnati,47030,1527,35,32,36,103,0.067452521
Montgomery-Selma,36775,682,18,15,13,46,0.06744868
Kansas City,64456,1364,33,19,40,92,0.06744868
Los Angeles,92339,1023,19,22,28,69,0.06744868
Boston (Manchester),3307,5634,136,129,115,380,0.067447639
Billings,59011,3262,96,70,54,220,0.067443286
Tallahassee-Thomasville,32340,10795,273,231,224,728,0.067438629
Boston (Manchester),2571,11196,221,267,267,755,0.067434798
Milwaukee,53126,7118,208,147,125,480,0.067434673
"Columbus, OH",43323,608,16,14,11,41,0.067434211
Sioux Falls(Mitchell),57227,608,15,12,14,41,0.067434211
Wichita-Hutchinson Plus,67473,1661,34,28,50,112,0.067429259
Terre Haute,62427,1765,50,36,33,119,0.067422096
Hartford & New Haven,6336,89,2,1,3,6,0.06741573
Norfolk-Portsmth-Newpt Nws,23109,1691,42,35,37,114,0.06741573
Wheeling-Steubenville,43971,979,20,23,23,66,0.06741573
Minneapolis-St. Paul,56017,1780,51,41,28,120,0.06741573
Fargo,58223,267,8,5,5,18,0.06741573
Colorado Springs-Pueblo,80926,1513,44,27,31,102,0.06741573
Medford-Klamath Falls,97635,89,2,2,2,6,0.06741573
Davenport-R.Island-Moline,62330,1528,36,36,31,103,0.067408377
Flint-Saginaw-Bay City,48612,9183,235,208,176,619,0.067407165
Burlington-Plattsburgh,5477,4599,116,97,97,310,0.067405958
Albany-Schenectady-Troy,12022,994,23,21,23,67,0.067404427
Johnstown-Altoona-St Colge,15551,727,23,16,10,49,0.067400275
Sioux City,50597,1276,32,29,25,86,0.067398119
Duluth-Superior,54874,3650,102,77,67,246,0.06739726
Lexington,41822,1736,42,38,37,117,0.067396313
Panama City,32465,8072,185,170,189,544,0.067393459
Omaha,50274,371,10,7,8,25,0.067385445
Wichita Falls & Lawton,76228,1113,25,26,24,75,0.067385445
Dayton,45387,5387,128,139,96,363,0.067384444
"Portland, OR",97865,1024,22,24,23,69,0.067382813
Peoria-Bloomington,61449,282,7,4,8,19,0.067375887
Champaign&Sprngfld-Decatur,61812,282,6,7,6,19,0.067375887
Baltimore,21915,3132,79,71,61,211,0.067369093
Knoxville,37738,4750,111,112,97,320,0.067368421
Sacramnto-Stkton-Modesto,95667,37347,949,831,736,2516,0.067368196
Albuquerque-Santa Fe,87718,668,21,15,9,45,0.067365269
Des Moines-Ames,52571,1529,41,37,25,103,0.06736429
Providence-New Bedford,2719,16360,379,371,352,1102,0.067359413
Chico-Redding,95954,8195,217,178,157,552,0.067358145
Albany-Schenectady-Troy,12873,772,16,16,20,52,0.067357513
Quincy-Hannibal-Keokuk,62319,193,4,5,4,13,0.067357513
Spokane,83842,193,5,5,3,13,0.067357513
Seattle-Tacoma,98359,5983,160,126,117,403,0.067357513
Columbia-Jefferson City,65059,1069,27,28,17,72,0.067352666
Fargo,56759,490,13,10,10,33,0.067346939
Boston (Manchester),1010,3935,106,84,75,265,0.067344346
Roanoke-Lynchburg,24915,401,15,7,5,27,0.067331671
Sherman-Ada,73447,906,25,12,24,61,0.067328918
Jacksonville,32081,31859,1061,659,425,2145,0.067327914
Minneapolis-St. Paul,56239,505,17,10,7,34,0.067326733
Minneapolis-St. Paul,56216,609,19,11,11,41,0.067323481
San Diego,92007,10695,267,206,247,720,0.067321178
Lincoln & Hastings-Krny,68812,817,18,13,24,55,0.067319461
Boston (Manchester),3249,7978,224,172,141,537,0.067310103
Missoula,59833,6433,172,135,126,433,0.067309187
Burlington-Plattsburgh,5829,1664,38,39,35,112,0.067307692
Watertown,13633,312,8,6,7,21,0.067307692
Omaha,51543,416,12,6,10,28,0.067307692
Bismarck-Mnt-Dcknsn(Wlstn),58488,208,6,5,3,14,0.067307692
Bismarck-Mnt-Dcknsn(Wlstn),58727,312,8,8,5,21,0.067307692
St. Louis,62045,416,12,8,8,28,0.067307692
Wichita-Hutchinson Plus,67072,208,6,5,3,14,0.067307692
Wichita-Hutchinson Plus,67762,312,8,7,6,21,0.067307692
Albuquerque-Santa Fe,88354,104,2,2,3,7,0.067307692
Sacramnto-Stkton-Modesto,95672,5512,163,123,85,371,0.067307692
Pittsburgh,15774,3670,89,81,77,247,0.067302452
Paducah-Cape Girard-Harsbg,62974,1367,39,27,26,92,0.067300658
"Washington, DC (Hagrstwn)",20684,1278,31,32,23,86,0.067292645
Philadelphia,8241,1174,35,19,25,79,0.067291312
New York,7457,4384,85,84,126,295,0.067290146
Peoria-Bloomington,61482,535,12,10,14,36,0.06728972
Rochestr-Mason City-Austin,55990,862,22,19,17,58,0.067285383
Portland-Auburn,4107,9631,288,221,139,648,0.067282733
Youngstown,44432,12129,276,272,268,816,0.067276775
Cincinnati,47325,550,15,10,12,37,0.067272727
Tulsa,74366,1100,33,22,19,74,0.067272727
Greenvll-Spart-Ashevll-And,28734,30637,768,647,646,2061,0.0672716
Bangor,4965,1888,41,45,41,127,0.067266949
Duluth-Superior,54550,669,15,11,19,45,0.067264574
Corpus Christi,78393,2007,47,46,42,135,0.067264574
Philadelphia,8346,565,14,12,12,38,0.067256637
Austin,78027,565,14,11,13,38,0.067256637
Johnstown-Altoona-St Colge,15846,3063,76,61,69,206,0.067254326
Topeka,66073,2275,67,49,37,153,0.067252747
Burlington-Plattsburgh,5071,342,8,7,8,23,0.067251462
Madison,53929,2736,68,69,47,184,0.067251462
Milwaukee,53069,1145,20,28,29,77,0.067248908
Spokane,83530,6216,186,115,117,418,0.067245817
Fresno-Visalia,93602,3361,95,64,67,226,0.067241892
Seattle-Tacoma,98570,4759,134,101,85,320,0.067241017
Jacksonville,32640,10470,277,227,200,704,0.067239733
Buffalo,14712,3153,65,89,58,212,0.067237552
La Crosse-Eau Claire,54631,1874,62,34,30,126,0.067235859
Omaha,51561,1056,31,25,15,71,0.067234848
Sioux City,68758,1056,24,22,25,71,0.067234848
Louisville,47160,119,4,2,2,8,0.067226891
Cedar Rapids-Wtrlo-IWC&Dub,52038,476,13,12,7,32,0.067226891
Madison,53827,357,10,8,6,24,0.067226891
St. Louis,63332,1428,38,32,26,96,0.067226891
St. Louis,65436,119,3,2,3,8,0.067226891
"Springfield, MO",65755,595,16,14,10,40,0.067226891
Lincoln & Hastings-Krny,68871,238,7,6,3,16,0.067226891
Des Moines-Ames,50579,2901,83,55,57,195,0.067218201
Columbia-Jefferson City,63350,610,13,14,14,41,0.067213115
Portland-Auburn,4984,491,14,11,8,33,0.067209776
Boston (Manchester),2632,10951,267,239,230,736,0.067208474
Philadelphia,8560,3824,92,90,75,257,0.067207113
Grand Rapids-Kalmzoo-B.Crk,49051,2351,62,52,44,158,0.067205444
Hartford & New Haven,6437,22052,586,505,391,1482,0.067204789
Sioux Falls(Mitchell),57259,372,7,9,9,25,0.067204301
Greensboro-H.Point-W.Salem,27343,1741,42,39,36,117,0.067202757
Duluth-Superior,55718,3378,93,76,58,227,0.067199526
Pittsburgh,15049,1012,16,22,30,68,0.067193676
Macon,31062,253,5,7,5,17,0.067193676
Green Bay-Appleton,49874,1012,27,22,19,68,0.067193676
Sioux Falls(Mitchell),57469,3036,71,62,71,204,0.067193676
Bismarck-Mnt-Dcknsn(Wlstn),58788,893,29,18,13,60,0.06718925
Burlington-Plattsburgh,5778,640,16,13,14,43,0.0671875
Roanoke-Lynchburg,24484,640,16,13,14,43,0.0671875
Little Rock-Pine Bluff,72561,908,21,23,17,61,0.067180617
St. Louis,63336,1042,24,24,22,70,0.067178503
Buffalo,14172,2873,75,68,50,193,0.067177167
Pittsburgh,16023,4466,102,96,102,300,0.067174205
Pittsburgh,15923,1578,40,37,29,106,0.067173638
"Washington, DC (Hagrstwn)",22435,2114,49,42,51,142,0.067171239
Pittsburgh,16115,3305,77,72,73,222,0.067170953
"Tri-Cities, TN-VA",24250,1072,23,23,26,72,0.067164179
Montgomery-Selma,36113,134,2,4,3,9,0.067164179
Des Moines-Ames,50582,268,8,5,5,18,0.067164179
Rochestr-Mason City-Austin,52155,1206,36,23,22,81,0.067164179
Cedar Rapids-Wtrlo-IWC&Dub,52219,134,3,3,3,9,0.067164179
Ottumwa-Kirksville,52535,804,16,20,18,54,0.067164179
Fargo,58345,134,3,4,2,9,0.067164179
"Springfield, MO",65777,268,6,7,5,18,0.067164179
Tulsa,74332,1623,48,32,29,109,0.067159581
Pittsburgh,15613,14533,315,328,333,976,0.067157504
Reno,89705,6418,165,143,123,431,0.067154877
Pittsburgh,15626,4929,119,104,108,331,0.067153581
Des Moines-Ames,50153,685,19,10,17,46,0.067153285
Boston (Manchester),2538,4676,95,95,124,314,0.067151411
Davenport-R.Island-Moline,61476,551,16,10,11,37,0.067150635
Quincy-Hannibal-Keokuk,62373,551,10,14,13,37,0.067150635
Madison,53560,3738,95,85,71,251,0.067148208
Boston (Manchester),1585,5272,129,130,95,354,0.067147193
"Columbia, SC",29047,3336,79,74,71,224,0.067146283
Cedar Rapids-Wtrlo-IWC&Dub,50654,417,10,10,8,28,0.067146283
Burlington-Plattsburgh,12910,1951,55,45,31,131,0.067145054
Minneapolis-St. Paul,54824,2234,57,50,43,150,0.067144136
New York,8553,700,21,16,10,47,0.067142857
Pittsburgh,15725,1266,26,29,30,85,0.0671406
Wheeling-Steubenville,26170,6196,144,139,133,416,0.06714009
Des Moines-Ames,50122,1430,35,30,31,96,0.067132867
New York,12740,1862,41,39,45,125,0.067132116
Ottumwa-Kirksville,52572,1147,33,21,23,77,0.067131648
Waco-Temple-Bryan,77865,1579,40,35,31,106,0.067131096
Fargo,58064,432,11,8,10,29,0.06712963
Denver,81149,864,22,19,17,58,0.06712963
"Washington, DC (Hagrstwn)",26852,879,25,18,16,59,0.067121729
Pittsburgh,15311,1326,37,25,27,89,0.067119155
Los Angeles,92315,5021,122,107,108,337,0.067118104
Charlotte,27306,6392,167,134,128,429,0.067115144
Charleston-Huntington,25025,149,3,3,4,10,0.067114094
Bismarck-Mnt-Dcknsn(Wlstn),58768,298,9,5,6,20,0.067114094
Great Falls,59463,298,9,6,5,20,0.067114094
Dallas-Ft. Worth,76666,298,8,7,5,20,0.067114094
Albuquerque-Santa Fe,87713,149,5,2,3,10,0.067114094
Buffalo,14080,4068,97,82,94,273,0.067109145
New York,8801,8464,228,195,145,568,0.06710775
Albany-Schenectady-Troy,12015,3636,73,73,98,244,0.067106711
Wichita-Hutchinson Plus,67642,1669,41,30,41,112,0.067106052
Sioux Falls(Mitchell),57003,2295,65,55,34,154,0.067102397
Omaha,68329,462,9,11,11,31,0.067099567
Lincoln & Hastings-Krny,68970,1237,26,20,37,83,0.067097817
Charleston-Huntington,41642,641,19,9,15,43,0.067082683
Bismarck-Mnt-Dcknsn(Wlstn),58573,641,21,13,9,43,0.067082683
New York,12404,3861,100,81,78,259,0.067081067
Orlando-Daytona Bch-Melbrn,32686,4860,108,99,119,326,0.067078189
San Francisco-Oak-San Jose,94611,38808,799,797,1007,2603,0.067073799
Bismarck-Mnt-Dcknsn(Wlstn),58494,328,8,5,9,22,0.067073171
Joplin-Pittsburg,66870,164,5,4,2,11,0.067073171
New York,7460,2967,53,75,71,199,0.067071116
Raleigh-Durham (Fayetvlle),27832,2311,49,55,51,155,0.067070532
Great Falls,59032,507,13,10,11,34,0.067061144
Omaha,68660,1014,28,18,22,68,0.067061144
Honolulu,96753,30137,636,643,742,2021,0.067060424
Jacksonville,32666,5607,132,120,124,376,0.067059033
Albany-Schenectady-Troy,12087,1193,35,22,23,80,0.067057837
Boston (Manchester),3811,7352,166,160,167,493,0.067056583
Burlington-Plattsburgh,5148,1372,35,34,23,92,0.067055394
Charleston-Huntington,26623,1551,37,40,27,104,0.067053514
Oklahoma City,73151,2103,67,45,29,141,0.067047076
"Columbus, GA (Opelika, AL)",36871,1059,23,24,24,71,0.067044381
"Portland, OR",97734,3550,105,71,62,238,0.067042254
New York,12734,1074,29,21,22,72,0.067039106
Great Falls,59532,179,5,4,3,12,0.067039106
St. Louis,62074,1074,31,19,22,72,0.067039106
Paducah-Cape Girard-Harsbg,62998,358,10,7,7,24,0.067039106
Lincoln & Hastings-Krny,68350,179,5,4,3,12,0.067039106
Oklahoma City,73667,537,14,14,8,36,0.067039106
Albuquerque-Santa Fe,87028,179,5,4,3,12,0.067039106
Detroit,48158,7131,178,155,145,478,0.067031272
Ft. Wayne,46766,552,12,15,10,37,0.067028986
Cedar Rapids-Wtrlo-IWC&Dub,52313,373,10,8,7,25,0.067024129
Cedar Rapids-Wtrlo-IWC&Dub,50670,2059,56,36,46,138,0.067022827
Flint-Saginaw-Bay City,48832,1328,28,29,32,89,0.067018072
Beaumont-Port Arthur,75980,2477,60,64,42,166,0.067016552
Philadelphia,18076,2865,76,62,54,192,0.067015707
Charleston-Huntington,41547,194,6,4,3,13,0.067010309
Lansing,49249,3492,84,76,74,234,0.067010309
St. Louis,62649,388,7,8,11,26,0.067010309
Lincoln & Hastings-Krny,68669,388,14,4,8,26,0.067010309
Sioux City,68774,388,12,7,7,26,0.067010309
Oklahoma City,73731,194,6,4,3,13,0.067010309
Baltimore,21625,2194,62,49,36,147,0.067000912
Rochestr-Mason City-Austin,52154,1000,22,21,24,67,0.067
Philadelphia,18938,15060,402,355,252,1009,0.066998672
Albuquerque-Santa Fe,87505,32150,674,713,767,2154,0.066998445
Albany-Schenectady-Troy,12442,806,19,17,18,54,0.066997519
Joplin-Pittsburg,74331,6478,170,150,114,434,0.066995986
Utica,13304,1418,33,32,30,95,0.066995769
Philadelphia,19373,4493,110,92,99,301,0.0669931
Des Moines-Ames,50029,627,17,13,12,42,0.066985646
Des Moines-Ames,50470,209,5,5,4,14,0.066985646
Madison,53544,836,26,15,15,56,0.066985646
Lincoln & Hastings-Krny,68878,418,12,9,7,28,0.066985646
San Francisco-Oak-San Jose,94404,38292,840,826,899,2565,0.066985271
Wichita-Hutchinson Plus,67443,1687,41,39,33,113,0.06698281
Wilmington,28451,48313,1140,937,1159,3236,0.066979902
Milwaukee,53034,1717,45,41,29,115,0.066977286
Rochestr-Mason City-Austin,50645,1075,38,22,12,72,0.066976744
Denver,80737,1523,48,26,28,102,0.066973079
"Rochester, NY",14512,4360,123,89,80,292,0.066972477
Abilene-Sweetwater,79546,1747,34,35,48,117,0.066971952
Wilkes Barre-Scranton-Hztn,18641,5719,109,124,150,383,0.06696975
Bangor,4679,1762,40,45,33,118,0.066969353
Paducah-Cape Girard-Harsbg,42082,1792,43,34,43,120,0.066964286
Lincoln & Hastings-Krny,69024,1120,31,25,19,75,0.066964286
Davenport-R.Island-Moline,52726,4495,125,95,81,301,0.066963293
West Palm Beach-Ft. Pierce,33493,5197,147,106,95,348,0.066961709
"Washington, DC (Hagrstwn)",26847,6034,126,129,149,404,0.066953928
Nashville,38251,2808,77,54,57,188,0.066951567
San Francisco-Oak-San Jose,94525,3301,60,68,93,221,0.066949409
Sacramnto-Stkton-Modesto,95379,3794,90,85,79,254,0.066947812
Pittsburgh,15713,239,6,4,6,16,0.066945607
Wilkes Barre-Scranton-Hztn,17836,239,7,5,4,16,0.066945607
Binghamton,13788,971,28,20,17,65,0.066941298
Orlando-Daytona Bch-Melbrn,32195,3660,91,77,77,245,0.066939891
Spokane,99179,493,12,8,13,33,0.06693712
Portland-Auburn,4260,5677,143,122,115,380,0.066936762
Medford-Klamath Falls,96023,1001,29,20,18,67,0.066933067
Tallahassee-Thomasville,32062,2779,76,58,52,186,0.066930551
Albuquerque-Santa Fe,87016,3631,89,79,75,243,0.066923712
Cleveland-Akron (Canton),44023,20024,595,432,313,1340,0.066919696
Dallas-Ft. Worth,76049,32741,845,688,658,2191,0.066919153
Boston (Manchester),3218,1061,29,19,23,71,0.066918002
Greensboro-H.Point-W.Salem,24328,2137,51,43,49,143,0.066916238
Topeka,66873,269,7,5,6,18,0.066914498
Topeka,67447,269,8,5,5,18,0.066914498
Wichita-Hutchinson Plus,67761,269,7,6,5,18,0.066914498
Sherman-Ada,73439,7308,194,169,126,489,0.066912972
Richmond-Petersburg,23124,6083,178,119,110,407,0.066907776
Davenport-R.Island-Moline,61485,553,19,9,9,37,0.066907776
Denver,80125,17861,545,376,274,1195,0.066905548
San Antonio,78010,3632,97,78,68,243,0.066905286
Presque Isle,4736,8998,222,192,188,602,0.066903756
Portland-Auburn,4024,568,12,11,15,38,0.066901408
Davenport-R.Island-Moline,61465,1136,26,18,32,76,0.066901408
Syracuse,13061,1166,37,23,18,78,0.066895369
Davenport-R.Island-Moline,61230,1166,34,17,27,78,0.066895369
Bismarck-Mnt-Dcknsn(Wlstn),59353,882,25,15,19,59,0.066893424
Eugene,97435,2377,60,46,53,159,0.066891039
Birmingham (Ann and Tusc),35574,1495,38,31,31,100,0.066889632
Bangor,4747,1211,35,30,16,81,0.06688687
Boston (Manchester),1368,1241,30,28,25,83,0.066881547
Cedar Rapids-Wtrlo-IWC&Dub,52305,643,22,13,8,43,0.066874028
Charleston-Huntington,26627,344,9,8,6,23,0.066860465
Lincoln & Hastings-Krny,68976,344,7,8,8,23,0.066860465
Albuquerque-Santa Fe,81331,344,10,6,7,23,0.066860465
Austin,78639,9169,201,203,209,613,0.066855709
Chattanooga,30708,359,8,7,9,24,0.066852368
Springfield-Holyoke,1038,2648,50,64,63,177,0.0668429
St. Louis,65462,1526,40,30,32,102,0.066841415
Cedar Rapids-Wtrlo-IWC&Dub,52309,404,12,8,7,27,0.066831683
Portland-Auburn,4352,1631,31,44,34,109,0.066830166
Traverse City-Cadillac,49729,1631,38,40,31,109,0.066830166
Madison,53821,7751,181,184,153,518,0.066830086
Lincoln & Hastings-Krny,68874,823,22,17,16,55,0.066828676
Bangor,4434,1242,27,35,21,83,0.066827697
Johnstown-Altoona-St Colge,15849,1242,23,30,30,83,0.066827697
San Francisco-Oak-San Jose,94602,29614,631,637,711,1979,0.066826501
Cleveland-Akron (Canton),44412,2514,69,51,48,168,0.066825776
Medford-Klamath Falls,97630,5597,149,107,118,374,0.066821512
Albany-Schenectady-Troy,1367,449,11,11,8,30,0.066815145
Greensboro-H.Point-W.Salem,28675,6301,166,127,128,421,0.066814791
Tulsa,74081,1377,39,31,22,92,0.06681191
Baltimore,20733,2814,70,59,59,188,0.066808813
Traverse City-Cadillac,49342,1467,47,28,23,98,0.066802999
Omaha,51565,494,14,9,10,33,0.066801619
Norfolk-Portsmth-Newpt Nws,23417,3473,75,85,72,232,0.066801037
San Francisco-Oak-San Jose,94920,12815,436,260,160,856,0.066796723
Albany-Schenectady-Troy,12809,3608,78,84,79,241,0.066796009
San Francisco-Oak-San Jose,95451,12112,314,240,255,809,0.066793263
Pittsburgh,15364,554,13,12,12,37,0.066787004
Johnstown-Altoona-St Colge,15722,2306,51,55,48,154,0.066782307
Honolulu,96783,2336,57,54,45,156,0.066780822
Pittsburgh,16319,1213,32,26,23,81,0.066776587
Omaha,50020,1318,34,24,30,88,0.06676783
Idaho Fals-Pocatllo(Jcksn),83452,2022,54,38,43,135,0.066765579
Bismarck-Mnt-Dcknsn(Wlstn),58781,704,20,13,14,47,0.066761364
Tampa-St. Pete (Sarasota),33709,27174,592,599,623,1814,0.066754986
Portland-Auburn,4563,1513,37,30,34,101,0.066754792
Boston (Manchester),1566,6906,180,154,127,461,0.066753548
Tampa-St. Pete (Sarasota),34652,27208,613,580,623,1816,0.066745075
Denver,82834,7627,222,146,141,509,0.066736594
Honolulu,96821,19615,505,448,356,1309,0.066734642
"Washington, DC (Hagrstwn)",26851,1993,46,43,44,133,0.066733567
Cincinnati,45243,15795,485,329,240,1054,0.066729978
Phoenix (Prescott),85356,4316,111,85,92,288,0.066728452
Portland-Auburn,3570,9726,197,219,233,649,0.066728357
"Washington, DC (Hagrstwn)",21502,40015,875,901,894,2670,0.066724978
Burlington-Plattsburgh,5761,1274,35,30,20,85,0.066718995
Rochestr-Mason City-Austin,50428,8978,218,187,194,599,0.066718646
Burlington-Plattsburgh,5356,1289,40,24,22,86,0.066718386
Austin,78636,3927,115,78,69,262,0.066717596
Hartford & New Haven,6078,12997,317,311,239,867,0.066707702
Paducah-Cape Girard-Harsbg,62914,1679,48,29,35,112,0.066706373
Raleigh-Durham (Fayetvlle),24598,1769,45,36,37,118,0.066704353
Dallas-Ft. Worth,75036,37389,1191,706,597,2494,0.066704111
Harrisonburg,22920,4123,111,87,77,275,0.066699006
Lincoln & Hastings-Krny,68713,2174,60,39,46,145,0.066697332
La Crosse-Eau Claire,54745,2219,59,48,41,148,0.06669671
Bangor,4957,4019,86,96,86,268,0.066683255
Greenvll-Spart-Ashevll-And,28759,8203,222,174,151,547,0.066682921
Pittsburgh,15009,15402,415,334,278,1027,0.066679652
San Francisco-Oak-San Jose,94903,29893,760,616,617,1993,0.066671127
Albany-Schenectady-Troy,1011,1230,30,24,28,82,0.066666667
Bangor,4614,2790,69,55,62,186,0.066666667
Presque Isle,4735,555,14,13,10,37,0.066666667
New York,6927,75,1,2,2,5,0.066666667
New York,12752,450,11,7,12,30,0.066666667
Johnstown-Altoona-St Colge,15546,660,15,15,14,44,0.066666667
Wilkes Barre-Scranton-Hztn,17778,105,3,2,2,7,0.066666667
"Washington, DC (Hagrstwn)",22572,7560,186,157,161,504,0.066666667
Charlottesville,22719,360,10,8,6,24,0.066666667
Richmond-Petersburg,23108,165,4,4,3,11,0.066666667
Norfolk-Portsmth-Newpt Nws,27946,960,22,22,20,64,0.066666667
Greenvll-Spart-Ashevll-And,29374,3735,94,83,72,249,0.066666667
Miami-Ft. Lauderdale,33122,15,0,0,1,1,0.066666667
Memphis,38047,75,2,2,1,5,0.066666667
Louisville,40161,195,4,5,4,13,0.066666667
Charleston-Huntington,41531,870,24,17,17,58,0.066666667
"Tri-Cities, TN-VA",41833,375,10,8,7,25,0.066666667
Toledo,43541,135,4,3,2,9,0.066666667
Louisville,47104,45,1,1,1,3,0.066666667
Evansville,47574,150,4,3,3,10,0.066666667
Des Moines-Ames,50570,195,6,3,4,13,0.066666667
Cedar Rapids-Wtrlo-IWC&Dub,50650,690,16,13,17,46,0.066666667
Omaha,51527,495,11,10,12,33,0.066666667
Rochestr-Mason City-Austin,52134,285,9,5,5,19,0.066666667
Cedar Rapids-Wtrlo-IWC&Dub,52312,90,3,2,1,6,0.066666667
Minneapolis-St. Paul,56039,930,23,21,18,62,0.066666667
Sioux Falls(Mitchell),57467,255,9,3,5,17,0.066666667
Fargo,58052,645,19,16,8,43,0.066666667
Rapid City,59316,45,1,1,1,3,0.066666667
Great Falls,59441,90,2,2,2,6,0.066666667
Great Falls,59525,255,7,5,5,17,0.066666667
Peoria-Bloomington,61313,270,9,4,5,18,0.066666667
Davenport-R.Island-Moline,61468,45,1,1,1,3,0.066666667
Peoria-Bloomington,61770,1065,32,22,17,71,0.066666667
Ottumwa-Kirksville,64667,255,4,6,7,17,0.066666667
Topeka,66520,660,21,9,14,44,0.066666667
Topeka,66864,435,13,5,11,29,0.066666667
Wichita-Hutchinson Plus,67120,1425,39,28,28,95,0.066666667
Lincoln & Hastings-Krny,68335,510,15,10,9,34,0.066666667
Lincoln & Hastings-Krny,68655,180,5,2,5,12,0.066666667
Lincoln & Hastings-Krny,68719,120,4,2,2,8,0.066666667
Sioux City,68764,825,14,20,21,55,0.066666667
Sioux City,68792,615,21,10,10,41,0.066666667
Sioux Falls(Mitchell),69216,150,5,3,2,10,0.066666667
Little Rock-Pine Bluff,72585,300,7,6,7,20,0.066666667
Sherman-Ada,73458,765,19,19,13,51,0.066666667
Oklahoma City,73838,660,14,17,13,44,0.066666667
Dallas-Ft. Worth,75450,270,7,5,6,18,0.066666667
Abilene-Sweetwater,76363,240,8,6,2,16,0.066666667
Corpus Christi,78376,495,12,12,9,33,0.066666667
Denver,80830,300,9,6,5,20,0.066666667
Albuquerque-Santa Fe,87730,30,1,0,1,2,0.066666667
Fresno-Visalia,93623,75,1,1,3,5,0.066666667
Sacramnto-Stkton-Modesto,94512,45,1,1,1,3,0.066666667
San Francisco-Oak-San Jose,95444,645,17,12,14,43,0.066666667
"Portland, OR",97722,90,2,2,2,6,0.066666667
Spokane,99034,360,9,7,8,24,0.066666667
Milwaukee,53963,13593,323,282,301,906,0.066651953
Johnstown-Altoona-St Colge,16881,2491,61,52,53,166,0.066639904
"Rochester, NY",14560,2221,48,53,47,148,0.06663665
Bangor,4627,1831,42,37,43,122,0.066630257
New York,8823,9035,175,201,226,602,0.066629773
"Alexandria, LA",71327,5253,130,101,119,350,0.066628593
Detroit,48137,5223,134,121,93,348,0.066628374
Cleveland-Akron (Canton),44032,1681,47,37,28,112,0.066627008
"Washington, DC (Hagrstwn)",22652,1666,37,43,31,111,0.066626651
Pittsburgh,15034,1576,26,35,44,105,0.066624365
Wichita-Hutchinson Plus,66861,3092,74,71,61,206,0.066623545
New York,7068,6169,149,140,122,411,0.06662344
Minneapolis-St. Paul,55910,1426,40,26,29,95,0.066619916
Paducah-Cape Girard-Harsbg,62922,2852,72,66,52,190,0.066619916
Toledo,43445,1411,38,27,29,94,0.066619419
San Francisco-Oak-San Jose,94502,13870,362,313,249,924,0.066618601
Cedar Rapids-Wtrlo-IWC&Dub,52161,1336,42,21,26,89,0.066616766
Burlington-Plattsburgh,3574,2522,54,54,60,168,0.066613799
New York,12443,3663,97,73,74,244,0.066612067
Raleigh-Durham (Fayetvlle),27553,2327,60,54,41,155,0.066609368
Burlington-Plattsburgh,5845,1156,31,23,23,77,0.066608997
New York,12572,9504,232,198,203,633,0.066603535
Portland-Auburn,4039,8318,194,168,192,554,0.066602549
Traverse City-Cadillac,49660,14129,332,304,305,941,0.066600609
Madison,53522,976,26,22,17,65,0.066598361
Buffalo,14836,946,22,16,25,63,0.066596195
New Orleans,70121,11202,203,256,287,746,0.066595251
Atlanta,30513,12133,285,278,245,808,0.066595236
Presque Isle,4776,886,25,17,17,59,0.066591422
Seattle-Tacoma,98329,11113,300,230,210,740,0.06658868
New York,11804,5677,138,137,103,378,0.066584464
Salt Lake City,89821,811,20,16,18,54,0.066584464
Tampa-St. Pete (Sarasota),34606,29737,650,689,641,1980,0.066583717
Fargo,58249,2403,60,35,65,160,0.066583437
Johnstown-Altoona-St Colge,15936,1532,40,34,28,102,0.066579634
Bluefield-Beckley-Oak Hill,24983,2178,62,44,39,145,0.066574839
Cleveland-Akron (Canton),44056,11897,314,240,238,792,0.066571405
Milwaukee,53091,2013,60,30,44,134,0.066567312
Erie,16405,631,16,12,14,42,0.066561014
Denver,69122,631,18,15,9,42,0.066561014
Charleston-Huntington,41528,616,19,12,10,41,0.066558442
Burlington-Plattsburgh,5046,1217,38,26,17,81,0.066557108
Minneapolis-St. Paul,56256,2359,64,41,52,157,0.066553624
West Palm Beach-Ft. Pierce,34952,44566,931,976,1059,2966,0.066552978
Minneapolis-St. Paul,56309,1172,38,22,18,78,0.066552901
Wichita-Hutchinson Plus,67854,1172,35,31,12,78,0.066552901
Johnstown-Altoona-St Colge,15952,1142,27,27,22,76,0.066549912
"Washington, DC (Hagrstwn)",26855,526,14,10,11,35,0.066539924
Charlotte,28644,1548,35,34,34,103,0.066537468
New York,11004,14954,262,314,419,995,0.066537381
Rochestr-Mason City-Austin,50603,511,15,10,9,34,0.066536204
Paducah-Cape Girard-Harsbg,62996,511,14,12,8,34,0.066536204
Marquette,49880,1007,25,23,19,67,0.06653426
Abilene-Sweetwater,79543,977,23,21,21,65,0.066530194
Wilkes Barre-Scranton-Hztn,18424,5321,136,114,104,354,0.066528848
"Tri-Cities, TN-VA",24634,481,12,10,10,32,0.066528067
Boston (Manchester),3032,6088,164,133,108,405,0.06652431
Rochestr-Mason City-Austin,50430,466,12,8,11,31,0.066523605
Tucson (Sierra Vista),85749,18520,472,420,340,1232,0.066522678
Seattle-Tacoma,98053,22429,732,471,289,1492,0.066521022
Seattle-Tacoma,98335,27573,739,573,522,1834,0.066514344
Phoenix (Prescott),85929,8194,212,191,142,545,0.066512082
North Platte,69165,1669,58,26,27,111,0.06650689
Elmira (Corning),16928,1248,37,24,22,83,0.06650641
Paducah-Cape Girard-Harsbg,42036,1233,31,24,27,82,0.066504461
Des Moines-Ames,52534,406,11,7,9,27,0.066502463
Topeka,66415,812,19,15,20,54,0.066502463
Omaha,51533,782,18,19,15,52,0.066496164
"Washington, DC (Hagrstwn)",25437,376,8,8,9,25,0.066489362
Norfolk-Portsmth-Newpt Nws,27917,737,18,13,18,49,0.066485753
Portland-Auburn,4274,5851,147,119,123,389,0.066484362
Lincoln & Hastings-Krny,68937,1459,47,23,27,97,0.066483893
Little Rock-Pine Bluff,71962,722,13,13,22,48,0.066481994
Grand Junction-Montrose,81525,1083,28,24,20,72,0.066481994
Reno,96121,361,11,6,7,24,0.066481994
Green Bay-Appleton,53019,2151,59,44,40,143,0.066480707
Bangor,4987,1053,31,21,18,70,0.066476733
Boston (Manchester),2191,8048,147,169,219,535,0.066476143
Pittsburgh,15646,346,9,7,7,23,0.066473988
Nashville,37029,7236,185,141,155,481,0.06647319
Minneapolis-St. Paul,56368,4438,126,97,72,295,0.066471384
Sioux Falls(Mitchell),57472,1023,19,24,25,68,0.066471163
Boston (Manchester),1969,5792,131,137,117,385,0.066470994
Santabarbra-Sanmar-Sanluob,93453,2994,80,64,55,199,0.066466266
Burlington-Plattsburgh,5052,331,9,7,6,22,0.066465257
Bismarck-Mnt-Dcknsn(Wlstn),58776,331,9,8,5,22,0.066465257
Rockford,61016,4634,103,105,100,308,0.066465257
New York,18425,1279,34,27,24,85,0.06645817
Memphis,38138,25445,662,543,486,1691,0.066457064
Mobile-Pensacola (Ft Walt),36511,617,14,16,11,41,0.066450567
Minneapolis-St. Paul,56167,617,18,15,8,41,0.066450567
Paducah-Cape Girard-Harsbg,63855,918,28,17,16,61,0.066448802
Austin,78606,6938,182,154,125,461,0.066445662
Harrisonburg,26802,903,22,21,17,60,0.066445183
Cincinnati,47036,903,25,17,18,60,0.066445183
Rochestr-Mason City-Austin,56029,602,16,9,15,40,0.066445183
Orlando-Daytona Bch-Melbrn,32127,29273,646,664,635,1945,0.06644348
Fresno-Visalia,93614,11574,314,261,194,769,0.066442025
"Tri-Cities, TN-VA",24211,10009,241,222,202,665,0.066440204
"Tri-Cities, TN-VA",41832,572,17,10,11,38,0.066433566
Columbia-Jefferson City,63351,1701,38,38,37,113,0.066431511
Eugene,97326,843,24,19,13,56,0.066429419
Rochestr-Mason City-Austin,55965,2499,70,47,49,166,0.066426571
Burlington-Plattsburgh,5075,1370,36,28,27,91,0.066423358
Corpus Christi,78383,3538,97,74,64,235,0.066421707
Greenvll-Spart-Ashevll-And,29658,271,8,6,4,18,0.066420664
Amarillo,79061,271,7,6,5,18,0.066420664
Charlotte,29712,2138,48,51,43,142,0.066417212
Burlington-Plattsburgh,5363,2364,48,45,64,157,0.06641286
Jacksonville,31565,2078,52,50,36,138,0.06641001
Topeka,66427,1280,38,25,22,85,0.06640625
Burlington-Plattsburgh,3777,1265,31,23,30,84,0.066403162
Traverse City-Cadillac,49654,753,27,16,7,50,0.066401062
Des Moines-Ames,50541,753,29,9,12,50,0.066401062
Lincoln & Hastings-Krny,68852,497,15,9,9,33,0.06639839
Monroe-El Dorado,71229,1988,43,46,43,132,0.06639839
"Portland, OR",97004,4714,120,106,87,313,0.066397964
Tampa-St. Pete (Sarasota),33898,19067,454,392,420,1266,0.066397441
Denver,81123,738,20,16,13,49,0.066395664
Tampa-St. Pete (Sarasota),34233,19490,467,427,400,1294,0.066393022
Bismarck-Mnt-Dcknsn(Wlstn),58356,1702,39,35,39,113,0.066392479
Des Moines-Ames,50117,241,7,4,5,16,0.066390041
Sioux Falls(Mitchell),57279,964,15,23,26,64,0.066390041
Watertown,13670,467,18,6,7,31,0.066381156
Fargo,58071,467,12,8,11,31,0.066381156
Albany-Schenectady-Troy,12460,226,5,5,5,15,0.066371681
Greenville-N.Bern-Washngtn,28524,452,10,11,9,30,0.066371681
Lincoln & Hastings-Krny,68651,1356,38,24,28,90,0.066371681
Minneapolis-St. Paul,54009,2697,76,54,49,179,0.066370041
Albany-Schenectady-Troy,12137,1567,38,35,31,104,0.066368858
Portland-Auburn,4579,3119,89,61,57,207,0.066367425
Minneapolis-St. Paul,54858,1552,41,29,33,103,0.066365979
Albany-Schenectady-Troy,12019,15204,427,311,271,1009,0.066364115
Great Falls,59072,4385,113,100,78,291,0.0663626
Utica,12064,437,10,7,12,29,0.066361556
Davenport-R.Island-Moline,61232,1311,41,23,23,87,0.066361556
Hartford & New Haven,6782,2170,60,46,38,144,0.066359447
New York,10516,5425,146,111,103,360,0.066359447
Savannah,31563,1296,27,27,32,86,0.066358025
Lincoln & Hastings-Krny,68844,211,6,3,5,14,0.066350711
Lincoln & Hastings-Krny,68855,422,14,7,7,28,0.066350711
Little Rock-Pine Bluff,72166,211,6,4,4,14,0.066350711
San Francisco-Oak-San Jose,94946,633,13,14,15,42,0.066350711
Erie,16313,1658,39,39,32,110,0.066344994
Albany-Schenectady-Troy,12845,4763,106,87,123,316,0.066344741
Hartford & New Haven,6247,2683,58,60,60,178,0.066343645
Hartford & New Haven,6759,5773,138,125,120,383,0.066343322
Quincy-Hannibal-Keokuk,61440,618,17,15,9,41,0.066343042
Wilkes Barre-Scranton-Hztn,18469,407,11,8,8,27,0.066339066
Rochestr-Mason City-Austin,56016,1010,28,18,21,67,0.066336634
Des Moines-Ames,50574,2201,62,30,54,146,0.066333485
Boston (Manchester),2648,7598,182,172,150,504,0.066333246
Duluth-Superior,55765,799,20,15,18,53,0.066332916
Springfield-Holyoke,1081,1794,48,39,32,119,0.066332219
Rochestr-Mason City-Austin,55962,784,22,18,12,52,0.066326531
Los Angeles,92256,3498,88,69,75,232,0.066323613
Youngstown,16154,2111,45,50,45,140,0.06631928
Chicago,60463,13527,303,320,274,897,0.066311821
Joplin-Pittsburg,66852,558,15,11,11,37,0.066308244
Harrisburg-Lncstr-Leb-York,17365,2006,49,42,42,133,0.066301097
Sacramnto-Stkton-Modesto,95945,26109,608,584,539,1731,0.066298977
Lexington,41386,181,5,4,3,12,0.066298343
Cleveland-Akron (Canton),43749,2534,61,54,53,168,0.066298343
Portland-Auburn,4236,4465,108,91,97,296,0.066293393
Anchorage,99672,4616,130,88,88,306,0.066291161
Abilene-Sweetwater,76464,528,12,11,12,35,0.066287879
San Angelo,76875,528,17,10,8,35,0.066287879
Orlando-Daytona Bch-Melbrn,32764,3651,81,75,86,242,0.06628321
Syracuse,13486,694,20,13,13,46,0.066282421
Columbia-Jefferson City,63388,694,14,17,15,46,0.066282421
Omaha,68417,347,9,8,6,23,0.066282421
Providence-New Bedford,2888,19146,413,392,464,1269,0.066280163
Lincoln & Hastings-Krny,68354,860,24,18,15,57,0.06627907
Shreveport,71004,513,13,13,8,34,0.066276803
Minneapolis-St. Paul,54840,4708,125,87,100,312,0.066270178
Ft. Myers-Naples,34113,25668,571,586,544,1701,0.066269285
"Portland, OR",97827,2837,85,52,51,188,0.066267184
"Alexandria, LA",71333,830,20,17,18,55,0.06626506
Albuquerque-Santa Fe,87745,996,24,19,23,66,0.06626506
Duluth-Superior,54864,1630,41,37,30,108,0.066257669
Salisbury,19945,9448,221,203,202,626,0.066257409
Shreveport,75973,2279,70,37,44,151,0.06625713
Los Angeles,90071,800,9,11,33,53,0.06625
Minneapolis-St. Paul,56131,2234,42,51,55,148,0.066248881
Wichita-Hutchinson Plus,67134,317,10,6,5,21,0.066246057
New York,12491,1736,39,37,39,115,0.06624424
"Washington, DC (Hagrstwn)",25444,785,17,16,19,52,0.066242038
Sioux Falls(Mitchell),57212,2038,52,40,43,135,0.066241413
Ottumwa-Kirksville,52635,619,17,12,12,41,0.066235864
San Antonio,78266,8440,245,175,139,559,0.066232227
Hartford & New Haven,6331,5043,129,105,100,334,0.066230418
Davenport-R.Island-Moline,61284,2431,70,47,44,161,0.06622789
Lincoln & Hastings-Krny,68439,453,13,11,6,30,0.066225166
Bismarck-Mnt-Dcknsn(Wlstn),58545,3307,99,57,63,219,0.066223163
Burlington-Plattsburgh,5471,740,18,19,12,49,0.066216216
Cleveland-Akron (Canton),44333,19407,505,436,344,1285,0.066213222
Wilmington,28452,438,12,9,8,29,0.066210046
Dallas-Ft. Worth,76005,8020,245,161,125,531,0.066209476
Cedar Rapids-Wtrlo-IWC&Dub,52215,725,20,15,13,48,0.066206897
Milwaukee,53122,6480,200,140,89,429,0.066203704
Mankato,56088,1722,37,39,38,114,0.066202091
Madison,53944,2568,69,55,46,170,0.066199377
Pittsburgh,15668,13550,344,323,230,897,0.066199262
Bangor,4628,710,17,15,15,47,0.066197183
Terre Haute,47578,710,22,10,15,47,0.066197183
Parkersburg,26181,5816,135,121,129,385,0.066196699
Denver,80135,4094,135,82,54,271,0.066194431
Cleveland-Akron (Canton),44620,1269,26,29,29,84,0.066193853
Albany-Schenectady-Troy,12827,3943,82,88,91,261,0.066193254
Boston (Manchester),1867,25789,685,567,455,1707,0.066191012
Philadelphia,8022,9231,233,197,181,611,0.066190012
Cedar Rapids-Wtrlo-IWC&Dub,52041,1390,42,27,23,92,0.06618705
"Charleston, SC",29487,2916,68,66,59,193,0.066186557
Burlington-Plattsburgh,5043,1103,40,16,17,73,0.066183137
Sioux Falls(Mitchell),57236,136,3,3,3,9,0.066176471
Omaha,64491,1617,46,32,29,107,0.066171923
Paducah-Cape Girard-Harsbg,38255,2131,50,41,50,141,0.066166119
West Palm Beach-Ft. Pierce,33412,18167,436,392,374,1202,0.066163924
Charleston-Huntington,41254,529,14,12,9,35,0.066162571
Harrisonburg,22952,1980,53,34,44,131,0.066161616
Des Moines-Ames,50563,2373,64,52,41,157,0.066160978
New York,12567,2494,63,48,54,165,0.066158781
Colorado Springs-Pueblo,81089,4822,116,102,101,319,0.066155122
Erie,16436,650,16,13,14,43,0.066153846
Milwaukee,53005,22721,647,478,378,1503,0.066150257
Philadelphia,19534,2056,52,38,46,136,0.06614786
Wichita-Hutchinson Plus,67736,257,7,4,6,17,0.06614786
"Columbus, GA (Opelika, AL)",31821,635,13,12,17,42,0.066141732
Philadelphia,19533,8195,198,177,167,542,0.066137889
Raleigh-Durham (Fayetvlle),27572,6925,172,137,149,458,0.066137184
Albany-Schenectady-Troy,12473,877,19,20,19,58,0.06613455
"Charleston, SC",29469,877,25,18,15,58,0.06613455
Milwaukee,53922,877,19,16,23,58,0.06613455
Monroe-El Dorado,71658,499,14,10,9,33,0.066132265
Milwaukee,53039,4582,109,102,92,303,0.066128328
Charleston-Huntington,26208,862,22,19,16,57,0.06612529
Philadelphia,19547,4431,102,100,91,293,0.066125028
Hartford & New Haven,6798,9709,202,238,202,642,0.066124215
Great Falls,59260,121,3,2,3,8,0.066115702
Lincoln & Hastings-Krny,69027,242,7,4,5,16,0.066115702
Lincoln & Hastings-Krny,69039,242,6,5,5,16,0.066115702
North Platte,69142,121,4,2,2,8,0.066115702
Spokane,98827,484,13,11,8,32,0.066115702
"Portland, OR",98672,7563,201,174,125,500,0.066111331
Wausau-Rhinelander,54459,1316,34,28,25,87,0.066109422
Tallahassee-Thomasville,31638,953,25,20,18,63,0.06610703
"Washington, DC (Hagrstwn)",22642,4644,121,103,83,307,0.066106804
Clarksburg-Weston,26283,1543,36,35,31,102,0.06610499
Providence-New Bedford,2790,17064,389,349,390,1128,0.066104079
Helena,59643,590,16,12,11,39,0.066101695
Peoria-Bloomington,61319,1165,36,21,20,77,0.066094421
Bangor,4626,348,9,9,5,23,0.066091954
"Washington, DC (Hagrstwn)",26720,348,8,7,8,23,0.066091954
"Portland, OR",97040,1392,35,31,26,92,0.066091954
Philadelphia,8226,11304,260,278,209,747,0.066082803
Ft. Wayne,46737,6825,178,138,135,451,0.066080586
Buffalo,14822,908,27,18,15,60,0.066079295
Rochestr-Mason City-Austin,55977,227,7,5,3,15,0.066079295
Bismarck-Mnt-Dcknsn(Wlstn),58731,227,7,4,4,15,0.066079295
Bismarck-Mnt-Dcknsn(Wlstn),59219,227,5,4,6,15,0.066079295
Albuquerque-Santa Fe,87023,560,13,12,12,37,0.066071429
Cedar Rapids-Wtrlo-IWC&Dub,52229,666,18,15,11,44,0.066066066
Oklahoma City,73747,333,12,6,4,22,0.066066066
Albany-Schenectady-Troy,12070,1438,36,38,21,95,0.066063978
Boston (Manchester),3448,772,24,14,13,51,0.066062176
"Portland, OR",98625,7373,200,149,138,487,0.066051811
Wichita-Hutchinson Plus,67758,969,28,18,18,64,0.066047472
Shreveport,71835,1181,33,25,20,78,0.066045724
Boston (Manchester),3602,2665,64,54,58,176,0.066041276
Bluefield-Beckley-Oak Hill,24844,1060,26,23,21,70,0.066037736
Traverse City-Cadillac,49667,636,14,14,14,42,0.066037736
Sioux Falls(Mitchell),57251,212,6,4,4,14,0.066037736
Bismarck-Mnt-Dcknsn(Wlstn),58565,212,5,4,5,14,0.066037736
Oklahoma City,73749,424,10,7,11,28,0.066037736
Abilene-Sweetwater,79505,212,4,5,5,14,0.066037736
New York,11963,8541,205,191,168,564,0.066034422
Burlington-Plattsburgh,5081,939,24,22,16,62,0.066027689
Bangor,4658,1348,39,24,26,89,0.066023739
Boston (Manchester),3229,6074,193,111,97,401,0.066019098
Fargo,58011,409,10,7,10,27,0.06601467
La Crosse-Eau Claire,54661,3969,113,81,68,262,0.06601159
Bangor,4677,303,7,6,7,20,0.066006601
New York,12463,1515,35,24,41,100,0.066006601
Roanoke-Lynchburg,22971,1606,40,32,34,106,0.066002491
Minneapolis-St. Paul,56327,803,23,16,14,53,0.066002491
Sacramnto-Stkton-Modesto,95641,2197,55,43,47,145,0.06599909
Baltimore,21013,4985,140,111,78,329,0.065997994
San Francisco-Oak-San Jose,94951,4470,96,89,110,295,0.065995526
Sioux City,51355,788,16,9,27,52,0.065989848
Fargo,58006,394,9,11,6,26,0.065989848
New York,7009,13654,322,306,273,901,0.065987989
Charlotte,28037,30659,839,648,536,2023,0.065983887
Lincoln & Hastings-Krny,68841,682,16,16,13,45,0.065982405
"Portland, OR",98648,3213,87,63,62,212,0.065981948
Sioux Falls(Mitchell),57434,485,12,9,11,32,0.065979381
Grand Junction-Montrose,81526,5517,130,128,106,364,0.065977887
Sioux City,68770,1258,34,23,26,83,0.065977742
Boston (Manchester),3048,3471,71,70,88,229,0.065975223
Madison,53531,4714,133,98,80,311,0.065973695
Syracuse,13303,1152,31,22,23,76,0.065972222
Denver,69155,864,24,17,16,57,0.065972222
Davenport-R.Island-Moline,61235,1334,31,27,30,88,0.065967016
Boston (Manchester),2673,9081,187,218,194,599,0.065961898
"Tri-Cities, TN-VA",24270,470,11,10,10,31,0.065957447
Marquette,49816,470,13,10,8,31,0.065957447
Minneapolis-St. Paul,55417,26154,604,550,571,1725,0.065955494
"Springfield, MO",65590,1683,46,31,34,111,0.065953654
Johnstown-Altoona-St Colge,16844,2851,64,51,73,188,0.065941775
San Diego,91916,2290,53,50,48,151,0.065938865
San Francisco-Oak-San Jose,95453,12178,296,258,249,803,0.065938578
Denver,81403,13179,362,274,233,869,0.065938235
Buffalo,14082,364,7,8,9,24,0.065934066
Sioux Falls(Mitchell),57264,182,5,4,3,12,0.065934066
Bismarck-Mnt-Dcknsn(Wlstn),58385,182,6,3,3,12,0.065934066
Billings,59343,91,2,2,2,6,0.065934066
Davenport-R.Island-Moline,61014,1092,27,24,21,72,0.065934066
St. Louis,62667,455,10,11,9,30,0.065934066
Phoenix (Prescott),86403,18094,366,365,462,1193,0.065933459
Charlotte,28777,10359,258,217,208,683,0.065933005
Phoenix (Prescott),85387,33671,857,654,709,2220,0.065932108
Orlando-Daytona Bch-Melbrn,32778,25922,578,576,555,1709,0.065928555
Boston (Manchester),3290,5142,136,107,96,339,0.065927655
Baltimore,20778,1714,45,38,30,113,0.065927655
Los Angeles,92252,8510,195,173,193,561,0.065922444
Eugene,97469,2776,68,55,60,183,0.06592219
Bangor,4643,895,22,20,17,59,0.065921788
Sioux City,57034,804,25,18,10,53,0.065920398
Greensboro-H.Point-W.Salem,27305,1335,32,32,24,88,0.065917603
Davenport-R.Island-Moline,61041,1335,36,22,30,88,0.065917603
Burlington-Plattsburgh,12950,622,13,13,15,41,0.065916399
Burlington-Plattsburgh,5906,1153,30,27,19,76,0.065915004
Lincoln & Hastings-Krny,68415,531,15,14,6,35,0.065913371
Dallas-Ft. Worth,76637,531,14,12,9,35,0.065913371
Burlington-Plattsburgh,5154,440,11,11,7,29,0.065909091
"Columbus, GA (Opelika, AL)",36053,1745,44,39,32,115,0.065902579
Great Falls,59489,349,9,7,7,23,0.065902579
Albuquerque-Santa Fe,87734,349,8,6,9,23,0.065902579
Augusta-Aiken,29838,607,15,16,9,40,0.065897858
Peoria-Bloomington,61432,607,16,8,16,40,0.065897858
Minneapolis-St. Paul,55001,2944,83,67,44,194,0.065896739
Sioux City,50514,1290,36,28,21,85,0.065891473
Minneapolis-St. Paul,54721,1290,36,21,28,85,0.065891473
Fairbanks,99743,850,25,12,19,56,0.065882353
Roanoke-Lynchburg,24122,1594,40,33,32,105,0.06587202
Portland-Auburn,3581,3097,76,56,72,204,0.065870197
Bluefield-Beckley-Oak Hill,24974,501,18,5,10,33,0.065868263
Oklahoma City,73758,167,3,5,3,11,0.065868263
Binghamton,12167,2247,50,43,55,148,0.065865599
Boston (Manchester),3034,4069,83,98,87,268,0.065863849
Lincoln & Hastings-Krny,68351,744,21,16,12,49,0.065860215
Bluefield-Beckley-Oak Hill,25841,577,14,12,12,38,0.065857886
Springfield-Holyoke,1339,1564,39,33,31,103,0.065856777
Honolulu,96738,7638,230,151,122,503,0.065854936
Tallahassee-Thomasville,32094,3037,72,66,62,200,0.065854462
Fargo,56552,410,11,9,7,27,0.065853659
Davenport-R.Island-Moline,61437,820,14,21,19,54,0.065853659
Minneapolis-St. Paul,56473,3933,109,86,64,259,0.065853038
Madison,53716,19255,452,398,418,1268,0.065853025
Providence-New Bedford,2748,12240,293,264,249,806,0.065849673
San Francisco-Oak-San Jose,94586,896,23,20,16,59,0.065848214
Hattiesburg-Laurel,39356,972,19,20,25,64,0.065843621
Des Moines-Ames,50545,243,6,6,4,16,0.065843621
Des Moines-Ames,52583,243,6,6,4,16,0.065843621
La Crosse-Eau Claire,55941,972,27,18,19,64,0.065843621
Wichita-Hutchinson Plus,67474,243,6,3,7,16,0.065843621
Madison,53521,3767,94,85,69,248,0.065834882
Lincoln & Hastings-Krny,68979,1838,45,35,41,121,0.065832427
Charlotte,28673,6942,185,151,121,457,0.065831173
Burlington-Plattsburgh,5034,319,6,8,7,21,0.065830721
Fargo,58017,319,8,5,8,21,0.065830721
Topeka,66058,319,10,7,4,21,0.065830721
Omaha,64446,1033,24,20,24,68,0.065827686
Salt Lake City,83113,2066,59,36,41,136,0.065827686
Paducah-Cape Girard-Harsbg,42044,3312,91,69,58,218,0.065821256
Green Bay-Appleton,54173,4391,126,93,70,289,0.065816443
Richmond-Petersburg,23897,547,11,12,13,36,0.065813528
Phoenix (Prescott),86442,35667,815,765,767,2347,0.065803123
Monroe-El Dorado,71479,1003,24,23,19,66,0.065802592
Eugene,97454,1231,39,19,23,81,0.065800162
Fargo,58270,1839,40,36,45,121,0.065796629
Philadelphia,18038,3131,75,66,65,206,0.065793676
Albany-Schenectady-Troy,12878,760,19,21,10,50,0.065789474
Ft. Myers-Naples,34104,26448,548,564,628,1740,0.065789474
Bowling Green,42252,76,2,2,1,5,0.065789474
Sioux City,51024,2128,73,36,31,140,0.065789474
Sioux Falls(Mitchell),57269,380,11,8,6,25,0.065789474
Rapid City,57792,76,2,1,2,5,0.065789474
Fargo,58241,152,3,4,3,10,0.065789474
Fargo,58281,76,2,1,2,5,0.065789474
Great Falls,59465,76,2,2,1,5,0.065789474
Kansas City,64438,228,5,4,6,15,0.065789474
Lincoln & Hastings-Krny,68014,228,7,4,4,15,0.065789474
Waco-Temple-Bryan,76518,1444,39,24,32,95,0.065789474
Denver,80749,380,10,6,9,25,0.065789474
Greenvll-Spart-Ashevll-And,28786,22087,484,459,510,1453,0.065785304
Joplin-Pittsburg,74344,15581,371,325,329,1025,0.065785251
Champaign&Sprngfld-Decatur,62440,1125,32,22,20,74,0.065777778
Paducah-Cape Girard-Harsbg,62919,1049,29,23,17,69,0.06577693
Greenvll-Spart-Ashevll-And,29384,4120,97,77,97,271,0.065776699
"Springfield, MO",65785,5458,144,119,96,359,0.065775009
Kansas City,64632,669,18,13,13,44,0.065769806
Bangor,4648,593,13,11,15,39,0.065767285
Albuquerque-Santa Fe,81327,593,16,11,12,39,0.065767285
Albany-Schenectady-Troy,12108,517,7,9,18,34,0.065764023
Detroit,49287,2129,53,51,36,140,0.065758572
Little Rock-Pine Bluff,72532,1688,35,39,37,111,0.065758294
Kansas City,64657,365,10,6,8,24,0.065753425
Utica,13348,1384,32,29,30,91,0.065751445
Omaha,68152,6723,182,140,120,442,0.065744459
Sioux Falls(Mitchell),57448,289,7,7,5,19,0.065743945
Champaign&Sprngfld-Decatur,61810,289,8,6,5,19,0.065743945
Ft. Smith-Fay-Sprngdl-Rgrs,72852,289,7,6,6,19,0.065743945
Portland-Auburn,4021,6784,218,141,87,446,0.065742925
Denver,80465,16672,447,357,292,1096,0.065738964
Boston (Manchester),3451,4016,85,77,102,264,0.065737052
Philadelphia,19444,11425,292,242,217,751,0.065733042
Pittsburgh,15686,928,20,18,23,61,0.065732759
Bangor,4920,1567,38,34,31,103,0.065730696
Omaha,51447,213,5,5,4,14,0.0657277
Omaha,51645,213,4,5,5,14,0.0657277
Bismarck-Mnt-Dcknsn(Wlstn),58560,213,7,4,3,14,0.0657277
Lincoln & Hastings-Krny,68314,350,10,9,4,23,0.065714286
Portland-Auburn,4002,7883,183,172,163,518,0.065711024
Syracuse,13110,2298,51,48,52,151,0.065709312
Lincoln & Hastings-Krny,68436,487,13,6,13,32,0.065708419
Lincoln & Hastings-Krny,68859,487,15,8,9,32,0.065708419
Kansas City,66041,624,14,16,11,41,0.065705128
Phoenix (Prescott),86323,20029,461,424,431,1316,0.065704728
Harrisburg-Lncstr-Leb-York,17032,7808,191,164,158,513,0.065701844
Tampa-St. Pete (Sarasota),33843,12405,346,253,216,815,0.065699315
"Portland, OR",97144,274,6,5,7,18,0.065693431
Cedar Rapids-Wtrlo-IWC&Dub,52159,2116,50,43,46,139,0.065689981
Knoxville,37880,3943,97,79,83,259,0.065686026
"Springfield, MO",64776,3943,99,76,84,259,0.065686026
Traverse City-Cadillac,49738,9652,223,197,214,634,0.065685868
Omaha,68454,746,24,14,11,49,0.065683646
Minneapolis-St. Paul,54761,1081,25,19,27,71,0.065679926
Paducah-Cape Girard-Harsbg,62982,1081,24,30,17,71,0.065679926
Wichita-Hutchinson Plus,67737,472,12,8,11,31,0.065677966
Terre Haute,62421,670,19,11,14,44,0.065671642
Lincoln & Hastings-Krny,68746,335,11,6,5,22,0.065671642
Utica,13328,1066,27,21,22,70,0.065666041
Wichita-Hutchinson Plus,67738,533,14,8,13,35,0.065666041
Eureka,95524,1599,43,31,31,105,0.065666041
Burlington-Plattsburgh,5874,594,14,13,12,39,0.065656566
Montgomery-Selma,36052,853,21,18,17,56,0.065650645
"Springfield, MO",72653,29429,664,646,622,1932,0.065649529
New York,18445,2422,56,47,56,159,0.065648225
Bangor,4617,716,19,13,15,47,0.065642458
Sioux Falls(Mitchell),57474,259,7,6,4,17,0.065637066
Abilene-Sweetwater,76882,259,8,6,3,17,0.065637066
Hartford & New Haven,6254,1874,44,42,37,123,0.065635005
Portland-Auburn,4222,4251,111,94,74,279,0.065631616
Greenvll-Spart-Ashevll-And,28714,16776,382,330,389,1101,0.065629471
"Portland, OR",97329,320,8,7,6,21,0.065625
"Springfield, MO",64763,1341,32,24,32,88,0.06562267
Minneapolis-St. Paul,55396,2103,61,43,34,138,0.065620542
Minneapolis-St. Paul,54801,6797,190,139,117,446,0.065617184
Kansas City,66042,381,10,8,7,25,0.065616798
Billings,82414,16734,402,342,354,1098,0.065614916
Omaha,68418,1265,40,24,19,83,0.065612648
Traverse City-Cadillac,49645,1829,53,28,39,120,0.065609623
Clarksburg-Weston,26206,2515,65,53,47,165,0.065606362
"Springfield, MO",65635,564,13,12,12,37,0.065602837
Dallas-Ft. Worth,75859,2317,66,53,33,152,0.065602072
"Springfield, MO",65438,2500,57,43,64,164,0.0656
Reno,89429,8705,236,157,178,571,0.065594486
Bangor,4443,2287,55,54,41,150,0.065588107
Erie,16411,1174,29,21,27,77,0.065587734
Bangor,4410,1235,31,23,27,81,0.065587045
Monroe-El Dorado,71261,1418,38,28,27,93,0.065585331
"Washington, DC (Hagrstwn)",22733,1601,42,35,28,105,0.06558401
Burlington-Plattsburgh,3603,5154,137,104,97,338,0.065580132
Dallas-Ft. Worth,75860,6664,170,148,119,437,0.06557623
Pittsburgh,15007,244,9,4,3,16,0.06557377
Johnstown-Altoona-St Colge,15411,549,8,15,13,36,0.06557377
Wilkes Barre-Scranton-Hztn,17957,305,6,6,8,20,0.06557377
Charlottesville,22711,61,2,1,1,4,0.06557377
Fargo,56551,2257,53,48,47,148,0.06557377
Bismarck-Mnt-Dcknsn(Wlstn),58386,122,3,2,3,8,0.06557377
Quincy-Hannibal-Keokuk,62314,488,11,11,10,32,0.06557377
Quincy-Hannibal-Keokuk,62344,122,2,3,3,8,0.06557377
Omaha,68379,61,2,1,1,4,0.06557377
San Antonio,78838,244,4,6,6,16,0.06557377
Denver,81210,244,6,6,4,16,0.06557377
San Francisco-Oak-San Jose,95488,244,6,4,6,16,0.06557377
"Portland, OR",97712,61,2,1,1,4,0.06557377
Boston (Manchester),1452,4316,105,101,77,283,0.065569972
Quincy-Hannibal-Keokuk,65275,2242,62,46,39,147,0.065566459
Reno,89451,9319,217,202,192,611,0.065564975
New York,7732,4713,68,97,144,309,0.065563335
Omaha,68069,2898,78,60,52,190,0.065562457
"Tri-Cities, TN-VA",37691,900,22,19,18,59,0.065555556
Duluth-Superior,55721,3417,107,61,56,224,0.06555458
Tampa-St. Pete (Sarasota),34689,28253,669,648,535,1852,0.065550561
Denver,80828,3402,80,73,70,223,0.065549677
Nashville,37175,1129,35,23,16,74,0.06554473
Boston (Manchester),3237,2426,71,47,41,159,0.065539984
Richmond-Petersburg,23126,473,13,8,10,31,0.065539112
Minneapolis-St. Paul,56280,473,14,9,8,31,0.065539112
Oklahoma City,73736,473,11,11,9,31,0.065539112
Charleston-Huntington,25501,1236,25,27,29,81,0.065533981
Burlington-Plattsburgh,5858,351,9,8,6,23,0.065527066
New York,12768,931,21,20,20,61,0.065520945
Youngstown,16137,12256,305,244,254,803,0.06551893
Davenport-R.Island-Moline,61275,4182,121,84,69,274,0.06551889
Phoenix (Prescott),85331,31750,901,726,453,2080,0.065511811
Wichita-Hutchinson Plus,67749,2122,49,37,53,139,0.065504241
Minneapolis-St. Paul,54841,229,7,5,3,15,0.065502183
Fargo,58377,229,7,3,5,15,0.065502183
Wichita-Hutchinson Plus,67511,229,5,5,5,15,0.065502183
Omaha,68036,458,14,7,9,30,0.065502183
Burlington-Plattsburgh,5086,855,23,16,17,56,0.065497076
Burlington-Plattsburgh,5737,626,15,15,11,41,0.065495208
Denver,80736,626,13,13,15,41,0.065495208
Albany-Schenectady-Troy,12156,794,18,15,19,52,0.065491184
Sioux Falls(Mitchell),57432,397,9,8,9,26,0.065491184
"Columbus, OH",43066,1359,40,27,22,89,0.06548933
"Columbia, SC",29130,6322,170,123,121,414,0.065485606
Boston (Manchester),2668,3543,85,73,74,232,0.065481231
Clarksburg-Weston,26411,672,11,16,17,44,0.06547619
Rapid City,57788,504,14,10,9,33,0.06547619
Santabarbra-Sanmar-Sanluob,93254,840,20,20,15,55,0.06547619
Springfield-Holyoke,1354,1451,38,26,31,95,0.065472088
Flint-Saginaw-Bay City,48747,1451,35,24,36,95,0.065472088
Sioux Falls(Mitchell),57070,1451,30,36,29,95,0.065472088
Missoula,59917,5300,155,116,76,347,0.065471698
Lexington,41472,11197,283,247,203,733,0.065463964
Buffalo,14034,1940,48,41,38,127,0.065463918
Buffalo,16748,2811,62,54,68,184,0.065457133
Tulsa,67347,275,9,4,5,18,0.065454545
Lincoln & Hastings-Krny,68858,275,7,3,8,18,0.065454545
"Portland, OR",97814,13002,316,259,276,851,0.065451469
Philadelphia,8327,657,16,9,18,43,0.065449011
Quincy-Hannibal-Keokuk,63448,1421,30,29,34,93,0.065446868
"Jackson, MS",39427,1253,29,29,24,82,0.065442937
Great Falls,59457,8878,214,182,185,581,0.065442667
"Portland, OR",97021,1192,38,19,21,78,0.065436242
"Washington, DC (Hagrstwn)",20689,1406,41,28,23,92,0.065433855
Raleigh-Durham (Fayetvlle),27869,1727,44,41,28,113,0.065431384
Bangor,4429,5013,126,89,113,328,0.065429882
Minneapolis-St. Paul,56318,1238,33,17,31,81,0.06542811
Bismarck-Mnt-Dcknsn(Wlstn),58540,2904,82,61,47,190,0.065426997
Topeka,66968,1559,41,36,25,102,0.065426555
New York,11719,3592,83,74,78,235,0.065423163
Charleston-Huntington,25103,107,2,2,3,7,0.065420561
Charleston-Huntington,25612,214,5,4,5,14,0.065420561
"Washington, DC (Hagrstwn)",26817,535,14,9,12,35,0.065420561
Norfolk-Portsmth-Newpt Nws,27966,1284,31,26,27,84,0.065420561
Wausau-Rhinelander,54418,1070,29,21,20,70,0.065420561
Minneapolis-St. Paul,54845,107,3,2,2,7,0.065420561
Minneapolis-St. Paul,56257,428,13,6,9,28,0.065420561
Rapid City,57775,214,5,4,5,14,0.065420561
Sioux City,68732,214,6,5,3,14,0.065420561
Albuquerque-Santa Fe,87579,749,19,14,16,49,0.065420561
Reno,96136,107,3,2,2,7,0.065420561
Pittsburgh,21561,2446,60,46,54,160,0.065412919
Minneapolis-St. Paul,56218,581,17,11,10,38,0.065404475
Des Moines-Ames,50135,1636,42,37,28,107,0.065403423
Lincoln & Hastings-Krny,68342,474,13,10,8,31,0.065400844
Seattle-Tacoma,98346,10842,265,228,216,709,0.065393839
Albany-Schenectady-Troy,12075,3395,87,71,64,222,0.06539028
Charleston-Huntington,26678,887,31,13,14,58,0.065388952
Burlington-Plattsburgh,5058,260,7,5,5,17,0.065384615
Bluefield-Beckley-Oak Hill,24976,780,25,11,15,51,0.065384615
Lincoln & Hastings-Krny,68338,260,7,5,5,17,0.065384615
Burlington-Plattsburgh,12918,2539,65,54,47,166,0.065380071
Burlington-Plattsburgh,5655,3105,78,65,60,203,0.065378422
"Portland, OR",97054,1499,35,34,29,98,0.065376918
Raleigh-Durham (Fayetvlle),24580,413,11,7,9,27,0.065375303
Amarillo,79237,413,10,7,10,27,0.065375303
Johnstown-Altoona-St Colge,16866,9698,193,183,258,634,0.065374304
Salt Lake City,83118,1178,31,28,18,77,0.065365025
Albany-Schenectady-Troy,12887,6135,151,121,129,401,0.065362673
Duluth-Superior,55731,5294,118,139,89,346,0.065357008
Wheeling-Steubenville,26039,811,23,18,12,53,0.065351418
Lexington,41311,6672,146,142,148,436,0.065347722
Columbia-Jefferson City,65260,505,13,12,8,33,0.065346535
Portland-Auburn,4088,1607,46,33,26,105,0.065339141
Baltimore,21034,3306,86,67,63,216,0.065335753
Santabarbra-Sanmar-Sanluob,93463,8847,215,179,184,578,0.065332881
Binghamton,12093,1546,36,30,35,101,0.065329884
"Springfield, MO",65564,199,5,5,3,13,0.065326633
Wichita-Hutchinson Plus,67731,597,16,10,13,39,0.065326633
Lincoln & Hastings-Krny,68833,199,4,5,4,13,0.065326633
Waco-Temple-Bryan,76653,995,28,18,19,65,0.065326633
Austin,78624,23808,587,467,501,1555,0.06531418
Wilkes Barre-Scranton-Hztn,18629,1669,34,35,40,109,0.065308568
Pittsburgh,15345,1470,36,29,31,96,0.065306122
Bismarck-Mnt-Dcknsn(Wlstn),58520,245,5,5,6,16,0.065306122
Amarillo,88118,245,9,5,2,16,0.065306122
Traverse City-Cadillac,49402,1562,41,32,29,102,0.065300896
Raleigh-Durham (Fayetvlle),27874,3951,90,86,82,258,0.065299924
Burlington-Plattsburgh,3748,4656,80,94,130,304,0.065292096
Baltimore,21084,6785,164,148,131,443,0.065291083
Grand Rapids-Kalmzoo-B.Crk,49344,3875,96,84,73,253,0.065290323
Monterey-Salinas,95005,7260,177,145,152,474,0.065289256
Tampa-St. Pete (Sarasota),33776,12713,328,275,227,830,0.065287501
Buffalo,14748,628,15,13,13,41,0.065286624
"Portland, OR",97029,337,11,5,6,22,0.065281899
Hartford & New Haven,6778,1057,24,25,20,69,0.065279092
Roanoke-Lynchburg,24366,720,17,16,14,47,0.065277778
Charlotte,28643,3294,81,69,65,215,0.065270188
Harrisonburg,24421,3723,92,77,74,243,0.065269944
Seattle-Tacoma,98394,1241,35,20,26,81,0.065269944
Cedar Rapids-Wtrlo-IWC&Dub,52141,1379,36,30,24,90,0.065264685
Norfolk-Portsmth-Newpt Nws,23890,3892,90,80,84,254,0.065262076
Sioux Falls(Mitchell),57029,1992,50,40,40,130,0.065261044
Des Moines-Ames,50026,521,14,12,8,34,0.065259117
Green Bay-Appleton,54408,1042,28,23,17,68,0.065259117
Paducah-Cape Girard-Harsbg,62905,521,12,12,10,34,0.065259117
Norfolk-Portsmth-Newpt Nws,27927,1609,31,38,36,105,0.065257924
Wausau-Rhinelander,54440,2927,75,57,59,191,0.065254527
Grand Junction-Montrose,81507,16398,462,353,255,1070,0.06525186
Kansas City,64650,705,17,18,11,46,0.065248227
Greenwood-Greenville,39176,2008,49,41,41,131,0.065239044
Wilkes Barre-Scranton-Hztn,18834,3219,82,62,66,210,0.065237651
Burlington-Plattsburgh,5038,1257,27,31,24,82,0.065234686
Richmond-Petersburg,23156,1303,30,29,26,85,0.065234075
Kansas City,64470,1441,37,33,24,94,0.065232477
Philadelphia,19505,3480,79,66,82,227,0.065229885
Charleston-Huntington,41224,3787,92,80,75,247,0.065223132
Albany-Schenectady-Troy,12042,414,11,8,8,27,0.065217391
Albany-Schenectady-Troy,12407,46,1,1,1,3,0.065217391
Utica,13301,92,2,1,3,6,0.065217391
Pittsburgh,15446,46,1,1,1,3,0.065217391
Elmira (Corning),16942,736,17,9,22,48,0.065217391
Wilkes Barre-Scranton-Hztn,17774,1012,35,16,15,66,0.065217391
Bluefield-Beckley-Oak Hill,25115,46,1,1,1,3,0.065217391
Charleston-Huntington,26615,46,1,1,1,3,0.065217391
Charleston-Huntington,26621,598,15,13,11,39,0.065217391
Columbus-Tupelo-West Point,38859,782,19,13,19,51,0.065217391
South Bend-Elkhart,46968,46,1,1,1,3,0.065217391
Indianapolis,47386,1104,28,21,23,72,0.065217391
Des Moines-Ames,50239,184,5,3,4,12,0.065217391
Des Moines-Ames,50835,92,3,1,2,6,0.065217391
Minneapolis-St. Paul,56207,184,5,4,3,12,0.065217391
Fargo,56755,92,3,1,2,6,0.065217391
Sioux Falls(Mitchell),57027,138,4,3,2,9,0.065217391
Sioux Falls(Mitchell),57454,552,13,11,12,36,0.065217391
Bismarck-Mnt-Dcknsn(Wlstn),58794,138,4,3,2,9,0.065217391
Rockford,60553,644,18,15,9,42,0.065217391
St. Louis,63433,46,1,1,1,3,0.065217391
Ottumwa-Kirksville,63560,184,6,4,2,12,0.065217391
Kansas City,64164,368,10,6,8,24,0.065217391
Wichita-Hutchinson Plus,67629,138,3,4,2,9,0.065217391
Denver,69335,46,1,1,1,3,0.065217391
Ft. Smith-Fay-Sprngdl-Rgrs,72835,966,21,22,20,63,0.065217391
Colorado Springs-Pueblo,81036,1058,24,14,31,69,0.065217391
Amarillo,88134,92,3,2,1,6,0.065217391
Spokane,99156,9093,237,192,164,593,0.065215001
Raleigh-Durham (Fayetvlle),27376,9554,251,200,172,623,0.06520829
Bangor,4457,5644,141,107,120,368,0.065201984
Green Bay-Appleton,54101,2730,75,54,49,178,0.065201465
Sioux Falls(Mitchell),57055,1181,30,25,22,77,0.065198984
Portland-Auburn,4253,2178,39,45,58,142,0.065197429
Rochestr-Mason City-Austin,50469,1672,43,33,33,109,0.065191388
Binghamton,13775,1488,40,27,30,97,0.065188172
Ottumwa-Kirksville,52565,1933,48,44,34,126,0.065183652
"Springfield, MO",72655,629,16,15,10,41,0.06518283
Topeka,66409,3007,77,69,50,196,0.065181244
Ft. Smith-Fay-Sprngdl-Rgrs,72851,583,14,13,11,38,0.065180103
Wilkes Barre-Scranton-Hztn,18255,4388,103,90,93,286,0.065177758
Paducah-Cape Girard-Harsbg,62871,537,10,14,11,35,0.065176909
Providence-New Bedford,2822,6168,154,118,130,402,0.065175097
Mankato,56176,1028,21,22,24,67,0.065175097
Pittsburgh,15622,890,19,21,18,58,0.065168539
Memphis,72346,445,9,7,13,29,0.065168539
Denver,81076,445,16,7,6,29,0.065168539
Albany-Schenectady-Troy,12067,1688,44,29,37,110,0.065165877
Wilkes Barre-Scranton-Hztn,18824,1059,24,20,25,69,0.065155807
Fargo,56554,3085,86,64,51,201,0.065153971
Springfield-Holyoke,1039,1673,36,33,40,109,0.065152421
Omaha,51649,307,5,7,8,20,0.06514658
Wichita-Hutchinson Plus,67563,307,8,4,8,20,0.06514658
Portland-Auburn,4358,4559,117,88,92,297,0.065145865
St. Louis,62214,1090,26,19,26,71,0.065137615
Greenvll-Spart-Ashevll-And,28731,9488,206,211,201,618,0.065134907
Hartford & New Haven,6021,1259,32,22,28,82,0.065131056
Greensboro-H.Point-W.Salem,27283,2948,66,64,62,192,0.065128901
Tyler-Longview(Lfkn&Ncgd),75451,1213,26,28,25,79,0.065127782
Minneapolis-St. Paul,55981,4238,104,95,77,276,0.065125059
Syracuse,13152,7740,211,170,123,504,0.065116279
Des Moines-Ames,50863,215,6,5,3,14,0.065116279
Lincoln & Hastings-Krny,68960,215,5,5,4,14,0.065116279
Cleveland-Akron (Canton),44286,6404,180,130,107,417,0.065115553
Boston (Manchester),3809,3809,82,90,76,248,0.065108952
Seattle-Tacoma,98045,16987,464,368,274,1106,0.065108612
Portland-Auburn,4917,3287,88,64,62,214,0.065104959
Fargo,56733,384,11,6,8,25,0.065104167
"Springfield, MO",72683,768,20,19,11,50,0.065104167
Youngstown,16133,1321,33,30,23,86,0.065102195
Cedar Rapids-Wtrlo-IWC&Dub,50601,2381,53,50,52,155,0.065098698
Columbia-Jefferson City,65236,1275,29,27,27,83,0.065098039
Roanoke-Lynchburg,24597,1229,34,20,26,80,0.065093572
St. Louis,62021,845,21,21,13,55,0.065088757
St. Louis,62083,169,4,4,3,11,0.065088757
Topeka,66859,169,5,3,3,11,0.065088757
Albuquerque-Santa Fe,88336,169,6,2,3,11,0.065088757
Wheeling-Steubenville,26149,2274,49,51,48,148,0.065083553
Dallas-Ft. Worth,76525,1137,30,21,23,74,0.065083553
Pittsburgh,16258,1767,37,34,44,115,0.06508206
Wilmington,28462,14029,342,278,293,913,0.065079478
Minneapolis-St. Paul,56051,630,12,14,15,41,0.065079365
"Washington, DC (Hagrstwn)",22640,461,10,10,10,30,0.065075922
Boston (Manchester),3870,5548,142,132,87,361,0.065068493
Reno,96130,20241,434,428,455,1317,0.065065955
Greenvll-Spart-Ashevll-And,28705,6163,145,120,136,401,0.065065715
Raleigh-Durham (Fayetvlle),27312,24947,666,533,424,1623,0.065057923
Denver,82331,2137,48,37,54,139,0.065044455
Boston (Manchester),1922,3244,71,80,60,211,0.065043157
Albany-Schenectady-Troy,12810,492,13,12,7,32,0.06504065
"Rochester, NY",14545,123,3,3,2,8,0.06504065
Indianapolis,46049,861,23,17,16,56,0.06504065
Terre Haute,47862,1476,42,33,21,96,0.06504065
Bismarck-Mnt-Dcknsn(Wlstn),58475,123,3,3,2,8,0.06504065
Lincoln & Hastings-Krny,68860,369,10,8,6,24,0.06504065
Philadelphia,18092,3429,90,70,63,223,0.065033537
Albany-Schenectady-Troy,12482,569,15,12,10,37,0.065026362
Greensboro-H.Point-W.Salem,27006,15840,401,341,288,1030,0.065025253
Jacksonville,32086,34157,722,692,807,2221,0.065023275
Philadelphia,8403,1092,25,27,19,71,0.065018315
Albuquerque-Santa Fe,87723,323,10,4,7,21,0.06501548
Wausau-Rhinelander,54471,1815,51,38,29,118,0.065013774
Seattle-Tacoma,99115,1169,30,29,17,76,0.065012831
Boston (Manchester),3862,4553,117,108,71,296,0.06501208
Bangor,4932,1246,32,21,28,81,0.065008026
Minneapolis-St. Paul,55324,1123,33,20,20,73,0.065004452
Green Bay-Appleton,49887,2446,62,48,49,159,0.065004088
Lubbock,79366,1200,27,28,23,78,0.065
Salt Lake City,82925,200,5,4,4,13,0.065
Santabarbra-Sanmar-Sanluob,93432,1200,31,25,22,78,0.065
"Washington, DC (Hagrstwn)",22716,954,25,20,17,62,0.064989518
"Springfield, MO",72628,954,23,19,20,62,0.064989518
Houston,77835,2262,52,43,52,147,0.064986737
Green Bay-Appleton,54204,1816,53,37,28,118,0.064977974
Corpus Christi,78382,20484,501,477,353,1331,0.064977543
Minneapolis-St. Paul,56127,354,10,8,5,23,0.064971751
Wilkes Barre-Scranton-Hztn,18618,3617,65,82,88,235,0.06497097
Richmond-Petersburg,23153,1847,45,40,35,120,0.064970222
Eugene,97495,1647,38,35,34,107,0.064966606
Yuma-El Centro,92233,6665,176,140,117,433,0.064966242
Milwaukee,53125,2155,47,61,32,140,0.064965197
Champaign&Sprngfld-Decatur,62643,431,9,8,11,28,0.064965197
Cleveland-Akron (Canton),44141,13608,368,286,230,884,0.064961787
Charleston-Huntington,25124,1016,26,25,15,66,0.06496063
Wilkes Barre-Scranton-Hztn,18222,9468,224,198,193,615,0.06495564
Pittsburgh,15139,6651,98,148,186,432,0.064952639
Burlington-Plattsburgh,12974,1555,44,30,27,101,0.064951768
Bangor,4958,1863,53,36,32,121,0.064949007
Tampa-St. Pete (Sarasota),34452,12981,305,253,285,843,0.064941068
Miami-Ft. Lauderdale,33442,31307,553,689,791,2033,0.064937554
Watertown,13639,77,3,1,1,5,0.064935065
Wilkes Barre-Scranton-Hztn,18465,1232,30,29,21,80,0.064935065
Sioux City,51026,770,25,18,7,50,0.064935065
Missoula,59931,231,6,4,5,15,0.064935065
Peoria-Bloomington,61720,231,6,6,3,15,0.064935065
Oklahoma City,74856,693,22,11,12,45,0.064935065
Denver,81239,77,2,2,1,5,0.064935065
Idaho Fals-Pocatllo(Jcksn),83414,539,14,8,13,35,0.064935065
Albuquerque-Santa Fe,87746,77,2,1,2,5,0.064935065
Little Rock-Pine Bluff,72645,1571,38,39,25,102,0.064926798
Seattle-Tacoma,98362,24429,535,490,561,1586,0.064922838
Minneapolis-St. Paul,56634,1602,31,34,39,104,0.064918851
Richmond-Petersburg,23894,724,17,15,15,47,0.064917127
Baltimore,20758,1063,29,23,17,69,0.06491063
"Portland, OR",97833,909,26,17,16,59,0.064906491
Buffalo,15834,3883,92,77,83,252,0.064898275
Toledo,49230,10586,247,214,226,687,0.064897034
Sioux Falls(Mitchell),57232,339,11,6,5,22,0.064896755
Fargo,58079,524,14,12,8,34,0.064885496
Harrisonburg,24485,447,10,8,11,29,0.064876957
Albany-Schenectady-Troy,12850,2420,62,45,50,157,0.064876033
Wilkes Barre-Scranton-Hztn,18830,632,16,15,10,41,0.064873418
Indianapolis,46290,185,6,4,2,12,0.064864865
Cedar Rapids-Wtrlo-IWC&Dub,52072,370,10,8,6,24,0.064864865
Los Angeles,91008,1480,31,31,34,96,0.064864865
Providence-New Bedford,2813,8495,195,177,179,551,0.064861683
Cincinnati,45252,4456,104,83,102,289,0.064856373
Duluth-Superior,55757,1141,27,16,31,74,0.06485539
Harrisburg-Lncstr-Leb-York,17329,2575,73,47,47,167,0.064854369
Missoula,59804,8450,200,180,168,548,0.064852071
Davenport-R.Island-Moline,52746,771,22,18,10,50,0.064850843
Orlando-Daytona Bch-Melbrn,32937,27434,720,563,496,1779,0.064846541
Bluefield-Beckley-Oak Hill,24314,1465,36,30,29,95,0.064846416
Salisbury,21842,11073,202,229,287,718,0.064842409
Green Bay-Appleton,54982,7125,183,130,149,462,0.064842105
Eureka,95542,2776,52,62,66,180,0.064841499
Wichita Falls & Lawton,79227,1095,33,23,15,71,0.064840183
Wichita-Hutchinson Plus,67029,910,24,14,21,59,0.064835165
Marquette,49935,6108,165,106,125,396,0.064833006
Rapid City,59324,1018,21,11,34,66,0.064833006
Eugene,97438,1342,49,20,18,87,0.064828614
Meridian,36916,725,15,17,15,47,0.064827586
Peoria-Bloomington,61484,725,16,8,23,47,0.064827586
Salisbury,19966,37763,882,751,815,2448,0.064825358
Bangor,4606,1157,27,30,18,75,0.064822818
Topeka,66524,2314,63,47,40,150,0.064822818
Tucson (Sierra Vista),85737,21968,538,489,397,1424,0.064821559
Johnstown-Altoona-St Colge,15540,324,9,6,6,21,0.064814815
Cedar Rapids-Wtrlo-IWC&Dub,52170,432,11,7,10,28,0.064814815
Sioux Falls(Mitchell),57455,108,3,2,2,7,0.064814815
Columbia-Jefferson City,63381,540,15,11,9,35,0.064814815
Fresno-Visalia,93260,216,5,5,4,14,0.064814815
Portland-Auburn,4008,3117,70,65,67,202,0.064805903
"Tri-Cities, TN-VA",24245,1003,22,22,21,65,0.064805583
Detroit,48054,7330,167,167,141,475,0.064802183
Shreveport,71044,679,18,18,8,44,0.064801178
Wilkes Barre-Scranton-Hztn,18826,1605,43,30,31,104,0.064797508
Pittsburgh,15051,463,12,11,7,30,0.064794816
Albuquerque-Santa Fe,88352,5140,136,98,99,333,0.064785992
New York,10464,4322,74,91,115,280,0.064784822
Greenvll-Spart-Ashevll-And,28742,2763,69,57,53,179,0.064784654
South Bend-Elkhart,49113,1806,45,41,31,117,0.064784053
Sioux City,51020,602,14,11,14,39,0.064784053
Greenville-N.Bern-Washngtn,27983,8521,203,198,151,552,0.064781129
Atlanta,28909,1096,33,21,17,71,0.064781022
Jacksonville,31537,10729,259,220,216,695,0.064777705
Bangor,4408,247,6,7,3,16,0.064777328
Norfolk-Portsmth-Newpt Nws,23128,741,17,16,15,48,0.064777328
Rochestr-Mason City-Austin,50472,2424,63,42,52,157,0.064768977
Green Bay-Appleton,54909,2177,59,40,42,141,0.064768029
Philadelphia,19073,22344,542,496,409,1447,0.064760115
Traverse City-Cadillac,48625,13342,322,258,284,864,0.064757907
San Antonio,78880,1220,32,22,25,79,0.064754098
Portland-Auburn,4015,3691,69,87,83,239,0.0647521
New York,12790,5560,120,118,122,360,0.064748201
Chattanooga,35774,139,4,3,2,9,0.064748201
"Tri-Cities, TN-VA",37731,834,18,21,15,54,0.064748201
Omaha,51540,417,11,12,4,27,0.064748201
Amarillo,79044,417,12,6,9,27,0.064748201
Beaumont-Port Arthur,75931,2286,56,46,46,148,0.064741907
Johnstown-Altoona-St Colge,16854,1004,21,22,22,65,0.064741036
Elmira (Corning),16946,2595,67,51,50,168,0.064739884
Utica,13324,1900,45,44,34,123,0.064736842
Green Bay-Appleton,54124,3661,92,76,69,237,0.064736411
Wausau-Rhinelander,54537,587,18,11,9,38,0.064735945
Norfolk-Portsmth-Newpt Nws,27947,1344,32,27,28,87,0.064732143
Fargo,58256,896,30,18,10,58,0.064732143
Minneapolis-St. Paul,56469,1066,25,23,21,69,0.064727955
St. Louis,62063,1066,29,22,18,69,0.064727955
"Columbia, SC",29355,927,23,19,18,60,0.064724919
Cleveland-Akron (Canton),44449,1236,37,22,21,80,0.064724919
Salisbury,21856,958,20,25,17,62,0.064718163
Burlington-Plattsburgh,3223,3817,85,80,82,247,0.064710506
New Orleans,70040,1669,39,35,34,108,0.064709407
Orlando-Daytona Bch-Melbrn,33538,5409,130,121,99,350,0.06470697
Ottumwa-Kirksville,64645,170,2,4,5,11,0.064705882
Sioux Falls(Mitchell),69221,170,4,3,4,11,0.064705882
Monroe-El Dorado,71264,850,26,15,14,55,0.064705882
Spokane,99122,4482,111,91,88,290,0.064703257
Spokane,99003,5595,149,112,101,362,0.064700626
Fargo,58278,2334,78,47,26,151,0.064695801
Traverse City-Cadillac,49710,371,8,9,7,24,0.064690027
Richmond-Petersburg,23850,1345,32,27,28,87,0.064684015
Seattle-Tacoma,98110,24968,771,505,339,1615,0.064682794
Elmira (Corning),14861,1175,32,24,20,76,0.064680851
Des Moines-Ames,50139,1175,36,15,25,76,0.064680851
Johnstown-Altoona-St Colge,16637,2412,57,54,45,156,0.064676617
Charleston-Huntington,25132,201,4,4,5,13,0.064676617
Des Moines-Ames,50249,1206,29,24,25,78,0.064676617
Wichita-Hutchinson Plus,67057,201,4,3,6,13,0.064676617
"Springfield, MO",65624,1639,37,39,30,106,0.064673581
Sherman-Ada,74569,634,16,14,11,41,0.06466877
La Crosse-Eau Claire,54756,866,22,18,16,56,0.064665127
Denver,69345,665,16,11,16,43,0.064661654
New York,7465,5645,119,114,132,365,0.06465899
Jonesboro,72453,232,5,6,4,15,0.064655172
Lubbock,79517,232,6,5,4,15,0.064655172
Fargo,58048,495,11,14,7,32,0.064646465
Bismarck-Mnt-Dcknsn(Wlstn),58759,758,21,16,12,49,0.064643799
Burlington-Plattsburgh,12978,263,6,6,5,17,0.064638783
Meridian,36922,263,5,6,6,17,0.064638783
Bismarck-Mnt-Dcknsn(Wlstn),58761,1052,29,19,20,68,0.064638783
Great Falls,59471,263,7,5,5,17,0.064638783
"Springfield, MO",72670,526,12,11,11,34,0.064638783
Bakersfield,93240,5848,138,119,121,378,0.064637483
San Francisco-Oak-San Jose,94567,557,13,11,12,36,0.064631957
San Diego,92014,12518,314,249,246,809,0.064626937
Roanoke-Lynchburg,26291,294,7,6,6,19,0.06462585
Omaha,68378,588,17,11,10,38,0.06462585
Spokane,99185,1470,44,24,27,95,0.06462585
Lincoln & Hastings-Krny,68620,3002,81,48,65,194,0.064623584
Wausau-Rhinelander,54441,619,18,12,10,40,0.064620355
Watertown,13624,5061,112,120,95,327,0.064611737
San Francisco-Oak-San Jose,95409,27427,618,607,547,1772,0.064607868
Monroe-El Dorado,71223,356,9,9,5,23,0.064606742
Twin Falls,83332,2492,64,50,47,161,0.064606742
Albany-Schenectady-Troy,1225,3297,79,64,70,213,0.064604186
Tulsa,74432,9334,236,202,165,603,0.064602528
Burlington-Plattsburgh,12934,1130,28,23,22,73,0.06460177
"Tri-Cities, TN-VA",41825,387,9,7,9,25,0.064599483
Nashville,38221,3158,88,55,61,204,0.064597847
Minneapolis-St. Paul,54837,4087,108,79,77,264,0.064595057
"Charleston, SC",29455,32049,643,643,784,2070,0.064588599
Greenvll-Spart-Ashevll-And,29664,1796,50,37,29,116,0.064587973
Portland-Auburn,4275,480,11,11,9,31,0.064583333
Eugene,97490,480,14,9,8,31,0.064583333
La Crosse-Eau Claire,54622,2075,49,42,43,134,0.064578313
Mankato,56041,1053,28,21,19,68,0.064577398
Flint-Saginaw-Bay City,48657,7712,180,174,144,498,0.064574689
Traverse City-Cadillac,49682,4429,119,95,72,286,0.064574396
Elmira (Corning),14869,1115,24,23,25,72,0.064573991
Greenville-N.Bern-Washngtn,28516,11491,253,236,253,742,0.064572274
Wichita-Hutchinson Plus,67481,635,17,9,15,41,0.064566929
Albany-Schenectady-Troy,12865,3206,72,69,66,207,0.064566438
Bangor,4474,3965,111,75,70,256,0.064564943
Macon,31711,697,14,14,17,45,0.06456241
Sioux City,68727,728,19,15,13,47,0.06456044
Albuquerque-Santa Fe,87529,6909,157,159,130,446,0.064553481
Davenport-R.Island-Moline,61259,1100,26,25,20,71,0.064545455
Ft. Myers-Naples,33954,12054,258,264,256,778,0.06454289
Tampa-St. Pete (Sarasota),33772,24249,531,532,502,1565,0.064538744
Boston (Manchester),1985,4509,140,85,66,291,0.064537591
Greensboro-H.Point-W.Salem,28623,1596,37,35,31,103,0.064536341
Orlando-Daytona Bch-Melbrn,32179,9607,233,200,187,620,0.064536276
Tampa-St. Pete (Sarasota),33773,19958,394,420,474,1288,0.064535525
Salisbury,21813,2898,58,71,58,187,0.06452726
Minneapolis-St. Paul,56334,5889,162,105,113,380,0.064527084
Burlington-Plattsburgh,3601,248,8,5,3,16,0.064516129
Portland-Auburn,3817,248,6,5,5,16,0.064516129
Philadelphia,8324,310,8,4,8,20,0.064516129
Burlington-Plattsburgh,12924,217,5,5,4,14,0.064516129
Des Moines-Ames,50275,496,10,14,8,32,0.064516129
Minneapolis-St. Paul,56014,744,17,16,15,48,0.064516129
Minneapolis-St. Paul,56371,124,4,2,2,8,0.064516129
Sioux Falls(Mitchell),57237,744,22,10,16,48,0.064516129
Billings,59026,155,5,3,2,10,0.064516129
Great Falls,59244,62,2,1,1,4,0.064516129
Peoria-Bloomington,61730,310,8,8,4,20,0.064516129
St. Louis,62001,1767,42,40,32,114,0.064516129
St. Louis,63060,1829,37,46,35,118,0.064516129
Wichita-Hutchinson Plus,66853,310,9,7,4,20,0.064516129
Denver,69041,93,2,2,2,6,0.064516129
Denver,69340,93,2,2,2,6,0.064516129
Denver,69354,93,3,2,1,6,0.064516129
Lake Charles,70645,868,18,17,21,56,0.064516129
"Springfield, MO",72515,62,2,1,1,4,0.064516129
San Antonio,78072,372,10,8,6,24,0.064516129
Amarillo,79251,62,2,1,1,4,0.064516129
Denver,80101,434,12,8,8,28,0.064516129
Tampa-St. Pete (Sarasota),33540,10091,228,212,211,651,0.064512932
Cedar Rapids-Wtrlo-IWC&Dub,52043,2155,57,44,38,139,0.06450116
Sioux Falls(Mitchell),57231,1659,45,35,27,107,0.064496685
Pittsburgh,15344,1535,36,27,36,99,0.064495114
Minneapolis-St. Paul,55030,1256,32,25,24,81,0.064490446
Lincoln & Hastings-Krny,68456,1070,29,22,18,69,0.064485981
"Portland, OR",97042,2869,70,55,60,185,0.064482398
Johnstown-Altoona-St Colge,16878,1706,44,33,33,110,0.064478312
Lincoln & Hastings-Krny,69045,791,22,12,17,51,0.064475348
La Crosse-Eau Claire,55943,3133,85,57,60,202,0.064474944
Albany-Schenectady-Troy,12117,2792,66,62,52,180,0.064469914
Montgomery-Selma,36853,8889,199,169,205,573,0.064461694
Paducah-Cape Girard-Harsbg,62972,1179,28,23,25,76,0.064461408
Binghamton,13832,574,14,11,12,37,0.06445993
Greenville-N.Bern-Washngtn,27817,6888,153,163,128,444,0.06445993
Savannah,31554,7509,178,156,150,484,0.064455986
Pittsburgh,15327,1350,31,28,28,87,0.064444444
Des Moines-Ames,50252,419,14,7,6,27,0.064439141
Wichita-Hutchinson Plus,67654,4159,105,94,69,268,0.064438567
Greenville-N.Bern-Washngtn,28573,1971,45,39,43,127,0.064434297
Elmira (Corning),16938,776,16,16,18,50,0.06443299
Milwaukee,53523,5448,153,108,90,351,0.064427313
Wheeling-Steubenville,43944,2111,51,40,45,136,0.064424443
Atlanta,36263,683,18,13,13,44,0.064421669
Minneapolis-St. Paul,56013,4269,97,82,96,275,0.064417896
Albuquerque-Santa Fe,88020,947,24,20,17,61,0.064413939
Sioux Falls(Mitchell),57066,1568,40,27,34,101,0.064413265
Lexington,40387,1863,50,35,35,120,0.064412238
Quincy-Hannibal-Keokuk,63462,1537,37,33,29,99,0.064411191
Sioux Falls(Mitchell),57313,1180,26,29,21,76,0.06440678
Sacramnto-Stkton-Modesto,95651,885,23,18,16,57,0.06440678
Dallas-Ft. Worth,75550,559,13,10,13,36,0.064400716
Elmira (Corning),14809,2500,67,48,46,161,0.0644
Salisbury,21811,24599,578,517,489,1584,0.064392861
Portland-Auburn,4069,1553,45,36,19,100,0.0643915
Minneapolis-St. Paul,54875,1025,27,21,18,66,0.064390244
Wichita-Hutchinson Plus,67151,466,13,9,8,30,0.064377682
Albany-Schenectady-Troy,1236,1833,51,33,34,118,0.064375341
Hartford & New Haven,6754,1569,41,33,27,101,0.064372212
Burlington-Plattsburgh,5149,2439,56,53,48,157,0.064370644
Philadelphia,8014,435,10,10,8,28,0.064367816
"Tri-Cities, TN-VA",24318,637,15,13,13,41,0.064364207
Albany-Schenectady-Troy,12529,2921,64,68,56,188,0.06436152
Orlando-Daytona Bch-Melbrn,32952,20603,499,446,381,1326,0.064359559
Billings,59070,1647,44,34,28,106,0.064359441
Flint-Saginaw-Bay City,48730,4708,101,105,97,303,0.064358539
New York,11509,2393,49,48,57,154,0.064354367
Tucson (Sierra Vista),85632,777,19,16,15,50,0.064350064
Green Bay-Appleton,54235,18446,464,365,358,1187,0.064349995
Dallas-Ft. Worth,75803,22426,529,498,416,1443,0.064344957
Portland-Auburn,3598,3668,81,79,76,236,0.06434024
Montgomery-Selma,36761,917,20,21,18,59,0.06434024
Portland-Auburn,4862,3917,99,73,80,252,0.06433495
Little Rock-Pine Bluff,72044,886,25,18,14,57,0.064334086
Philadelphia,18070,684,17,13,14,44,0.064327485
Omaha,51650,342,10,7,5,22,0.064327485
Minneapolis-St. Paul,56332,1368,42,25,21,88,0.064327485
San Francisco-Oak-San Jose,95468,1197,29,33,15,77,0.064327485
Burlington-Plattsburgh,5051,1135,28,27,18,73,0.064317181
Burlington-Plattsburgh,5487,1446,37,29,27,93,0.064315353
Rockford,61378,482,11,10,10,31,0.064315353
Burlington-Plattsburgh,3279,793,23,15,13,51,0.064312736
Minneapolis-St. Paul,56111,451,12,10,7,29,0.064301552
Fargo,58472,451,13,8,8,29,0.064301552
Spokane,99119,1353,39,25,23,87,0.064301552
Minneapolis-St. Paul,55983,1493,49,25,22,96,0.064300067
Buffalo,14777,420,8,12,7,27,0.064285714
Elmira (Corning),14815,980,25,18,20,63,0.064285714
Denver,80744,420,11,7,9,27,0.064285714
Roanoke-Lynchburg,24531,9054,223,183,176,582,0.064280981
Denver,81410,1898,57,36,29,122,0.064278188
Duluth-Superior,55797,1478,39,28,28,95,0.064276049
Youngstown,44452,2785,65,60,54,179,0.06427289
Albany-Schenectady-Troy,12843,529,16,8,10,34,0.064272212
Minneapolis-St. Paul,54728,6208,146,128,125,399,0.064271907
Abilene-Sweetwater,79512,7860,179,170,156,505,0.064249364
Traverse City-Cadillac,49690,6506,152,139,127,418,0.064248386
Minneapolis-St. Paul,55043,3440,85,76,60,221,0.064244186
Spokane,99101,1541,39,26,34,99,0.064243997
Norfolk-Portsmth-Newpt Nws,23881,2117,54,35,47,136,0.064241852
Sioux City,51033,467,13,9,8,30,0.064239829
Erie,16134,3425,77,74,69,220,0.064233577
Beaumont-Port Arthur,75979,10275,295,186,179,660,0.064233577
Toledo,43435,1479,39,33,23,95,0.06423259
Utica,13415,109,3,2,2,7,0.064220183
Salisbury,21862,109,3,2,2,7,0.064220183
Great Falls,59528,218,6,4,4,14,0.064220183
Topeka,66541,218,5,4,5,14,0.064220183
Omaha,68068,109,3,2,2,7,0.064220183
Oklahoma City,73757,109,3,2,2,7,0.064220183
Ft. Myers-Naples,33919,30567,585,724,654,1963,0.064219583
"Springfield, MO",72658,1604,43,31,29,103,0.064214464
"Columbus, OH",43746,1277,33,26,23,82,0.064212999
Paducah-Cape Girard-Harsbg,62988,1059,23,27,18,68,0.06421152
Richmond-Petersburg,23110,841,14,20,20,54,0.064209275
Lincoln & Hastings-Krny,68777,623,20,11,9,40,0.064205457
Honolulu,96704,11837,308,226,226,760,0.064205457
Boston (Manchester),2739,6744,165,158,110,433,0.064205219
"Charleston, SC",29580,1137,25,22,26,73,0.064204046
"Washington, DC (Hagrstwn)",20608,919,12,21,26,59,0.064200218
Knoxville,37878,592,15,11,12,38,0.064189189
New York,8559,4923,109,99,108,316,0.064188503
Knoxville,37772,14006,333,297,269,899,0.064186777
Burlington-Plattsburgh,5454,5344,155,115,73,343,0.064184132
Presque Isle,4781,483,10,10,11,31,0.064182195
Bangor,4915,9115,228,187,170,585,0.064179923
"Charleston, SC",29449,8461,214,176,153,543,0.064176811
Portland-Auburn,4071,5220,141,110,84,335,0.064176245
Peoria-Bloomington,60934,187,5,3,4,12,0.064171123
Green Bay-Appleton,54247,2026,52,37,41,130,0.064165844
Toledo,43501,826,19,15,19,53,0.064164649
Greenville-N.Bern-Washngtn,28445,12625,281,232,297,810,0.064158416
West Palm Beach-Ft. Pierce,34990,32047,870,687,499,2056,0.064155771
New York,12726,1060,25,16,27,68,0.064150943
Binghamton,13842,265,7,5,5,17,0.064150943
Sherman-Ada,74543,265,7,6,4,17,0.064150943
Wilkes Barre-Scranton-Hztn,17728,4817,115,99,95,309,0.06414781
Traverse City-Cadillac,49713,2167,47,42,50,139,0.064143978
Des Moines-Ames,50836,343,9,6,7,22,0.064139942
Sioux Falls(Mitchell),57045,1372,42,25,21,88,0.064139942
Peoria-Bloomington,61333,343,10,6,6,22,0.064139942
Greenwood-Greenville,38920,764,17,16,16,49,0.064136126
Cleveland-Akron (Canton),44086,2292,55,37,55,147,0.064136126
Utica,12116,1684,40,32,36,108,0.064133017
Green Bay-Appleton,54945,3524,97,58,71,226,0.064131669
Providence-New Bedford,2878,16014,364,339,324,1027,0.064131385
New York,7114,17511,337,370,416,1123,0.064131118
San Francisco-Oak-San Jose,94127,17886,418,369,360,1147,0.064128369
Medford-Klamath Falls,96032,2573,69,46,50,165,0.064127478
Mobile-Pensacola (Ft Walt),32561,9606,272,220,124,616,0.064126588
Albuquerque-Santa Fe,88435,3447,69,74,78,221,0.064113722
Sherman-Ada,76264,1669,39,41,27,107,0.064110246
Minneapolis-St. Paul,55345,21620,588,451,347,1386,0.064107308
"Tri-Cities, TN-VA",24239,78,2,2,1,5,0.064102564
Fargo,56553,234,8,4,3,15,0.064102564
Duluth-Superior,56660,234,8,4,3,15,0.064102564
Fargo,58443,312,8,5,7,20,0.064102564
Columbia-Jefferson City,65580,780,20,18,12,50,0.064102564
Lincoln & Hastings-Krny,68929,234,5,5,5,15,0.064102564
Cheyenne-Scottsbluff,82243,156,5,2,3,10,0.064102564
Portland-Auburn,4350,3713,91,61,86,238,0.064099111
Ft. Myers-Naples,33914,46227,1101,990,872,2963,0.06409674
Philadelphia,8402,5383,96,121,128,345,0.064090656
Sacramnto-Stkton-Modesto,95329,2715,75,53,46,174,0.064088398
Lansing,48822,2918,62,62,63,187,0.06408499
Denver,80121,18429,473,369,339,1181,0.064083781
Pittsburgh,15042,7787,171,158,170,499,0.064081161
Nashville,38564,593,15,14,9,38,0.064080944
Minneapolis-St. Paul,56050,1623,42,34,28,104,0.064078866
Flint-Saginaw-Bay City,48766,1030,18,24,24,66,0.06407767
Sioux Falls(Mitchell),56172,2778,72,54,52,178,0.064074874
Bismarck-Mnt-Dcknsn(Wlstn),58636,796,22,16,13,51,0.064070352
Oklahoma City,73759,1358,32,15,40,87,0.064064801
Sacramnto-Stkton-Modesto,95947,1358,24,36,27,87,0.064064801
Sioux Falls(Mitchell),57315,999,26,19,19,64,0.064064064
Burlington-Plattsburgh,5734,1280,28,26,28,82,0.0640625
Green Bay-Appleton,54139,3247,83,65,60,208,0.064059132
Boston (Manchester),3084,1405,31,29,30,90,0.06405694
Omaha,68407,843,22,19,13,54,0.06405694
Wichita-Hutchinson Plus,67422,1327,35,26,24,85,0.064054258
San Francisco-Oak-San Jose,94020,1733,25,39,47,111,0.064050779
Billings,59087,484,3,13,15,31,0.064049587
Buffalo,14710,3357,75,67,73,215,0.064045279
Johnstown-Altoona-St Colge,15856,890,20,10,27,57,0.064044944
Boston (Manchester),3858,4825,106,104,99,309,0.064041451
Fargo,58053,1218,37,21,20,78,0.064039409
"Springfield, MO",65570,406,11,8,7,26,0.064039409
Lincoln & Hastings-Krny,68834,203,6,4,3,13,0.064039409
South Bend-Elkhart,49130,1546,39,31,29,99,0.064036223
Missoula,59920,2077,58,40,35,133,0.064034665
Lincoln & Hastings-Krny,68961,734,21,9,17,47,0.064032698
Johnstown-Altoona-St Colge,16640,984,25,18,20,63,0.06402439
Little Rock-Pine Bluff,71969,328,9,7,5,21,0.06402439
Mankato,56010,1109,32,20,19,71,0.064021641
Montgomery-Selma,36029,906,20,22,16,58,0.06401766
Seattle-Tacoma,98624,1359,34,25,28,87,0.06401766
Norfolk-Portsmth-Newpt Nws,23839,828,30,13,10,53,0.064009662
Denver,80403,21591,558,460,364,1382,0.064008152
La Crosse-Eau Claire,54610,1578,37,34,30,101,0.06400507
Bangor,4492,125,3,3,2,8,0.064
Burlington-Plattsburgh,5902,125,3,3,2,8,0.064
"Rochester, NY",14462,625,18,11,11,40,0.064
Bluefield-Beckley-Oak Hill,24991,375,8,9,7,24,0.064
Des Moines-Ames,50074,375,11,8,5,24,0.064
Lincoln & Hastings-Krny,68444,125,3,2,3,8,0.064
San Antonio,78007,125,3,3,2,8,0.064
Albuquerque-Santa Fe,81335,125,3,2,3,8,0.064
Albuquerque-Santa Fe,88314,125,3,2,3,8,0.064
"Portland, OR",97758,125,4,2,2,8,0.064
Shreveport,71033,3516,80,73,72,225,0.063993174
Peoria-Bloomington,61535,1844,50,41,27,118,0.063991323
"Albany, GA",39826,547,9,9,17,35,0.063985375
Denver,80733,547,14,11,10,35,0.063985375
Utica,13438,3704,95,73,69,237,0.063984881
Roanoke-Lynchburg,24445,2235,44,47,52,143,0.063982103
Sioux City,51061,422,11,7,9,27,0.063981043
Milwaukee,53001,1688,40,32,36,108,0.063981043
Charlotte,28624,1313,33,26,25,84,0.063975628
Boston (Manchester),3216,2673,58,54,59,171,0.063973064
"Columbia, SC",29145,594,15,12,11,38,0.063973064
Binghamton,13833,3486,70,69,84,223,0.063970166
Albany-Schenectady-Troy,12192,1829,47,35,35,117,0.063969382
Orlando-Daytona Bch-Melbrn,32754,12664,318,248,244,810,0.063960834
La Crosse-Eau Claire,54627,1970,54,39,33,126,0.063959391
Los Angeles,93022,5191,130,101,101,332,0.063956848
Harrisonburg,24437,1032,25,23,18,66,0.063953488
Harrisonburg,26814,344,10,6,6,22,0.063953488
Traverse City-Cadillac,49701,1032,20,20,26,66,0.063953488
Marquette,49885,1767,54,33,26,113,0.063950198
Hartford & New Haven,6371,9961,276,203,158,637,0.063949403
Wilkes Barre-Scranton-Hztn,18453,1079,24,20,25,69,0.0639481
Albany-Schenectady-Troy,12423,1126,23,20,29,72,0.063943162
Charleston-Huntington,41650,563,13,10,13,36,0.063943162
Las Vegas,89005,15076,362,346,256,964,0.06394269
Harrisonburg,24439,1048,26,17,24,67,0.063931298
Atlanta,30555,2315,48,42,58,148,0.063930886
Peoria-Bloomington,61774,876,21,13,22,56,0.063926941
Wichita-Hutchinson Plus,67560,1533,32,28,38,98,0.063926941
Davenport-R.Island-Moline,61458,751,15,16,17,48,0.06391478
Pittsburgh,15076,1017,24,19,22,65,0.063913471
Wilkes Barre-Scranton-Hztn,17771,3051,76,63,56,195,0.063913471
Charleston-Huntington,25121,532,10,10,14,34,0.063909774
Great Falls,59530,266,7,5,5,17,0.063909774
Sioux City,68730,1909,56,28,38,122,0.063907805
Boston (Manchester),2536,20812,486,429,415,1330,0.063905439
Bangor,4685,313,6,7,7,20,0.063897764
Greenville-N.Bern-Washngtn,28528,626,14,14,12,40,0.063897764
Des Moines-Ames,50248,4476,119,81,86,286,0.063896336
Wichita Falls & Lawton,76483,1033,27,17,22,66,0.063891578
Charlotte,28626,2520,61,41,59,161,0.063888889
Omaha,68455,767,20,15,14,49,0.063885267
Lincoln & Hastings-Krny,68628,767,19,15,15,49,0.063885267
Spokane,99009,4242,118,80,73,271,0.06388496
Tampa-St. Pete (Sarasota),34241,16280,418,353,269,1040,0.063882064
Sioux City,50561,454,13,8,8,29,0.063876652
Johnstown-Altoona-St Colge,16639,1002,24,19,21,64,0.063872255
Fargo,56588,501,13,10,9,32,0.063872255
Flint-Saginaw-Bay City,48749,1096,25,25,20,70,0.063868613
Chico-Redding,95552,595,12,7,19,38,0.063865546
Denver,82701,5324,138,112,90,340,0.063861758
Madison,53529,2349,56,47,47,150,0.06385696
"Washington, DC (Hagrstwn)",20144,1065,25,23,20,68,0.063849765
Johnstown-Altoona-St Colge,15744,47,1,1,1,3,0.063829787
Johnstown-Altoona-St Colge,15760,94,2,2,2,6,0.063829787
Wilkes Barre-Scranton-Hztn,17876,1692,32,28,48,108,0.063829787
Chattanooga,37366,987,20,20,23,63,0.063829787
Cedar Rapids-Wtrlo-IWC&Dub,52550,470,14,5,11,30,0.063829787
Rapid City,57562,94,2,1,3,6,0.063829787
Fargo,58258,329,11,6,4,21,0.063829787
Fargo,58261,1034,32,18,16,66,0.063829787
Great Falls,59452,564,13,11,12,36,0.063829787
Quincy-Hannibal-Keokuk,62365,517,17,9,7,33,0.063829787
"Springfield, MO",65468,47,1,1,1,3,0.063829787
Wichita-Hutchinson Plus,67049,47,1,1,1,3,0.063829787
Sioux Falls(Mitchell),69166,564,18,10,8,36,0.063829787
Shreveport,75566,658,15,13,14,42,0.063829787
Corpus Christi,78008,235,6,4,5,15,0.063829787
Abilene-Sweetwater,79540,94,3,2,1,6,0.063829787
Colorado Springs-Pueblo,80809,2115,41,50,44,135,0.063829787
Albuquerque-Santa Fe,88324,188,6,2,4,12,0.063829787
Albuquerque-Santa Fe,88348,470,16,6,8,30,0.063829787
Albuquerque-Santa Fe,88439,47,1,1,1,3,0.063829787
San Francisco-Oak-San Jose,95493,282,7,4,7,18,0.063829787
Roanoke-Lynchburg,24330,3071,66,63,67,196,0.063822859
Bismarck-Mnt-Dcknsn(Wlstn),58730,1332,38,26,21,85,0.063813814
New York,7662,5673,117,116,129,362,0.063811035
Los Angeles,92625,11832,252,258,245,755,0.063810007
Augusta-Aiken,30631,1677,38,38,31,107,0.063804413
Baltimore,21087,5564,136,107,112,355,0.063803019
Champaign&Sprngfld-Decatur,62668,1348,29,29,28,86,0.06379822
Sioux Falls(Mitchell),57533,1834,42,35,40,117,0.063794984
Atlanta,30541,1646,41,35,29,105,0.063791009
Medford-Klamath Falls,97623,2571,74,47,43,164,0.063788409
Charlotte,29707,39976,1066,752,732,2550,0.063788273
Hartford & New Haven,6071,10285,257,214,185,656,0.063782207
Kansas City,66014,439,14,9,5,28,0.063781321
Burlington-Plattsburgh,12852,392,13,4,8,25,0.06377551
Cedar Rapids-Wtrlo-IWC&Dub,50136,392,10,9,6,25,0.06377551
Green Bay-Appleton,53949,6382,161,132,114,407,0.063773112
Boston (Manchester),3243,1082,28,19,22,69,0.063770795
Peoria-Bloomington,61565,1286,39,16,27,82,0.063763608
Seattle-Tacoma,98014,7716,221,161,110,492,0.063763608
Spokane,83856,7544,160,165,156,481,0.063759279
Bismarck-Mnt-Dcknsn(Wlstn),58649,298,6,6,7,19,0.063758389
Lincoln & Hastings-Krny,67621,298,6,7,6,19,0.063758389
Minneapolis-St. Paul,55007,2290,57,48,41,146,0.063755459
Raleigh-Durham (Fayetvlle),23968,847,18,17,19,54,0.063754427
Norfolk-Portsmth-Newpt Nws,27941,847,21,16,17,54,0.063754427
Sioux Falls(Mitchell),57430,2149,65,30,42,137,0.063750582
Green Bay-Appleton,54414,3153,73,58,70,201,0.063748811
Fresno-Visalia,93675,4204,98,78,92,268,0.063748811
"Springfield, MO",72644,2510,72,47,41,160,0.06374502
Lansing,49234,2463,61,54,42,157,0.063743402
Denver,80452,3922,81,90,79,250,0.063742988
Bismarck-Mnt-Dcknsn(Wlstn),58482,957,24,18,19,61,0.063740857
Chicago,60511,1616,43,30,30,103,0.063737624
Philadelphia,18920,455,12,11,6,29,0.063736264
Denver,81122,10026,284,207,148,639,0.063734291
Boise,83638,8206,213,172,138,523,0.063733853
Parkersburg,26346,659,15,13,14,42,0.063732929
Orlando-Daytona Bch-Melbrn,32950,4676,113,95,90,298,0.063729683
Denver,69347,1271,29,24,28,81,0.063729347
Greenvll-Spart-Ashevll-And,29356,9635,223,181,210,614,0.063725999
Sioux Falls(Mitchell),57359,612,16,12,11,39,0.06372549
Columbia-Jefferson City,64681,204,6,4,3,13,0.06372549
"Springfield, MO",65634,612,17,10,12,39,0.06372549
Topeka,66514,1428,38,29,24,91,0.06372549
Colorado Springs-Pueblo,81044,204,6,5,2,13,0.06372549
Davenport-R.Island-Moline,52638,518,12,11,10,33,0.063706564
"Portland, OR",98613,518,11,10,12,33,0.063706564
"Springfield, MO",65542,6593,173,135,112,420,0.063703928
Youngstown,44430,4678,112,95,91,298,0.063702437
Waco-Temple-Bryan,77879,5840,157,103,112,372,0.06369863
West Palm Beach-Ft. Pierce,34997,45214,1022,996,862,2880,0.063697085
New York,11375,73050,1339,1466,1848,4653,0.063696099
Greenvll-Spart-Ashevll-And,28733,157,4,3,3,10,0.063694268
Sioux Falls(Mitchell),57475,157,4,3,3,10,0.063694268
Lincoln & Hastings-Krny,69020,471,13,6,11,30,0.063694268
Paducah-Cape Girard-Harsbg,62816,1209,28,26,23,77,0.063688999
Bismarck-Mnt-Dcknsn(Wlstn),58741,581,17,11,9,37,0.063683305
Roanoke-Lynchburg,22938,1225,27,26,25,78,0.063673469
Spokane,83850,2293,50,46,50,146,0.063672045
Fargo,56546,267,7,7,3,17,0.063670412
Bismarck-Mnt-Dcknsn(Wlstn),58752,267,6,6,5,17,0.063670412
Greenville-N.Bern-Washngtn,27957,1178,29,26,20,75,0.063667233
Kansas City,66091,377,10,7,7,24,0.063660477
"Washington, DC (Hagrstwn)",22307,9755,202,221,198,621,0.063659662
Gainesville,32628,4744,104,109,89,302,0.063659359
Quincy-Hannibal-Keokuk,52625,2372,52,45,54,151,0.063659359
Bismarck-Mnt-Dcknsn(Wlstn),58623,2168,50,41,47,138,0.063653137
Rapid City,57559,597,12,9,17,38,0.063651591
Eureka,95548,1194,30,25,21,76,0.063651591
Pittsburgh,16143,2718,59,51,63,173,0.063649742
Lincoln & Hastings-Krny,69034,707,20,10,15,45,0.063649222
Fargo,58077,927,29,18,12,59,0.06364617
Bangor,4974,2624,56,64,47,167,0.063643293
New York,12783,1760,43,35,34,112,0.063636364
Elmira (Corning),14874,220,5,4,5,14,0.063636364
Roanoke-Lynchburg,24927,220,5,5,4,14,0.063636364
Lexington,40372,2310,59,39,49,147,0.063636364
Lexington,40763,330,6,10,5,21,0.063636364
Marquette,49881,330,8,7,6,21,0.063636364
Minneapolis-St. Paul,56236,330,8,7,6,21,0.063636364
Minneapolis-St. Paul,56342,2860,70,61,51,182,0.063636364
Wichita-Hutchinson Plus,67631,220,7,3,4,14,0.063636364
Wichita-Hutchinson Plus,67653,220,7,4,3,14,0.063636364
Grand Junction-Montrose,81506,12210,280,240,257,777,0.063636364
Chico-Redding,95595,110,2,1,4,7,0.063636364
San Francisco-Oak-San Jose,94005,4966,109,101,106,316,0.063632702
"Washington, DC (Hagrstwn)",26812,1776,49,37,27,113,0.063626126
Albuquerque-Santa Fe,87506,15937,353,317,344,1014,0.063625526
Tucson (Sierra Vista),85750,25132,526,564,509,1599,0.063624065
Burlington-Plattsburgh,12979,2169,48,44,46,138,0.06362379
Sioux City,50565,393,11,7,7,25,0.063613232
La Crosse-Eau Claire,55931,393,14,5,6,25,0.063613232
Flint-Saginaw-Bay City,48659,2704,71,53,48,172,0.063609467
Flint-Saginaw-Bay City,48765,676,12,19,12,43,0.063609467
Pittsburgh,15470,959,20,19,22,61,0.063607925
Mankato,56121,566,15,12,9,36,0.06360424
Portland-Auburn,4351,2437,65,41,49,155,0.06360279
Minneapolis-St. Paul,56052,739,20,15,12,47,0.063599459
Louisville,47135,1368,35,25,27,87,0.063596491
Great Falls,59414,1085,24,20,25,69,0.06359447
Wilkes Barre-Scranton-Hztn,17941,802,19,14,18,51,0.063591022
Burlington-Plattsburgh,5065,1211,31,28,18,77,0.063583815
Harrisonburg,24432,346,8,6,8,22,0.063583815
Bismarck-Mnt-Dcknsn(Wlstn),58789,346,10,6,6,22,0.063583815
Bismarck-Mnt-Dcknsn(Wlstn),59247,346,7,6,9,22,0.063583815
Syracuse,14521,3932,92,77,81,250,0.063580875
Bangor,4664,1274,28,26,27,81,0.063579278
Wilkes Barre-Scranton-Hztn,18660,3649,89,71,72,232,0.063579063
Rockford,61039,755,17,15,16,48,0.063576159
Lincoln & Hastings-Krny,68735,755,21,14,13,48,0.063576159
Little Rock-Pine Bluff,72142,2328,53,47,48,148,0.063573883
New Orleans,39525,9721,251,201,166,618,0.063573706
Burlington-Plattsburgh,3240,1400,41,28,20,89,0.063571429
Alpena,49747,1400,31,28,30,89,0.063571429
Des Moines-Ames,50242,409,13,6,7,26,0.063569682
Augusta-Aiken,29821,1290,28,32,22,82,0.063565891
Bismarck-Mnt-Dcknsn(Wlstn),58577,1825,64,31,21,116,0.063561644
Hartford & New Haven,6262,236,6,5,4,15,0.063559322
Pittsburgh,16063,8732,165,187,203,555,0.063559322
Wilkes Barre-Scranton-Hztn,17985,1180,30,22,23,75,0.063559322
Wilkes Barre-Scranton-Hztn,18661,5318,121,99,118,338,0.063557728
"Springfield, MO",65787,1668,34,34,38,106,0.063549161
Davenport-R.Island-Moline,61001,1133,33,20,19,72,0.063548102
Great Falls,59540,299,8,6,5,19,0.063545151
Spokane,83845,1794,53,35,26,114,0.063545151
Rochestr-Mason City-Austin,55939,2046,53,35,42,130,0.063538612
Omaha,68304,362,10,8,5,23,0.063535912
Mobile-Pensacola (Ft Walt),36555,787,19,16,15,50,0.063532402
Des Moines-Ames,50147,425,13,7,7,27,0.063529412
Wichita-Hutchinson Plus,67648,425,15,7,5,27,0.063529412
Denver,80863,12924,326,265,230,821,0.063525224
"Springfield, MO",65680,1464,30,36,27,93,0.06352459
Evansville,47551,551,16,10,9,35,0.063520871
Sacramnto-Stkton-Modesto,95310,1842,41,39,37,117,0.063517915
Waco-Temple-Bryan,77871,3795,91,82,68,241,0.063504611
Boston (Manchester),1523,8362,208,188,135,531,0.063501555
Davenport-R.Island-Moline,61028,1685,45,35,27,107,0.063501484
Paducah-Cape Girard-Harsbg,62938,2567,70,49,44,163,0.063498247
New York,12729,1701,37,36,35,108,0.063492063
Burlington-Plattsburgh,12961,63,2,1,1,4,0.063492063
Baltimore,21667,252,7,5,4,16,0.063492063
Rochestr-Mason City-Austin,50447,1071,27,21,20,68,0.063492063
Green Bay-Appleton,54940,4284,112,85,75,272,0.063492063
Rapid City,57640,63,2,1,1,4,0.063492063
"Springfield, MO",65657,189,5,4,3,12,0.063492063
Wichita-Hutchinson Plus,67643,189,6,3,3,12,0.063492063
Omaha,68040,378,12,8,4,24,0.063492063
"Springfield, MO",72666,378,9,8,7,24,0.063492063
Albuquerque-Santa Fe,87715,693,21,10,13,44,0.063492063
Albany-Schenectady-Troy,12196,2914,80,50,55,185,0.063486616
"Columbia, SC",29128,5072,115,108,99,322,0.063485804
Portland-Auburn,4086,10051,228,206,204,638,0.063476271
Wilkes Barre-Scranton-Hztn,18436,13391,323,290,237,850,0.063475469
Burlington-Plattsburgh,5860,2568,64,55,44,163,0.06347352
Dayton,45337,1938,55,38,30,123,0.063467492
Chicago,60470,646,14,13,14,41,0.063467492
Lincoln & Hastings-Krny,69140,1623,50,27,26,103,0.063462723
Wausau-Rhinelander,54515,520,15,12,6,33,0.063461538
Phoenix (Prescott),86440,7974,186,149,171,506,0.063456233
Hartford & New Haven,6475,10464,244,226,194,664,0.063455657
Topeka,66432,394,11,8,6,25,0.063451777
Omaha,68031,1576,36,29,35,100,0.063451777
Green Bay-Appleton,54174,2916,81,58,46,185,0.063443073
New York,18458,3058,77,64,53,194,0.063440157
Corpus Christi,78401,4587,68,106,117,291,0.063440157
Utica,13468,268,4,6,7,17,0.063432836
Cedar Rapids-Wtrlo-IWC&Dub,52251,268,9,5,3,17,0.063432836
Great Falls,59456,268,5,5,7,17,0.063432836
Peoria-Bloomington,61311,268,9,4,4,17,0.063432836
Davenport-R.Island-Moline,61425,268,5,6,6,17,0.063432836
"Springfield, MO",72512,2617,67,53,46,166,0.06343141
Pittsburgh,16141,1545,28,36,34,98,0.063430421
St. Louis,62355,678,16,14,13,43,0.063421829
Albany-Schenectady-Troy,12074,3327,86,67,58,211,0.063420499
Kansas City,66056,1766,46,34,32,112,0.063420159
Wausau-Rhinelander,54566,1435,30,26,35,91,0.063414634
Fargo,58021,410,12,11,3,26,0.063414634
Bismarck-Mnt-Dcknsn(Wlstn),58626,410,11,8,7,26,0.063414634
Billings,59010,205,5,4,4,13,0.063414634
Missoula,59915,410,10,7,9,26,0.063414634
Omaha,68443,1230,32,20,26,78,0.063414634
"Portland, OR",98603,1025,30,19,16,65,0.063414634
New York,11952,4731,101,100,99,300,0.063411541
Little Rock-Pine Bluff,72122,1309,33,26,24,83,0.063407181
Portland-Auburn,3830,1861,43,35,40,118,0.063406771
Hartford & New Haven,6412,3722,75,77,84,236,0.063406771
Des Moines-Ames,50005,694,14,13,17,44,0.063400576
Minneapolis-St. Paul,56641,347,10,7,5,22,0.063400576
Burlington-Plattsburgh,5143,4748,111,109,81,301,0.063395114
Shreveport,71752,915,21,22,15,58,0.063387978
New York,7632,5143,129,108,89,326,0.063387128
Boise,83629,1909,45,36,40,121,0.063383971
New York,18428,12448,255,253,281,789,0.063383676
Utica,13342,142,3,3,3,9,0.063380282
Knoxville,40843,142,4,3,2,9,0.063380282
Des Moines-Ames,50141,426,11,7,9,27,0.063380282
Paducah-Cape Girard-Harsbg,63951,284,5,7,6,18,0.063380282
"Springfield, MO",65603,142,5,2,2,9,0.063380282
Omaha,68344,426,11,8,8,27,0.063380282
"Springfield, MO",72682,284,8,5,5,18,0.063380282
Pittsburgh,16233,1215,28,24,25,77,0.063374486
San Francisco-Oak-San Jose,94598,26463,653,540,484,1677,0.0633715
Roanoke-Lynchburg,24460,1436,37,25,29,91,0.063370474
Little Rock-Pine Bluff,72060,647,13,13,15,41,0.063369397
Fargo,58275,726,19,14,13,46,0.063360882
Miami-Ft. Lauderdale,33140,19147,422,387,404,1213,0.063351961
Quincy-Hannibal-Keokuk,62323,221,3,5,6,14,0.063348416
Amarillo,79011,221,6,4,4,14,0.063348416
Atlanta,30568,2068,50,35,46,131,0.063346228
Presque Isle,4750,1784,43,33,37,113,0.063340807
Spokane,83545,521,14,10,9,33,0.063339731
Eugene,97458,4626,99,85,109,293,0.063337657
Providence-New Bedford,2837,3663,88,85,59,232,0.063336063
"Columbus, GA (Opelika, AL)",36855,1421,27,27,36,90,0.063335679
New York,11971,6016,115,122,144,381,0.063331117
Tyler-Longview(Lfkn&Ncgd),75783,8227,194,151,176,521,0.063328066
Johnstown-Altoona-St Colge,16823,29229,539,579,733,1851,0.063327517
Hartford & New Haven,6755,1137,25,23,24,72,0.063324538
"Washington, DC (Hagrstwn)",22810,758,21,13,14,48,0.063324538
Minneapolis-St. Paul,56474,4785,130,88,85,303,0.063322884
Grand Rapids-Kalmzoo-B.Crk,48846,22126,496,456,449,1401,0.063319172
Hartford & New Haven,6750,1406,28,25,36,89,0.063300142
Sioux City,51347,1564,41,29,29,99,0.063299233
Utica,12197,2133,47,40,48,135,0.063291139
"Washington, DC (Hagrstwn)",21778,1264,29,22,29,80,0.063291139
Fargo,58466,395,12,6,7,25,0.063291139
St. Louis,62079,158,4,3,3,10,0.063291139
Wichita-Hutchinson Plus,67021,79,2,2,1,5,0.063291139
Denver,80745,79,2,1,2,5,0.063291139
"Portland, OR",97874,316,10,5,5,20,0.063291139
New York,18426,4014,101,79,74,254,0.063278525
Richmond-Petersburg,23175,1928,44,42,36,122,0.063278008
Greensboro-H.Point-W.Salem,28663,727,15,16,15,46,0.063273728
Syracuse,13034,1944,51,38,34,123,0.063271605
Clarksburg-Weston,26342,490,13,11,7,31,0.063265306
Columbia-Jefferson City,65250,490,14,7,10,31,0.063265306
Greenvll-Spart-Ashevll-And,28763,2861,71,55,55,181,0.063264593
Utica,13861,411,14,6,6,26,0.063260341
Greenvll-Spart-Ashevll-And,28167,2466,58,60,38,156,0.063260341
Nashville,38311,822,23,15,14,52,0.063260341
Minneapolis-St. Paul,56212,411,13,5,8,26,0.063260341
Topeka,66834,822,21,15,16,52,0.063260341
Los Angeles,90077,9027,209,190,172,571,0.06325468
Albany-Schenectady-Troy,12130,664,16,14,12,42,0.063253012
Johnstown-Altoona-St Colge,16685,253,6,4,6,16,0.063241107
La Crosse-Eau Claire,54657,253,6,4,6,16,0.063241107
Bismarck-Mnt-Dcknsn(Wlstn),58561,1012,31,13,20,64,0.063241107
"Washington, DC (Hagrstwn)",21711,1028,31,21,13,65,0.063229572
Cleveland-Akron (Canton),44028,9853,229,207,187,623,0.063229473
West Palm Beach-Ft. Pierce,34945,6437,155,146,106,407,0.063228212
Spokane,59930,1202,41,24,11,76,0.063227953
Milwaukee,53020,3290,80,70,58,208,0.063221884
Wichita-Hutchinson Plus,67632,174,5,2,4,11,0.063218391
"Portland, OR",98616,174,5,3,3,11,0.063218391
Evansville,47525,443,13,8,7,28,0.063205418
St. Louis,62091,443,15,7,6,28,0.063205418
Erie,16316,5095,114,109,99,322,0.063199215
Great Falls,59421,2152,48,46,42,136,0.063197026
Evansville,62809,269,6,6,5,17,0.063197026
Knoxville,38549,3592,84,69,74,227,0.063195991
Denver,81419,3956,92,77,81,250,0.063195147
Minneapolis-St. Paul,55945,1361,36,27,23,86,0.063188832
Bangor,4417,364,7,11,5,23,0.063186813
St. Louis,62685,1820,48,38,29,115,0.063186813
Cedar Rapids-Wtrlo-IWC&Dub,52052,3039,87,55,50,192,0.063178677
Topeka,66868,649,17,11,13,41,0.063174114
Augusta-Aiken,29824,7900,187,170,142,499,0.063164557
Portland-Auburn,3909,11779,260,253,231,744,0.063163257
Baltimore,21131,8629,263,169,113,545,0.063159115
Albany-Schenectady-Troy,12153,950,21,22,17,60,0.063157895
Burlington-Plattsburgh,12945,475,10,9,11,30,0.063157895
Phoenix (Prescott),86038,95,2,2,2,6,0.063157895
Amarillo,88410,95,2,2,2,6,0.063157895
San Francisco-Oak-San Jose,95427,570,13,10,13,36,0.063157895
"Portland, OR",97848,190,4,4,4,12,0.063157895
Spokane,99171,950,21,19,20,60,0.063157895
"Springfield, MO",65737,8630,214,170,161,545,0.063151796
Portland-Auburn,4263,2217,60,40,40,140,0.063148399
Pittsburgh,16362,966,23,19,19,61,0.063146998
Omaha,50843,586,14,8,15,37,0.063139932
Minneapolis-St. Paul,54723,1172,28,23,23,74,0.063139932
Marquette,49892,2170,62,40,35,137,0.063133641
"Washington, DC (Hagrstwn)",20680,396,9,9,7,25,0.063131313
Juneau,99827,2091,52,39,41,132,0.06312769
Jacksonville,32189,6036,135,124,122,381,0.063121272
Bluefield-Beckley-Oak Hill,24938,1410,33,28,28,89,0.063120567
Richmond-Petersburg,23103,6021,130,98,152,380,0.06311244
Spokane,98844,4516,110,98,77,285,0.063108946
Great Falls,59482,412,11,10,5,26,0.063106796
Champaign&Sprngfld-Decatur,61940,206,5,4,4,13,0.063106796
Bismarck-Mnt-Dcknsn(Wlstn),58653,523,16,5,12,33,0.063097514
Detroit,48465,634,17,12,11,40,0.063091483
San Francisco-Oak-San Jose,95585,634,16,10,14,40,0.063091483
Sioux City,57001,1712,44,33,31,108,0.063084112
Little Rock-Pine Bluff,72536,428,13,6,8,27,0.063084112
Springfield-Holyoke,1072,1395,36,26,26,88,0.063082437
Portland-Auburn,4110,1776,49,36,27,112,0.063063063
Charleston-Huntington,26636,111,3,2,2,7,0.063063063
Rochestr-Mason City-Austin,50467,111,3,2,2,7,0.063063063
Omaha,68042,111,3,2,2,7,0.063063063
Lincoln & Hastings-Krny,68440,111,3,2,2,7,0.063063063
Sherman-Ada,74549,111,3,2,2,7,0.063063063
Panama City,32321,5677,132,121,105,358,0.063061476
Cleveland-Akron (Canton),44065,4139,86,78,97,261,0.06305871
Portland-Auburn,4051,1126,31,25,15,71,0.063055062
Bismarck-Mnt-Dcknsn(Wlstn),57638,1697,37,29,41,107,0.063052445
Utica,13470,682,17,12,14,43,0.063049853
Spokane,99141,6281,163,121,112,396,0.063047285
Boston (Manchester),3221,2538,66,54,40,160,0.063041765
Minneapolis-St. Paul,56091,349,11,6,5,22,0.063037249
Cleveland-Akron (Canton),44253,3268,84,63,59,206,0.063035496
Albany-Schenectady-Troy,12120,587,12,13,12,37,0.063032368
Minneapolis-St. Paul,55073,3522,92,74,56,222,0.063032368
Denver,80535,2475,57,43,56,156,0.063030303
Albuquerque-Santa Fe,87931,825,23,12,17,52,0.063030303
Wichita-Hutchinson Plus,67649,238,8,4,3,15,0.06302521
Oklahoma City,73021,238,7,5,3,15,0.06302521
Fresno-Visalia,93645,238,6,5,4,15,0.06302521
Austin,78676,15121,425,292,236,953,0.063024932
Minneapolis-St. Paul,54810,2634,69,43,54,166,0.06302202
Eugene,97324,1079,29,22,17,68,0.063021316
Albany-Schenectady-Troy,12023,1920,48,38,35,121,0.063020833
Missoula,59870,12409,302,269,211,782,0.063018777
Des Moines-Ames,50123,730,22,13,11,46,0.063013699
Rochestr-Mason City-Austin,50484,365,9,6,8,23,0.063013699
La Crosse-Eau Claire,54819,2317,62,43,41,146,0.063012516
Clarksburg-Weston,26293,492,9,11,11,31,0.06300813
Nashville,38573,2238,50,44,47,141,0.063002681
Sioux Falls(Mitchell),57477,127,3,2,3,8,0.062992126
Rapid City,57755,127,3,2,3,8,0.062992126
Erie,16340,1937,45,38,39,122,0.062983996
Reno,89410,11306,283,251,178,712,0.062975411
Roanoke-Lynchburg,23967,794,15,21,14,50,0.062972292
Bluefield-Beckley-Oak Hill,24935,397,8,9,8,25,0.062972292
Butte-Bozeman,59739,397,11,8,6,25,0.062972292
Tampa-St. Pete (Sarasota),33774,18535,443,374,350,1167,0.062961964
Cedar Rapids-Wtrlo-IWC&Dub,52222,683,16,14,13,43,0.06295754
Youngstown,44403,3606,75,69,83,227,0.062950638
New York,11954,4274,96,89,84,269,0.062938699
Charlotte,28679,1859,48,33,36,117,0.062937063
Ottumwa-Kirksville,52566,143,4,3,2,9,0.062937063
Lincoln & Hastings-Krny,68942,429,9,6,12,27,0.062937063
Albuquerque-Santa Fe,87539,143,4,3,2,9,0.062937063
Sherman-Ada,75076,8739,212,178,160,550,0.062936263
Johnstown-Altoona-St Colge,15563,2765,61,60,53,174,0.062929476
"Tri-Cities, TN-VA",24279,4513,111,84,89,284,0.062929315
Minneapolis-St. Paul,54872,2781,72,57,46,175,0.062927005
New York,7092,7057,185,160,99,444,0.062916253
Wilkes Barre-Scranton-Hztn,18441,302,7,6,6,19,0.062913907
"Portland, OR",97873,302,5,6,8,19,0.062913907
New York,7024,40295,819,852,864,2535,0.062911031
Sioux City,50510,1065,28,17,22,67,0.062910798
Fargo,56536,461,12,11,6,29,0.062906725
Davenport-R.Island-Moline,61413,922,23,15,20,58,0.062906725
Burlington-Plattsburgh,12935,1558,41,31,26,98,0.062901155
Bangor,4733,159,3,4,3,10,0.062893082
Sioux Falls(Mitchell),57541,159,4,3,3,10,0.062893082
Eureka,95587,477,13,7,10,30,0.062893082
Spokane,99135,318,9,7,4,20,0.062893082
Boston (Manchester),3842,16775,346,347,362,1055,0.062891207
St. Louis,63621,1288,32,24,25,81,0.062888199
Greenvll-Spart-Ashevll-And,29686,1145,30,25,17,72,0.062882096
Knoxville,38572,13279,310,252,273,835,0.062881241
Chicago,60154,15651,361,307,316,984,0.062871382
Pittsburgh,16053,4549,94,93,99,286,0.062870961
Syracuse,13132,3881,86,73,85,244,0.062870394
Albany-Schenectady-Troy,12186,6617,164,134,118,416,0.062868369
Gainesville,32680,10770,246,239,192,677,0.062859796
Augusta-Aiken,29840,175,5,3,3,11,0.062857143
Charleston-Huntington,41667,350,7,6,9,22,0.062857143
Sioux Falls(Mitchell),57057,175,5,3,3,11,0.062857143
Abilene-Sweetwater,79534,175,4,3,4,11,0.062857143
Albany-Schenectady-Troy,12121,1766,40,37,34,111,0.062853907
Las Vegas,89046,541,11,13,10,34,0.06284658
New York,12481,1289,31,24,26,81,0.06283941
Madison,53526,557,16,12,7,35,0.062836625
Tampa-St. Pete (Sarasota),33703,24524,498,505,538,1541,0.062836405
Madison,53517,1878,53,35,30,118,0.062832801
Buffalo,14481,2451,56,49,49,154,0.062831497
"Washington, DC (Hagrstwn)",20626,382,6,7,11,24,0.062827225
Rapid City,57745,2292,60,51,33,144,0.062827225
Lincoln & Hastings-Krny,69040,573,13,8,15,36,0.062827225
Sioux Falls(Mitchell),57362,1926,50,31,40,121,0.062824507
Cedar Rapids-Wtrlo-IWC&Dub,52203,1735,42,30,37,109,0.062824207
Hartford & New Haven,6757,2197,50,43,45,138,0.062812927
Little Rock-Pine Bluff,71763,1210,35,24,17,76,0.062809917
Denver,81630,1019,27,21,16,64,0.062806673
Wichita-Hutchinson Plus,67584,207,6,2,5,13,0.062801932
Albany-Schenectady-Troy,12086,1481,28,31,34,93,0.062795409
Johnstown-Altoona-St Colge,16621,637,17,10,13,40,0.062794349
Palm Springs,92260,31532,630,694,656,1980,0.062793353
Chico-Redding,96033,430,11,8,8,27,0.062790698
Sacramnto-Stkton-Modesto,95685,4953,103,107,101,311,0.062790228
Wichita-Hutchinson Plus,67756,1943,37,31,54,122,0.062789501
Oklahoma City,74641,653,16,13,12,41,0.062787136
Denver,80439,24720,709,523,320,1552,0.062783172
Quincy-Hannibal-Keokuk,52639,1768,34,36,41,111,0.062782805
Omaha,51556,446,12,9,7,28,0.062780269
Oklahoma City,74646,223,6,4,4,14,0.062780269
Eureka,95560,1561,28,33,37,98,0.062780269
"Portland, OR",97721,223,6,4,4,14,0.062780269
Binghamton,13739,908,24,17,16,57,0.06277533
South Bend-Elkhart,46374,924,19,16,23,58,0.062770563
Columbia-Jefferson City,64660,462,14,8,7,29,0.062770563
Syracuse,13118,5831,147,113,106,366,0.062767964
Marquette,49854,6309,150,135,111,396,0.062767475
Cleveland-Akron (Canton),44072,4764,115,105,79,299,0.062762385
Fargo,56735,717,19,9,17,45,0.062761506
Minneapolis-St. Paul,56289,749,20,15,12,47,0.062750334
"Rochester, NY",14585,255,6,5,5,16,0.062745098
Chicago,60523,10503,256,218,185,659,0.062743978
Atlanta,30642,16131,383,357,272,1012,0.062736346
Little Rock-Pine Bluff,71644,542,13,10,11,34,0.062730627
Oklahoma City,73041,271,7,5,5,17,0.062730627
San Francisco-Oak-San Jose,95412,271,4,6,7,17,0.062730627
Tampa-St. Pete (Sarasota),33572,28537,731,515,544,1790,0.062725584
Omaha,50076,1387,30,23,34,87,0.062725306
Boston (Manchester),2568,14078,312,271,300,883,0.062721978
La Crosse-Eau Claire,55969,1132,31,20,20,71,0.062720848
Rochestr-Mason City-Austin,55956,2009,56,40,30,126,0.06271777
Bismarck-Mnt-Dcknsn(Wlstn),58639,1770,36,35,40,111,0.062711864
Eugene,97416,941,22,19,18,59,0.062699256
Portland-Auburn,3845,957,18,21,21,60,0.062695925
St. Louis,62538,319,8,7,5,20,0.062695925
Topeka,66403,670,15,14,13,42,0.062686567
Duluth-Superior,54828,702,22,11,11,44,0.062678063
Eugene,97481,702,16,15,13,44,0.062678063
Austin,78669,13769,384,277,202,863,0.062677028
Albany-Schenectady-Troy,12817,2170,46,45,45,136,0.062672811
Topeka,66408,367,11,6,6,23,0.0626703
Albuquerque-Santa Fe,87581,367,11,7,5,23,0.0626703
Providence-New Bedford,2725,2617,60,48,56,164,0.062667176
Omaha,51639,750,19,16,12,47,0.062666667
Marquette,49805,383,8,7,9,24,0.062663185
Albuquerque-Santa Fe,87752,383,7,6,11,24,0.062663185
Burlington-Plattsburgh,3753,3479,76,80,62,218,0.062661684
Boston (Manchester),2649,15720,351,326,308,985,0.062659033
Minneapolis-St. Paul,55385,1181,31,23,20,74,0.062658764
Bismarck-Mnt-Dcknsn(Wlstn),58773,798,19,18,13,50,0.062656642
Wichita Falls & Lawton,76460,399,11,5,9,25,0.062656642
Waco-Temple-Bryan,75833,3304,84,68,55,207,0.062651332
Albany-Schenectady-Troy,12523,2075,50,38,42,130,0.062650602
Missoula,59925,1676,43,31,31,105,0.062649165
Victoria,77974,431,12,7,8,27,0.062645012
Topeka,66423,878,20,13,22,55,0.062642369
Sioux City,51333,447,13,6,9,28,0.062639821
"Portland, OR",97037,1341,34,25,25,84,0.062639821
Eugene,97451,447,13,7,8,28,0.062639821
Bismarck-Mnt-Dcknsn(Wlstn),58579,1357,38,21,26,85,0.062638172
Omaha,51632,6849,160,132,137,429,0.062636881
Missoula,59910,463,11,8,10,29,0.062634989
Joplin-Pittsburg,66010,479,12,11,7,30,0.06263048
Portland-Auburn,4076,3082,73,64,56,193,0.062621674
Madison,53506,1038,22,21,22,65,0.062620424
San Francisco-Oak-San Jose,94028,6803,204,144,78,426,0.062619433
Hartford & New Haven,6438,2635,70,54,41,165,0.062618596
Omaha,68413,527,13,10,10,33,0.062618596
Tulsa,74860,1613,36,32,33,101,0.062616243
Milwaukee,53178,2763,69,53,51,173,0.062613102
Harrisburg-Lncstr-Leb-York,17353,2811,72,53,51,176,0.06261117
Topeka,66945,1134,29,13,29,71,0.062610229
Phoenix (Prescott),85120,32282,650,677,694,2021,0.062604547
Des Moines-Ames,52549,607,17,12,9,38,0.062602965
Philadelphia,18343,4313,100,89,81,270,0.062601438
Albany-Schenectady-Troy,12046,623,15,9,15,39,0.062600321
Paducah-Cape Girard-Harsbg,62977,687,13,16,14,43,0.062590975
Eugene,97447,687,19,14,10,43,0.062590975
Sioux Falls(Mitchell),57383,703,22,14,8,44,0.062588905
Palm Springs,92241,9187,208,209,158,575,0.06258844
Macon,31087,8580,182,184,171,537,0.062587413
"Washington, DC (Hagrstwn)",21713,12160,274,251,236,761,0.062582237
Seattle-Tacoma,98336,783,17,15,17,49,0.062579821
Houston,77983,1582,34,32,33,99,0.062579014
Phoenix (Prescott),85602,10931,285,190,209,684,0.06257433
Albuquerque-Santa Fe,87714,895,23,19,14,56,0.062569832
Sioux Falls(Mitchell),57332,943,26,19,14,59,0.062566278
Bangor,4911,1950,39,44,39,122,0.062564103
Jacksonville,32193,1023,19,23,22,64,0.062561095
"Columbia, SC",29148,5883,112,111,145,368,0.062553119
Baton Rouge,39669,4924,103,110,95,308,0.062550772
"Rochester, NY",14466,1439,29,27,34,90,0.062543433
Indianapolis,46186,1743,43,36,30,109,0.062535858
Portland-Auburn,3886,1855,45,34,37,116,0.062533693
Buffalo,14171,1935,45,33,43,121,0.0625323
Dallas-Ft. Worth,76671,2047,52,41,35,128,0.062530532
Bangor,4673,160,5,3,2,10,0.0625
Presque Isle,4764,32,1,1,0,2,0.0625
Burlington-Plattsburgh,5873,688,18,12,13,43,0.0625
Utica,13776,416,10,9,7,26,0.0625
Johnstown-Altoona-St Colge,15730,80,2,1,2,5,0.0625
Wilkes Barre-Scranton-Hztn,17953,416,9,8,9,26,0.0625
"Washington, DC (Hagrstwn)",20687,560,12,11,12,35,0.0625
Roanoke-Lynchburg,22964,48,1,1,1,3,0.0625
Roanoke-Lynchburg,24363,1296,28,28,25,81,0.0625
Charleston-Huntington,25305,48,0,2,1,3,0.0625
Greenville-N.Bern-Washngtn,28537,64,2,1,1,4,0.0625
Greenwood-Greenville,38944,272,8,4,5,17,0.0625
"Lafayette, IN",47942,672,13,15,14,42,0.0625
Flint-Saginaw-Bay City,48624,16032,391,312,299,1002,0.0625
Des Moines-Ames,50120,320,8,5,7,20,0.0625
Cedar Rapids-Wtrlo-IWC&Dub,50672,544,15,6,13,34,0.0625
Sioux City,51558,512,14,8,10,32,0.0625
Cedar Rapids-Wtrlo-IWC&Dub,52151,2064,48,36,45,129,0.0625
Milwaukee,53108,3248,71,60,72,203,0.0625
Minneapolis-St. Paul,56025,464,15,8,6,29,0.0625
Duluth-Superior,56669,368,11,6,6,23,0.0625
Sioux Falls(Mitchell),57428,656,17,14,10,41,0.0625
Fargo,58445,144,4,2,3,9,0.0625
Bismarck-Mnt-Dcknsn(Wlstn),58638,1072,25,13,29,67,0.0625
Billings,59038,656,13,11,17,41,0.0625
Rapid City,59319,48,1,1,1,3,0.0625
Billings,59345,80,2,2,1,5,0.0625
Butte-Bozeman,59733,144,4,2,3,9,0.0625
Champaign&Sprngfld-Decatur,60928,800,19,18,13,50,0.0625
St. Louis,63636,496,14,10,7,31,0.0625
Paducah-Cape Girard-Harsbg,63934,96,3,2,1,6,0.0625
Wichita-Hutchinson Plus,67444,544,14,9,11,34,0.0625
Wichita-Hutchinson Plus,67675,160,5,1,4,10,0.0625
Lincoln & Hastings-Krny,68445,112,3,2,2,7,0.0625
Little Rock-Pine Bluff,72546,96,2,2,2,6,0.0625
Austin,78948,896,20,18,18,56,0.0625
Amarillo,79259,48,1,1,1,3,0.0625
Amarillo,88125,16,0,0,1,1,0.0625
San Diego,92066,368,6,8,9,23,0.0625
Greensboro-H.Point-W.Salem,24120,1761,46,35,29,110,0.062464509
San Francisco-Oak-San Jose,94563,19500,596,379,243,1218,0.062461538
Champaign&Sprngfld-Decatur,60924,1585,36,26,37,99,0.062460568
Portland-Auburn,4955,1473,41,30,21,92,0.06245757
Watertown,13343,1377,31,23,32,86,0.062454611
Minneapolis-St. Paul,56115,1377,35,22,29,86,0.062454611
West Palm Beach-Ft. Pierce,33478,14875,412,307,210,929,0.062453782
"Portland, OR",98605,1297,34,25,22,81,0.062451812
Baltimore,20779,1281,34,27,19,80,0.06245121
Sioux City,68629,1233,28,20,29,77,0.062449311
Houston,75926,1105,23,24,22,69,0.062443439
Dallas-Ft. Worth,75418,15167,313,325,309,947,0.062438188
Tallahassee-Thomasville,31629,1009,25,19,19,63,0.062438057
Traverse City-Cadillac,49676,3572,88,65,70,223,0.062430011
Des Moines-Ames,50590,881,23,15,17,55,0.062429058
San Francisco-Oak-San Jose,95469,1762,51,36,23,110,0.062429058
Colorado Springs-Pueblo,81073,1714,42,37,28,107,0.062427071
Burlington-Plattsburgh,5091,3236,80,60,62,202,0.062422744
Albany-Schenectady-Troy,5251,1618,42,34,25,101,0.062422744
Presque Isle,4773,801,18,15,17,50,0.062421973
"Columbus, GA (Opelika, AL)",31823,737,15,17,14,46,0.062415197
Burlington-Plattsburgh,12981,2051,49,42,37,128,0.062408581
Champaign&Sprngfld-Decatur,61919,673,15,14,13,42,0.062407132
Miami-Ft. Lauderdale,33316,13172,186,268,368,822,0.062405102
San Angelo,76859,1859,45,31,40,116,0.062399139
"Tri-Cities, TN-VA",37683,12709,315,242,236,793,0.062396727
Pittsburgh,15501,16107,334,353,318,1005,0.062395232
"Springfield, MO",65629,577,17,11,8,36,0.062391681
Lincoln & Hastings-Krny,68939,1154,27,23,22,72,0.062391681
Green Bay-Appleton,49821,1122,27,20,23,70,0.062388592
Wilkes Barre-Scranton-Hztn,18812,1523,37,27,31,95,0.062376888
Tulsa,74423,946,23,19,17,59,0.062367865
Albany-Schenectady-Troy,12138,2806,63,62,50,175,0.062366358
New York,7822,930,25,18,15,58,0.062365591
Ft. Wayne,46742,3207,71,58,71,200,0.06236358
New York,10526,1812,53,33,27,113,0.062362031
Fargo,58228,898,27,16,13,56,0.062360802
"Portland, OR",97750,433,14,7,6,27,0.062355658
Eureka,95573,1700,44,32,30,106,0.062352941
Boston (Manchester),3466,1251,29,26,23,78,0.06235012
Watertown,13664,417,10,7,9,26,0.06235012
Lincoln & Hastings-Krny,68920,1251,33,20,25,78,0.06235012
"Rochester, NY",14418,1235,23,24,30,77,0.062348178
Burlington-Plattsburgh,5158,818,19,14,18,51,0.062347188
Omaha,51531,818,16,17,18,51,0.062347188
Great Falls,59479,818,19,13,19,51,0.062347188
Wichita-Hutchinson Plus,67757,401,12,4,9,25,0.06234414
Lincoln & Hastings-Krny,68831,802,21,15,14,50,0.06234414
Pittsburgh,15342,5197,120,101,103,324,0.06234366
Sacramnto-Stkton-Modesto,95726,9320,229,187,165,581,0.062339056
Seattle-Tacoma,98349,5037,139,88,87,314,0.062338694
Portland-Auburn,3860,3850,58,80,102,240,0.062337662
Cedar Rapids-Wtrlo-IWC&Dub,52077,385,13,8,3,24,0.062337662
Nashville,38582,1476,37,34,21,92,0.062330623
Columbia-Jefferson City,65287,369,9,6,8,23,0.062330623
Clarksburg-Weston,26270,722,21,10,14,45,0.06232687
Little Rock-Pine Bluff,72153,2439,67,49,36,152,0.062320623
Springfield-Holyoke,1373,4622,98,100,90,288,0.062310688
Minneapolis-St. Paul,56466,3178,81,64,53,198,0.062303335
Minneapolis-St. Paul,54750,1236,32,19,26,77,0.062297735
Lincoln & Hastings-Krny,68814,899,27,14,15,56,0.062291435
Memphis,63827,594,12,12,13,37,0.062289562
Presque Isle,4756,3259,60,66,77,203,0.062289046
Monterey-Salinas,93924,6438,160,122,119,401,0.062286424
Albany-Schenectady-Troy,12007,289,7,4,7,18,0.062283737
Wilkes Barre-Scranton-Hztn,17768,289,8,5,5,18,0.062283737
Flint-Saginaw-Bay City,48654,2312,48,43,53,144,0.062283737
Minneapolis-St. Paul,56235,578,13,13,10,36,0.062283737
Dayton,43324,2521,66,46,45,157,0.062276874
Rapid City,57762,546,13,13,8,34,0.062271062
Phoenix (Prescott),85928,1092,25,24,19,68,0.062271062
Albuquerque-Santa Fe,88351,273,8,4,5,17,0.062271062
Baltimore,21645,996,26,21,15,62,0.062248996
Green Bay-Appleton,54227,1719,42,35,30,107,0.062245492
Buffalo,16943,482,12,9,9,30,0.062240664
Sioux Falls(Mitchell),57646,241,7,4,4,15,0.062240664
Medford-Klamath Falls,96027,2153,49,47,38,134,0.062238737
Albany-Schenectady-Troy,1266,1671,41,38,25,104,0.062238181
Sacramnto-Stkton-Modesto,95228,4772,110,86,101,297,0.062238055
Albany-Schenectady-Troy,1257,2330,51,50,44,145,0.06223176
Hartford & New Haven,6242,1398,28,23,36,87,0.06223176
"Columbus, GA (Opelika, AL)",31743,466,10,10,9,29,0.06223176
Burlington-Plattsburgh,5060,4628,105,106,77,288,0.062229905
Albany-Schenectady-Troy,12469,691,14,14,15,43,0.062228654
Boston (Manchester),3444,1607,41,33,26,100,0.062227754
Rochestr-Mason City-Austin,50473,225,5,5,4,14,0.062222222
Missoula,59929,225,6,4,4,14,0.062222222
Albany-Schenectady-Troy,12860,659,11,13,17,41,0.062215478
Des Moines-Ames,50566,434,14,6,7,27,0.062211982
Sherman-Ada,74555,868,22,18,14,54,0.062211982
Pittsburgh,15243,14178,362,301,219,882,0.062209056
"Jackson, TN",38370,643,11,16,13,40,0.062208398
Burlington-Plattsburgh,5494,1688,36,29,40,105,0.062203791
Denver,81324,1688,31,34,40,105,0.062203791
Greensboro-H.Point-W.Salem,24185,820,19,16,16,51,0.062195122
Greenvll-Spart-Ashevll-And,28775,611,14,10,14,38,0.062193126
Sioux Falls(Mitchell),57529,402,11,7,7,25,0.062189055
Wichita-Hutchinson Plus,67741,402,11,7,7,25,0.062189055
Ft. Wayne,46792,3988,100,79,69,248,0.06218656
South Bend-Elkhart,49061,1769,45,35,30,110,0.062182024
Spokane,83810,1174,33,20,20,73,0.062180579
Greenville-N.Bern-Washngtn,27970,2541,57,56,45,158,0.062180244
Wichita-Hutchinson Plus,67452,193,7,2,3,12,0.062176166
Boston (Manchester),3855,2847,74,51,52,177,0.062170706
Burlington-Plattsburgh,5839,756,27,14,6,47,0.062169312
Green Bay-Appleton,54965,1512,37,29,28,94,0.062169312
Macon,31090,933,21,18,19,58,0.062165059
Sacramnto-Stkton-Modesto,95614,3732,91,78,63,232,0.062165059
Green Bay-Appleton,49893,1641,39,30,33,102,0.062157221
Greenville-N.Bern-Washngtn,28557,15300,325,295,331,951,0.062156863
Santabarbra-Sanmar-Sanluob,93460,5616,132,117,100,349,0.062143875
Macon,31035,1046,23,22,20,65,0.062141491
San Francisco-Oak-San Jose,94707,12182,298,258,201,757,0.062140864
Roanoke-Lynchburg,24565,869,21,13,20,54,0.062140391
Denver,69360,1207,24,29,22,75,0.062137531
Green Bay-Appleton,54141,2752,73,53,45,171,0.062136628
Omaha,51446,515,13,12,7,32,0.062135922
Quincy-Hannibal-Keokuk,52656,2060,44,41,43,128,0.062135922
Sioux City,68783,1030,29,18,17,64,0.062135922
Tucson (Sierra Vista),85616,5199,122,95,106,323,0.062127332
"Tri-Cities, TN-VA",24221,821,16,17,18,51,0.062119367
Lincoln & Hastings-Krny,68971,322,8,5,7,20,0.062111801
"Tri-Cities, TN-VA",24277,6537,131,139,136,406,0.062108001
Burlington-Plattsburgh,12997,1079,19,26,22,67,0.062094532
Miami-Ft. Lauderdale,33070,6217,128,126,132,386,0.062087824
"Washington, DC (Hagrstwn)",26810,451,10,9,9,28,0.062084257
Wausau-Rhinelander,54541,1353,35,19,30,84,0.062084257
"Columbus, OH",43061,5010,134,103,74,311,0.062075848
Boston (Manchester),3256,2497,60,47,48,155,0.062074489
Clarksburg-Weston,26217,290,6,7,5,18,0.062068966
Sioux City,68728,290,7,7,4,18,0.062068966
Erie,16421,1869,52,38,26,116,0.062065276
Bangor,4623,999,22,21,19,62,0.062062062
New York,8831,58249,1540,1188,887,3615,0.062061151
Bluefield-Beckley-Oak Hill,26656,564,12,12,11,35,0.062056738
Fargo,56684,419,12,6,8,26,0.062052506
Boston (Manchester),3037,4980,118,88,103,309,0.062048193
Jonesboro,72482,1241,30,28,19,77,0.062046737
Wilkes Barre-Scranton-Hztn,18443,548,14,10,10,34,0.062043796
Lincoln & Hastings-Krny,68838,274,8,6,3,17,0.062043796
Myrtle Beach-Florence,29568,17939,388,345,380,1113,0.062043592
Detroit,48469,1209,31,19,25,75,0.062034739
Sioux Falls(Mitchell),57218,403,7,8,10,25,0.062034739
Bismarck-Mnt-Dcknsn(Wlstn),58572,403,13,7,5,25,0.062034739
Champaign&Sprngfld-Decatur,61884,1209,28,23,24,75,0.062034739
Las Vegas,89048,26874,575,545,547,1667,0.062030215
Austin,78953,1322,31,24,27,82,0.062027231
Evansville,47541,1177,28,21,24,73,0.06202209
Pittsburgh,15330,5853,141,121,101,363,0.062019477
Omaha,50853,645,15,14,11,40,0.062015504
Fargo,58431,129,3,2,3,8,0.062015504
Lincoln & Hastings-Krny,69028,774,20,14,14,48,0.062015504
Eugene,97414,258,7,4,5,16,0.062015504
Seattle-Tacoma,98330,258,7,5,4,16,0.062015504
Roanoke-Lynchburg,24325,1016,25,18,20,63,0.062007874
Traverse City-Cadillac,49613,758,19,15,13,47,0.062005277
La Crosse-Eau Claire,54530,758,24,15,8,47,0.062005277
Cleveland-Akron (Canton),44044,15516,331,336,295,962,0.062000516
Wausau-Rhinelander,54435,2226,55,47,36,138,0.061994609
Kansas City,65330,371,11,5,7,23,0.061994609
Missoula,59840,16131,362,330,308,1000,0.061992437
Charleston-Huntington,26629,613,17,9,12,38,0.061990212
Seattle-Tacoma,98304,855,22,16,15,53,0.061988304
Little Rock-Pine Bluff,71965,242,6,5,4,15,0.061983471
Little Rock-Pine Bluff,72026,242,6,5,4,15,0.061983471
Little Rock-Pine Bluff,72140,242,6,5,4,15,0.061983471
"Portland, OR",98612,3372,80,60,69,209,0.06198102
Roanoke-Lynchburg,24101,6487,147,142,113,402,0.061970094
Columbus-Tupelo-West Point,38913,468,11,10,8,29,0.061965812
Burlington-Plattsburgh,5359,581,12,10,14,36,0.061962134
Utica,13796,1275,27,23,29,79,0.061960784
Mobile-Pensacola (Ft Walt),32583,33812,770,616,709,2095,0.061960251
Wilkes Barre-Scranton-Hztn,17827,807,20,18,12,50,0.061957869
Green Bay-Appleton,54246,807,19,16,15,50,0.061957869
Idaho Fals-Pocatllo(Jcksn),83014,3341,71,70,66,207,0.061957498
Bismarck-Mnt-Dcknsn(Wlstn),58576,920,21,16,20,57,0.061956522
Bangor,4460,1259,26,26,26,78,0.061953932
Syracuse,13028,1259,31,23,24,78,0.061953932
Hartford & New Haven,6264,113,1,3,3,7,0.061946903
New York,12750,113,3,2,2,7,0.061946903
Roanoke-Lynchburg,24487,226,5,4,5,14,0.061946903
St. Louis,63087,791,20,16,13,49,0.061946903
Lincoln & Hastings-Krny,68875,565,17,8,10,35,0.061946903
Albuquerque-Santa Fe,87315,339,9,6,6,21,0.061946903
"Charleston, SC",29458,2583,62,53,45,160,0.061943477
Omaha,68409,888,22,17,16,55,0.061936937
New York,10530,12110,243,230,277,750,0.061932287
Marquette,49815,436,10,9,8,27,0.061926606
Traverse City-Cadillac,49638,759,17,16,14,47,0.061923584
Ft. Smith-Fay-Sprngdl-Rgrs,72721,323,7,7,6,20,0.061919505
Burlington-Plattsburgh,3245,2035,48,37,41,126,0.061916462
Portland-Auburn,4041,1599,32,30,37,99,0.061913696
Bismarck-Mnt-Dcknsn(Wlstn),58533,953,20,19,20,59,0.061909759
Burlington-Plattsburgh,5733,6091,148,123,106,377,0.061894599
Roanoke-Lynchburg,22949,1325,30,25,27,82,0.061886792
Albany-Schenectady-Troy,12063,404,10,7,8,25,0.061881188
New York,12786,404,8,7,10,25,0.061881188
Wichita-Hutchinson Plus,67455,1713,43,31,32,106,0.061879743
Des Moines-Ames,51463,501,14,11,6,31,0.061876248
New York,11933,8049,188,167,143,498,0.06187104
Traverse City-Cadillac,49332,2877,65,55,58,178,0.061870003
Burlington-Plattsburgh,5343,986,27,16,18,61,0.061866126
Burlington-Plattsburgh,5458,2166,49,28,57,134,0.061865189
Minneapolis-St. Paul,54829,5205,127,88,107,322,0.061863593
Richmond-Petersburg,22438,388,10,6,8,24,0.06185567
Cedar Rapids-Wtrlo-IWC&Dub,52221,194,4,4,4,12,0.06185567
Bismarck-Mnt-Dcknsn(Wlstn),59242,97,2,2,2,6,0.06185567
Great Falls,59472,582,16,10,10,36,0.06185567
Great Falls,59535,97,2,2,2,6,0.06185567
Helena,59647,291,7,6,5,18,0.06185567
Paducah-Cape Girard-Harsbg,62947,194,5,4,3,12,0.06185567
Sioux City,68631,485,10,7,13,30,0.06185567
Idaho Fals-Pocatllo(Jcksn),83462,582,14,11,11,36,0.06185567
Syracuse,13461,2991,67,60,58,185,0.061852223
Phoenix (Prescott),85028,20680,431,446,402,1279,0.061847195
Syracuse,13044,2393,58,44,46,148,0.061847054
Johnstown-Altoona-St Colge,15823,1229,27,24,25,76,0.061838893
Bismarck-Mnt-Dcknsn(Wlstn),58384,566,16,9,10,35,0.061837456
Omaha,51557,744,17,17,12,46,0.061827957
Albuquerque-Santa Fe,87056,744,21,14,11,46,0.061827957
Monterey-Salinas,95017,744,18,15,13,46,0.061827957
Burlington-Plattsburgh,12993,1666,46,23,34,103,0.06182473
Minneapolis-St. Paul,56249,275,7,6,4,17,0.061818182
Sioux City,50554,1553,33,22,41,96,0.06181584
San Antonio,78024,1003,27,20,15,62,0.061814556
Dallas-Ft. Worth,75440,7280,171,142,137,450,0.061813187
Portland-Auburn,4017,453,12,9,7,28,0.061810155
Paducah-Cape Girard-Harsbg,63739,453,12,7,9,28,0.061810155
Little Rock-Pine Bluff,72581,987,23,22,16,61,0.061803445
Greenville-N.Bern-Washngtn,27840,356,7,8,7,22,0.061797753
Davenport-R.Island-Moline,61435,178,5,4,2,11,0.061797753
Wichita-Hutchinson Plus,67626,178,3,4,4,11,0.061797753
Tampa-St. Pete (Sarasota),34433,8949,215,172,166,553,0.061794614
Burlington-Plattsburgh,3222,6198,118,133,132,383,0.061794127
Sioux City,68718,1505,40,32,21,93,0.06179402
Richmond-Petersburg,23885,2654,65,47,52,164,0.061793519
Evansville,47631,1926,46,34,39,119,0.061786085
Albuquerque-Santa Fe,88345,8530,177,175,175,527,0.061781946
Albany-Schenectady-Troy,12823,259,6,4,6,16,0.061776062
Des Moines-Ames,50556,259,6,4,6,16,0.061776062
Minneapolis-St. Paul,56349,777,20,17,11,48,0.061776062
Sioux Falls(Mitchell),57219,518,14,7,11,32,0.061776062
Wichita-Hutchinson Plus,67485,259,10,2,4,16,0.061776062
Greenville-N.Bern-Washngtn,27806,1894,59,35,23,117,0.061774023
Los Angeles,90069,19896,112,240,877,1229,0.06177121
Minneapolis-St. Paul,56461,3578,101,67,53,221,0.06176635
Flint-Saginaw-Bay City,48632,5424,124,111,100,335,0.061762537
Boston (Manchester),1583,7610,156,162,152,470,0.061760841
Albany-Schenectady-Troy,1259,842,21,16,15,52,0.06175772
Tucson (Sierra Vista),85603,6380,143,125,126,394,0.061755486
Eugene,97462,4113,106,78,70,254,0.06175541
Lincoln & Hastings-Krny,68966,502,16,8,7,31,0.061752988
Houston,78944,502,12,10,9,31,0.061752988
Albany-Schenectady-Troy,12418,583,11,11,14,36,0.061749571
West Palm Beach-Ft. Pierce,34986,33945,760,686,650,2096,0.061746944
Champaign&Sprngfld-Decatur,61754,1150,28,24,19,71,0.06173913
Sacramnto-Stkton-Modesto,95623,4568,95,90,97,282,0.0617338
New York,11961,12846,264,265,264,793,0.061731278
Burlington-Plattsburgh,5353,1134,22,22,26,70,0.061728395
Roanoke-Lynchburg,24526,1458,33,28,29,90,0.061728395
Fargo,58004,243,6,6,3,15,0.061728395
Fargo,58043,162,4,2,4,10,0.061728395
Great Falls,59466,81,2,2,1,5,0.061728395
"Springfield, MO",65778,324,6,8,6,20,0.061728395
Wichita-Hutchinson Plus,67028,162,5,3,2,10,0.061728395
Wichita-Hutchinson Plus,67556,243,5,5,5,15,0.061728395
Omaha,68320,324,9,6,5,20,0.061728395
Cheyenne-Scottsbluff,82219,81,3,1,1,5,0.061728395
Boise,97909,81,2,2,1,5,0.061728395
Sacramnto-Stkton-Modesto,95222,5460,138,107,92,337,0.061721612
Minneapolis-St. Paul,55314,1118,26,19,24,69,0.061717352
Tampa-St. Pete (Sarasota),34202,31029,777,617,521,1915,0.061716459
Greenville-N.Bern-Washngtn,28527,875,21,17,16,54,0.061714286
Twin Falls,83340,6028,123,109,140,372,0.061712011
Little Rock-Pine Bluff,72036,713,14,17,13,44,0.06171108
Sioux Falls(Mitchell),57568,632,12,11,16,39,0.061708861
Honolulu,96790,10080,246,199,177,622,0.061706349
Clarksburg-Weston,26234,1102,28,19,21,68,0.061705989
Missoula,59932,1718,44,34,28,106,0.061699651
Boston (Manchester),3464,1232,39,22,15,76,0.061688312
Lincoln & Hastings-Krny,68842,616,18,9,11,38,0.061688312
"Portland, OR",98635,2302,59,42,41,142,0.061685491
Burlington-Plattsburgh,5875,600,18,11,8,37,0.061666667
Youngstown,44455,1200,28,23,23,74,0.061666667
Harrisonburg,26807,2076,38,45,45,128,0.061657033
Orlando-Daytona Bch-Melbrn,32668,5336,120,110,99,329,0.061656672
Birmingham (Ann and Tusc),35984,1995,47,40,36,123,0.061654135
Pittsburgh,15142,1476,24,28,39,91,0.061653117
Richmond-Petersburg,23146,3309,75,67,62,204,0.061650045
Rochestr-Mason City-Austin,50423,2790,70,45,57,172,0.061648746
Buffalo,16726,438,10,8,9,27,0.061643836
Bismarck-Mnt-Dcknsn(Wlstn),58641,146,4,3,2,9,0.061643836
Bismarck-Mnt-Dcknsn(Wlstn),59275,292,6,5,7,18,0.061643836
Sioux City,68773,292,4,7,7,18,0.061643836
Abilene-Sweetwater,76884,146,5,3,1,9,0.061643836
Abilene-Sweetwater,79533,438,11,8,8,27,0.061643836
Sacramnto-Stkton-Modesto,95607,438,10,8,9,27,0.061643836
Greenvll-Spart-Ashevll-And,28740,2385,55,45,47,147,0.06163522
Pittsburgh,26716,649,17,14,9,40,0.061633282
Des Moines-Ames,50002,1298,34,24,22,80,0.061633282
Wichita-Hutchinson Plus,67575,357,6,8,8,22,0.06162465
Sacramnto-Stkton-Modesto,95602,17964,436,346,325,1107,0.061623246
New York,11360,19198,379,394,410,1183,0.061621002
Philadelphia,18035,211,6,4,3,13,0.061611374
Chattanooga,35751,211,6,4,3,13,0.061611374
Indianapolis,46164,4561,110,87,84,281,0.061609296
Medford-Klamath Falls,96025,2175,37,47,50,134,0.061609195
Spokane,83847,1818,41,41,30,112,0.061606161
Milwaukee,53103,3896,107,74,59,240,0.061601643
Kansas City,66206,11218,325,243,123,691,0.061597433
"Tri-Cities, TN-VA",24217,276,7,5,5,17,0.061594203
Wilmington,28479,6624,178,118,112,408,0.061594203
Chicago,60913,1380,30,29,26,85,0.061594203
Topeka,66962,276,6,5,6,17,0.061594203
Buffalo,16720,1169,30,20,22,72,0.061591104
Sioux Falls(Mitchell),56136,1234,24,27,25,76,0.061588331
Greenville-N.Bern-Washngtn,28529,1981,40,44,38,122,0.061585058
Wilkes Barre-Scranton-Hztn,17967,2387,51,44,52,147,0.061583578
Missoula,59914,341,8,6,7,21,0.061583578
Roanoke-Lynchburg,24435,1754,44,29,35,108,0.061573546
Louisville,40152,877,23,13,18,54,0.061573546
Mobile-Pensacola (Ft Walt),32509,471,12,9,8,29,0.061571125
Houston,77861,3265,80,56,65,201,0.061562021
Roanoke-Lynchburg,24083,4614,122,96,66,284,0.061551799
Baltimore,21032,9960,237,209,167,613,0.061546185
Greensboro-H.Point-W.Salem,27379,4777,111,98,85,294,0.061544903
New York,6853,3656,109,80,36,225,0.06154267
Traverse City-Cadillac,49743,650,10,14,16,40,0.061538462
Des Moines-Ames,50001,455,12,9,7,28,0.061538462
Green Bay-Appleton,54486,2210,50,34,52,136,0.061538462
Great Falls,59522,1365,20,27,37,84,0.061538462
Kansas City,64022,130,3,3,2,8,0.061538462
Omaha,64496,130,3,2,3,8,0.061538462
Wichita-Hutchinson Plus,67071,65,2,1,1,4,0.061538462
Denver,69021,1105,25,20,23,68,0.061538462
Denver,82242,65,1,1,2,4,0.061538462
Albuquerque-Santa Fe,87419,260,6,6,4,16,0.061538462
"Portland, OR",97350,260,6,5,5,16,0.061538462
"Washington, DC (Hagrstwn)",22620,2584,55,54,50,159,0.061532508
New York,10987,4502,91,85,101,277,0.06152821
Buffalo,15870,1349,29,26,28,83,0.061527057
Sacramnto-Stkton-Modesto,95634,2942,74,42,65,181,0.061522774
Burlington-Plattsburgh,5472,1853,35,36,43,114,0.061521856
San Francisco-Oak-San Jose,94131,28544,446,530,780,1756,0.061519058
Wichita-Hutchinson Plus,67467,2975,79,58,46,183,0.061512605
Little Rock-Pine Bluff,72073,943,18,17,23,58,0.061505832
Helena,59644,5106,110,103,101,314,0.061496279
San Antonio,78063,9709,249,189,159,597,0.06148934
Paducah-Cape Girard-Harsbg,63944,1171,23,26,23,72,0.061485909
San Francisco-Oak-San Jose,95472,27537,640,552,501,1693,0.061480917
Denver,82214,1220,30,19,26,75,0.06147541
"Washington, DC (Hagrstwn)",16691,423,9,8,9,26,0.061465721
Milwaukee,53033,5174,145,99,74,318,0.061461152
Portland-Auburn,4547,1139,21,24,25,70,0.061457419
Boston (Manchester),3467,1676,39,36,28,103,0.061455847
Tampa-St. Pete (Sarasota),33542,22895,498,432,477,1407,0.061454466
Minneapolis-St. Paul,56647,716,18,13,13,44,0.061452514
Rapid City,57758,179,6,3,2,11,0.061452514
Great Falls,59462,179,4,3,4,11,0.061452514
"Springfield, MO",65484,179,5,3,3,11,0.061452514
Reno,89418,472,10,10,9,29,0.061440678
Burlington-Plattsburgh,5759,1709,31,37,37,105,0.061439438
New York,8738,1058,12,27,26,65,0.061436673
Columbia-Jefferson City,65281,2995,79,50,55,184,0.061435726
Albany-Schenectady-Troy,12056,2393,48,50,49,147,0.061429168
Youngstown,44418,1107,23,22,23,68,0.061427281
Boston (Manchester),2576,4363,96,99,73,268,0.061425625
Miami-Ft. Lauderdale,33050,10778,199,221,242,662,0.061421414
Watertown,13437,521,11,11,10,32,0.061420345
Traverse City-Cadillac,49449,2719,69,56,42,167,0.06141964
Burlington-Plattsburgh,5647,1156,21,25,25,71,0.061418685
Pittsburgh,15005,9004,206,172,175,553,0.061417148
Bismarck-Mnt-Dcknsn(Wlstn),58833,114,3,2,2,7,0.061403509
St. Louis,62630,456,12,9,7,28,0.061403509
Corpus Christi,78340,342,7,9,5,21,0.061403509
Albuquerque-Santa Fe,87750,114,2,2,3,7,0.061403509
Los Angeles,89013,342,10,7,4,21,0.061403509
Buffalo,16922,1759,45,26,37,108,0.061398522
Des Moines-Ames,50851,1922,46,33,39,118,0.061394381
Philadelphia,8260,12656,255,247,275,777,0.061393805
Burlington-Plattsburgh,5153,847,21,17,14,52,0.061393152
Albuquerque-Santa Fe,87549,2085,36,45,47,128,0.061390887
Wilkes Barre-Scranton-Hztn,17935,1515,30,32,31,93,0.061386139
Minneapolis-St. Paul,56221,782,19,10,19,48,0.061381074
Butte-Bozeman,59731,668,17,10,14,41,0.061377246
"Columbia, SC",29037,831,17,17,17,51,0.061371841
Sioux Falls(Mitchell),57043,1434,37,25,26,88,0.061366806
"Columbus, GA (Opelika, AL)",36317,440,10,8,9,27,0.061363636
Binghamton,13844,603,16,10,11,37,0.061359867
Lincoln & Hastings-Krny,68816,163,4,4,2,10,0.061349693
Amarillo,88424,163,5,2,3,10,0.061349693
Fresno-Visalia,93244,326,8,7,5,20,0.061349693
Bangor,4653,701,15,14,14,43,0.061340942
Colorado Springs-Pueblo,81212,32460,769,636,586,1991,0.06133703
Tampa-St. Pete (Sarasota),34239,15281,315,313,309,937,0.061317977
Bangor,4765,1109,30,20,18,68,0.061316501
Orlando-Daytona Bch-Melbrn,34731,12560,291,258,221,770,0.061305732
Pittsburgh,16353,2773,63,55,52,170,0.061305445
Paducah-Cape Girard-Harsbg,62274,7585,165,163,137,465,0.061305208
Sioux Falls(Mitchell),57450,571,15,10,10,35,0.061295972
San Francisco-Oak-San Jose,94708,11584,257,211,242,710,0.061291436
Minneapolis-St. Paul,54813,620,17,10,11,38,0.061290323
Duluth-Superior,56627,310,11,4,4,19,0.061290323
Roanoke-Lynchburg,24102,1599,36,33,29,98,0.061288305
Bismarck-Mnt-Dcknsn(Wlstn),58529,669,13,13,15,41,0.061285501
Fargo,58425,1387,26,25,34,85,0.061283345
Champaign&Sprngfld-Decatur,61932,359,8,8,6,22,0.061281337
Minneapolis-St. Paul,56083,767,20,13,14,47,0.061277705
"Portland, OR",98650,1175,36,26,10,72,0.061276596
Cedar Rapids-Wtrlo-IWC&Dub,52135,816,18,12,20,50,0.06127451
Traverse City-Cadillac,49616,2089,46,41,41,128,0.061273337
"Washington, DC (Hagrstwn)",26808,865,16,18,19,53,0.061271676
Flint-Saginaw-Bay City,48652,1371,28,29,27,84,0.061269147
Sioux Falls(Mitchell),56123,457,11,7,10,28,0.061269147
Topeka,66938,963,21,15,23,59,0.061266874
Burlington-Plattsburgh,5146,653,13,11,16,40,0.061255743
Greenvll-Spart-Ashevll-And,28743,2008,43,42,38,123,0.06125498
Springfield-Holyoke,1096,2906,66,61,51,178,0.061252581
"Washington, DC (Hagrstwn)",26755,751,17,13,16,46,0.061251664
Richmond-Petersburg,23030,4539,105,83,90,278,0.061246971
Topeka,66097,947,23,23,12,58,0.06124604
Bismarck-Mnt-Dcknsn(Wlstn),58831,996,28,21,12,61,0.06124498
Marquette,49958,1094,28,22,17,67,0.061243144
Evansville,47577,1241,27,31,18,76,0.061240935
Springfield-Holyoke,1088,784,14,17,17,48,0.06122449
Albany-Schenectady-Troy,1270,735,11,17,17,45,0.06122449
Albany-Schenectady-Troy,12819,294,7,6,5,18,0.06122449
"Washington, DC (Hagrstwn)",15536,490,10,9,11,30,0.06122449
"Washington, DC (Hagrstwn)",20319,147,1,3,5,9,0.06122449
Charlotte,28682,2156,53,44,35,132,0.06122449
Des Moines-Ames,50524,588,17,8,11,36,0.06122449
Fargo,58323,49,1,1,1,3,0.06122449
Fargo,58415,147,4,2,3,9,0.06122449
Great Falls,59547,49,1,1,1,3,0.06122449
Paducah-Cape Girard-Harsbg,63942,343,9,7,5,21,0.06122449
Wichita Falls & Lawton,76481,196,6,4,2,12,0.06122449
Denver,81143,833,19,16,16,51,0.06122449
Spokane,83548,147,4,2,3,9,0.06122449
Hartford & New Haven,6277,3953,79,82,81,242,0.061219327
Savannah,29909,24358,547,651,293,1491,0.061211922
Shreveport,75661,2369,54,49,42,145,0.06120726
Richmond-Petersburg,22460,1830,48,36,28,112,0.061202186
Eugene,97436,768,19,14,14,47,0.061197917
"Portland, OR",97108,621,16,13,9,38,0.061191626
"Washington, DC (Hagrstwn)",26714,572,10,12,13,35,0.061188811
Atlanta,28902,1471,37,30,23,90,0.061182869
Des Moines-Ames,50451,474,8,8,13,29,0.061181435
Phoenix (Prescott),86301,27479,559,588,534,1681,0.061173987
Albany-Schenectady-Troy,12849,376,10,5,8,23,0.061170213
Sacramnto-Stkton-Modesto,95664,1406,35,27,24,86,0.06116643
Monroe-El Dorado,71758,327,6,11,3,20,0.06116208
San Antonio,78850,1112,34,20,14,68,0.061151079
Denver,82639,834,20,15,16,51,0.061151079
Oklahoma City,73641,736,21,11,13,45,0.061141304
Duluth-Superior,54534,2666,56,55,52,163,0.061140285
Wichita-Hutchinson Plus,67451,916,28,13,15,56,0.061135371
Clarksburg-Weston,26238,867,19,18,16,53,0.061130334
Greensboro-H.Point-W.Salem,27291,1505,37,25,30,92,0.061129568
Lincoln & Hastings-Krny,69038,638,9,19,11,39,0.061128527
Flint-Saginaw-Bay City,48628,1865,41,42,31,114,0.061126005
Fargo,58282,1227,28,25,22,75,0.061124694
Burlington-Plattsburgh,5342,540,12,12,9,33,0.061111111
Clarksburg-Weston,26222,540,13,8,12,33,0.061111111
Omaha,51630,180,4,3,4,11,0.061111111
Houston,78933,1440,36,27,25,88,0.061111111
Tulsa,67344,671,18,13,10,41,0.061102832
Ft. Myers-Naples,34109,26923,620,527,498,1645,0.061100175
Wilkes Barre-Scranton-Hztn,18462,491,12,10,8,30,0.061099796
Houston,78954,982,23,19,18,60,0.061099796
Sioux Falls(Mitchell),56114,311,8,5,6,19,0.061093248
Salt Lake City,83115,573,17,10,8,35,0.061082024
Paducah-Cape Girard-Harsbg,63766,835,20,15,16,51,0.061077844
Champaign&Sprngfld-Decatur,62625,966,28,18,13,59,0.061076605
Omaha,68317,2194,62,37,35,134,0.061075661
Monroe-El Dorado,71250,131,3,3,2,8,0.061068702
Spokane,83804,1834,46,39,27,112,0.061068702
Raleigh-Durham (Fayetvlle),23915,1081,26,20,20,66,0.061054579
South Bend-Elkhart,49128,3375,66,58,82,206,0.061037037
Bismarck-Mnt-Dcknsn(Wlstn),58627,213,5,4,4,13,0.061032864
Butte-Bozeman,59751,213,4,4,5,13,0.061032864
"Portland, OR",97856,426,10,9,7,26,0.061032864
Portland-Auburn,4029,1950,26,36,57,119,0.061025641
Wichita-Hutchinson Plus,67035,803,19,16,14,49,0.061021171
Lincoln & Hastings-Krny,68843,803,19,16,14,49,0.061021171
Portland-Auburn,4055,3884,89,70,78,237,0.061019567
Grand Rapids-Kalmzoo-B.Crk,49453,3163,84,75,34,193,0.061018021
Wilkes Barre-Scranton-Hztn,18417,1131,28,23,18,69,0.061007958
Topeka,66406,459,10,9,9,28,0.061002179
Dayton,45370,2410,66,51,30,147,0.060995851
Harrisonburg,24479,1574,38,30,28,96,0.060991105
Panama City,32461,4099,108,80,62,250,0.060990485
Bismarck-Mnt-Dcknsn(Wlstn),59254,1984,48,36,37,121,0.060987903
New York,12720,164,3,3,4,10,0.06097561
Greenvll-Spart-Ashevll-And,28747,2132,47,34,49,130,0.06097561
Wichita-Hutchinson Plus,67345,164,5,2,3,10,0.06097561
Wichita-Hutchinson Plus,67418,164,4,3,3,10,0.06097561
Wichita-Hutchinson Plus,67513,82,1,2,2,5,0.06097561
Lincoln & Hastings-Krny,68864,902,21,21,13,55,0.06097561
Oklahoma City,73668,82,2,2,1,5,0.06097561
Idaho Fals-Pocatllo(Jcksn),83012,246,5,4,6,15,0.06097561
Chico-Redding,96076,246,5,5,5,15,0.06097561
Cedar Rapids-Wtrlo-IWC&Dub,52766,853,20,19,13,52,0.060961313
New York,18464,1378,29,29,26,84,0.06095791
Wichita-Hutchinson Plus,67671,1575,44,21,31,96,0.060952381
Fargo,58059,2018,51,41,31,123,0.060951437
Burlington-Plattsburgh,5866,722,14,14,16,44,0.060941828
Baltimore,21057,3971,98,79,65,242,0.060941828
Richmond-Petersburg,23011,1805,38,29,43,110,0.060941828
Spokane,83830,722,18,14,12,44,0.060941828
Spokane,99123,1083,21,24,21,66,0.060941828
Philadelphia,18942,3085,74,62,52,188,0.060940032
Burlington-Plattsburgh,5736,558,10,9,15,34,0.0609319
"Springfield, MO",65338,3102,74,39,76,189,0.060928433
Erie,16345,3496,83,71,59,213,0.060926773
Boston (Manchester),2635,3808,80,78,74,232,0.06092437
Spokane,83536,4202,115,80,61,256,0.06092337
La Crosse-Eau Claire,54746,673,19,8,14,41,0.060921248
Chico-Redding,96062,1067,25,21,19,65,0.060918463
San Antonio,78873,1461,37,30,22,89,0.06091718
Fargo,58235,394,7,8,9,24,0.060913706
Fargo,58481,197,5,4,3,12,0.060913706
"Springfield, MO",72624,197,4,4,4,12,0.060913706
Seattle-Tacoma,98305,394,6,9,9,24,0.060913706
Flint-Saginaw-Bay City,48610,3448,88,71,51,210,0.060904872
Sacramnto-Stkton-Modesto,95249,3957,88,66,87,241,0.060904726
Des Moines-Ames,50599,312,5,6,8,19,0.060897436
"Columbus, OH",43356,1051,26,21,17,64,0.060894386
"Springfield, MO",65690,739,13,19,13,45,0.060893099
Fargo,58033,427,10,8,8,26,0.06088993
San Francisco-Oak-San Jose,95454,2135,55,35,40,130,0.06088993
Minneapolis-St. Paul,55047,2595,70,53,35,158,0.06088632
Roanoke-Lynchburg,24104,3827,104,71,58,233,0.060883198
Dallas-Ft. Worth,76449,2431,61,44,43,148,0.060880296
Johnstown-Altoona-St Colge,16864,115,2,3,2,7,0.060869565
Santabarbra-Sanmar-Sanluob,93442,11060,205,236,232,673,0.06084991
Hartford & New Haven,6785,871,25,14,14,53,0.060849598
Lincoln & Hastings-Krny,68313,904,24,18,13,55,0.060840708
Grand Rapids-Kalmzoo-B.Crk,49436,1693,42,30,31,103,0.060838748
Fargo,58479,263,6,7,3,16,0.060836502
Bangor,4945,1085,24,15,27,66,0.060829493
Boston (Manchester),3253,6790,142,146,125,413,0.060824742
Burlington-Plattsburgh,5903,855,23,18,11,52,0.060818713
Bangor,4951,1036,23,19,21,63,0.060810811
Flint-Saginaw-Bay City,48720,1036,23,20,20,63,0.060810811
Abilene-Sweetwater,76888,148,5,3,1,9,0.060810811
Sacramnto-Stkton-Modesto,95709,4654,108,93,82,283,0.060807907
Albany-Schenectady-Troy,5250,3684,95,71,58,224,0.060803474
St. Louis,62051,773,16,12,19,47,0.06080207
Charleston-Huntington,26137,625,14,12,12,38,0.0608
Greenvll-Spart-Ashevll-And,28791,15117,343,293,283,919,0.060792485
Columbia-Jefferson City,63333,658,15,14,11,40,0.060790274
Ottumwa-Kirksville,63551,329,9,6,5,20,0.060790274
Hartford & New Haven,6751,3373,59,74,72,205,0.060776757
Traverse City-Cadillac,49736,543,10,13,10,33,0.060773481
Duluth-Superior,55779,3505,88,65,60,213,0.060770328
"Tri-Cities, TN-VA",37640,3719,78,80,68,226,0.060769024
Fargo,56579,1152,30,22,18,70,0.060763889
Minneapolis-St. Paul,54853,3884,103,72,61,236,0.060762101
Tampa-St. Pete (Sarasota),33852,22499,545,429,393,1367,0.060758256
Fargo,58240,1218,32,21,21,74,0.060755337
Sacramnto-Stkton-Modesto,95669,2436,55,56,37,148,0.060755337
Bangor,4676,1070,30,22,13,65,0.060747664
South Bend-Elkhart,49125,1926,47,38,32,117,0.060747664
Butte-Bozeman,59854,214,6,3,4,13,0.060747664
Champaign&Sprngfld-Decatur,61834,8347,195,154,158,507,0.060740386
Minneapolis-St. Paul,56132,461,12,10,6,28,0.060737527
Miami-Ft. Lauderdale,33322,41914,774,845,926,2545,0.060719569
Marquette,49806,560,15,9,10,34,0.060714286
Miami-Ft. Lauderdale,33194,9619,220,186,178,584,0.060713172
Fresno-Visalia,93601,1779,39,37,32,108,0.060708263
Topeka,66872,906,23,16,16,55,0.060706402
Bangor,4449,1318,29,26,25,80,0.060698027
Quincy-Hannibal-Keokuk,61411,346,9,7,5,21,0.060693642
Boston (Manchester),1951,3592,79,67,72,218,0.060690423
Tucson (Sierra Vista),85615,9491,229,188,159,576,0.060689074
Lincoln & Hastings-Krny,68371,1582,40,23,33,96,0.06068268
Burlington-Plattsburgh,3285,2538,61,53,40,154,0.060677699
Portland-Auburn,4043,11998,290,246,192,728,0.060676779
Roanoke-Lynchburg,24352,923,21,15,20,56,0.060671723
Traverse City-Cadillac,49745,923,20,20,16,56,0.060671723
Topeka,66953,577,12,10,13,35,0.060658579
Wilkes Barre-Scranton-Hztn,18846,643,17,9,13,39,0.060653188
Presque Isle,4760,709,16,18,9,43,0.060648801
San Francisco-Oak-San Jose,95442,3298,66,68,66,200,0.060642814
Atlanta,30552,1979,37,44,39,120,0.060636685
Minneapolis-St. Paul,55783,2507,66,46,40,152,0.060630235
Sacramnto-Stkton-Modesto,95722,4701,127,91,67,285,0.060625399
Madison,53515,2491,56,50,45,151,0.060618226
Richmond-Petersburg,23952,132,5,2,1,8,0.060606061
Duluth-Superior,54559,594,15,10,11,36,0.060606061
Minneapolis-St. Paul,56285,1023,30,18,14,62,0.060606061
Bismarck-Mnt-Dcknsn(Wlstn),59223,396,11,8,5,24,0.060606061
Bismarck-Mnt-Dcknsn(Wlstn),59253,132,4,2,2,8,0.060606061
Memphis,63879,528,10,10,12,32,0.060606061
North Platte,69161,132,4,2,2,8,0.060606061
Dallas-Ft. Worth,76857,1848,49,37,26,112,0.060606061
San Angelo,79506,726,22,11,11,44,0.060606061
Denver,80430,66,2,1,1,4,0.060606061
Albuquerque-Santa Fe,88034,99,3,2,1,6,0.060606061
Reno,93512,297,6,6,6,18,0.060606061
New York,11944,4951,100,93,107,300,0.060593819
"Washington, DC (Hagrstwn)",22740,1304,33,22,24,79,0.060582822
Boston (Manchester),2045,10086,178,233,200,611,0.06057902
Tallahassee-Thomasville,32344,13173,309,259,230,798,0.060578456
Des Moines-Ames,50118,908,23,14,18,55,0.060572687
Marquette,49908,3038,66,70,48,184,0.060566162
Portland-Auburn,4956,710,14,13,16,43,0.06056338
Spokane,99148,2840,71,53,48,172,0.06056338
Flint-Saginaw-Bay City,48750,8620,161,166,195,522,0.060556845
Billings,59645,1668,46,27,28,101,0.060551559
Sacramnto-Stkton-Modesto,95642,7762,172,152,146,470,0.060551404
Traverse City-Cadillac,48629,7052,161,137,129,427,0.060550199
Spokane,99125,512,12,10,9,31,0.060546875
Pittsburgh,15658,8061,161,168,159,488,0.060538395
Richmond-Petersburg,23180,413,9,11,5,25,0.060532688
Minneapolis-St. Paul,56354,1239,31,22,22,75,0.060532688
Champaign&Sprngfld-Decatur,61943,1520,35,30,27,92,0.060526316
Des Moines-Ames,52555,314,8,7,4,19,0.060509554
Fargo,58274,942,25,15,17,57,0.060509554
Bismarck-Mnt-Dcknsn(Wlstn),58645,314,8,5,6,19,0.060509554
Memphis,72347,628,12,8,18,38,0.060509554
Tallahassee-Thomasville,32358,2413,54,45,47,146,0.060505595
Minneapolis-St. Paul,55087,281,8,5,4,17,0.060498221
Great Falls,59447,281,7,4,6,17,0.060498221
Detroit,48450,4166,91,84,77,252,0.060489678
Boston (Manchester),3456,744,13,13,19,45,0.060483871
Salt Lake City,84046,744,22,13,10,45,0.060483871
Burlington-Plattsburgh,5465,5688,152,115,77,344,0.0604782
Seattle-Tacoma,99133,1753,37,29,40,106,0.06046777
Richmond-Petersburg,22503,3936,97,71,70,238,0.06046748
Seattle-Tacoma,98826,7872,188,147,141,476,0.06046748
Greenville-N.Bern-Washngtn,27857,1075,24,22,19,65,0.060465116
Fargo,56533,215,4,5,4,13,0.060465116
Sacramnto-Stkton-Modesto,95914,430,11,7,8,26,0.060465116
Wilkes Barre-Scranton-Hztn,18415,1191,27,21,24,72,0.060453401
Tucson (Sierra Vista),85630,2647,79,32,49,160,0.060445788
Boston (Manchester),2630,2002,45,40,36,121,0.06043956
Davenport-R.Island-Moline,52644,364,11,6,5,22,0.06043956
Green Bay-Appleton,53049,2366,61,39,43,143,0.06043956
Santabarbra-Sanmar-Sanluob,93452,513,10,10,11,31,0.06042885
Albuquerque-Santa Fe,87556,2532,58,48,47,153,0.06042654
Fresno-Visalia,93644,7828,171,164,138,473,0.060424119
New York,12741,298,7,5,6,18,0.060402685
Fargo,58029,149,3,4,2,9,0.060402685
Rockford,61015,894,20,14,20,54,0.060402685
"Springfield, MO",65501,149,4,3,2,9,0.060402685
St. Louis,65529,149,2,4,3,9,0.060402685
Lincoln & Hastings-Krny,69026,149,4,3,2,9,0.060402685
Corpus Christi,78119,7020,163,149,112,424,0.06039886
Binghamton,13780,861,20,16,16,52,0.06039489
Bangor,4612,563,12,11,11,34,0.060390764
Champaign&Sprngfld-Decatur,61859,1126,29,21,18,68,0.060390764
Norfolk-Portsmth-Newpt Nws,23846,828,17,14,19,50,0.060386473
San Francisco-Oak-San Jose,95033,9754,257,183,149,589,0.060385483
Rochestr-Mason City-Austin,50483,679,19,13,9,41,0.060382916
West Palm Beach-Ft. Pierce,34951,16926,350,314,358,1022,0.06038048
Fargo,56646,265,7,4,5,16,0.060377358
Butte-Bozeman,59750,530,14,5,13,32,0.060377358
Colorado Springs-Pueblo,81054,4588,104,99,74,277,0.060374891
Pittsburgh,15610,3346,75,61,66,202,0.060370592
Cedar Rapids-Wtrlo-IWC&Dub,52157,1524,39,30,23,92,0.060367454
Bakersfield,93225,7057,143,123,160,426,0.060365594
Denver,80480,1259,31,29,16,76,0.060365369
Sioux City,50539,464,8,10,10,28,0.060344828
Lincoln & Hastings-Krny,68429,116,3,2,2,7,0.060344828
Hartford & New Haven,6088,5055,81,82,142,305,0.060336301
Phoenix (Prescott),86305,21944,586,442,296,1324,0.060335399
Minneapolis-St. Paul,56484,3315,85,67,48,200,0.060331825
Hartford & New Haven,6359,5188,115,105,93,313,0.060331534
St. Louis,62250,431,9,8,9,26,0.060324826
Sioux City,68771,1376,35,26,22,83,0.060319767
Duluth-Superior,54839,315,8,5,6,19,0.06031746
Jonesboro,72435,315,6,7,6,19,0.06031746
Albuquerque-Santa Fe,88316,2404,57,48,40,145,0.06031614
Jacksonville,32131,4941,116,86,96,298,0.060311678
Burlington-Plattsburgh,5045,1625,34,27,37,98,0.060307692
Philadelphia,8204,16864,346,309,362,1017,0.060305977
New York,12484,2786,57,56,55,168,0.060301508
Sioux City,50567,199,6,3,3,12,0.060301508
Minneapolis-St. Paul,56433,1990,55,36,29,120,0.060301508
Boise,83615,2073,53,36,36,125,0.060299083
Boston (Manchester),1773,5672,125,128,89,342,0.060296192
Champaign&Sprngfld-Decatur,61850,481,11,7,11,29,0.06029106
Rapid City,57720,763,16,13,17,46,0.060288336
Palm Springs,92262,28033,514,558,618,1690,0.060286091
Baltimore,21665,282,5,5,7,17,0.060283688
Quincy-Hannibal-Keokuk,52619,564,14,11,9,34,0.060283688
Fargo,58015,282,9,5,3,17,0.060283688
Roanoke-Lynchburg,24139,647,16,13,10,39,0.060278207
Kansas City,64487,647,17,10,12,39,0.060278207
Charleston-Huntington,25243,1012,27,21,13,61,0.06027668
Roanoke-Lynchburg,24137,2356,58,51,33,142,0.060271647
Eugene,97437,2439,62,43,42,147,0.060270603
Burlington-Plattsburgh,5773,2074,59,36,30,125,0.06027001
Monterey-Salinas,95006,9806,214,202,175,591,0.060269223
"Charleston, SC",29929,979,26,14,19,59,0.060265577
Tucson (Sierra Vista),85637,531,13,9,10,32,0.060263653
Abilene-Sweetwater,79529,1145,24,22,23,69,0.060262009
"Washington, DC (Hagrstwn)",22627,614,14,11,12,37,0.060260586
Davenport-R.Island-Moline,52756,2390,67,44,33,144,0.060251046
Bluefield-Beckley-Oak Hill,24966,1361,28,29,25,82,0.060249816
Springfield-Holyoke,1338,166,4,3,3,10,0.060240964
Albany-Schenectady-Troy,12422,249,4,5,6,15,0.060240964
New York,12760,498,13,8,9,30,0.060240964
Omaha,64498,332,9,5,6,20,0.060240964
Lincoln & Hastings-Krny,68945,249,7,5,3,15,0.060240964
Denver,69144,249,7,4,4,15,0.060240964
Albuquerque-Santa Fe,88431,83,2,1,2,5,0.060240964
Traverse City-Cadillac,49774,1793,47,35,26,108,0.060234244
Sioux Falls(Mitchell),57225,2009,41,42,38,121,0.06022897
Minneapolis-St. Paul,56315,1644,37,29,33,99,0.060218978
Columbia-Jefferson City,65061,548,11,11,11,33,0.060218978
San Antonio,78003,9798,212,187,191,590,0.060216371
Lincoln & Hastings-Krny,68527,2408,73,40,32,145,0.060215947
Traverse City-Cadillac,49653,1993,55,36,29,120,0.060210738
Albuquerque-Santa Fe,87520,980,20,18,21,59,0.060204082
Des Moines-Ames,50132,299,7,5,6,18,0.060200669
"Portland, OR",97125,299,7,5,6,18,0.060200669
Seattle-Tacoma,98858,2093,61,33,32,126,0.060200669
Wilkes Barre-Scranton-Hztn,17866,9668,192,195,195,582,0.060198593
Burlington-Plattsburgh,3262,1412,26,32,27,85,0.0601983
"Rochester, NY",14435,2525,56,53,43,152,0.06019802
Denver,80422,3788,99,70,59,228,0.060190074
Louisville,40119,2210,54,41,38,133,0.060180995
Duluth-Superior,54891,3473,85,62,62,209,0.06017852
Cedar Rapids-Wtrlo-IWC&Dub,52169,349,9,7,5,21,0.06017192
Seattle-Tacoma,98250,9224,202,171,182,555,0.060169124
Tallahassee-Thomasville,31625,1097,31,17,18,66,0.060164084
Champaign&Sprngfld-Decatur,62547,748,20,14,11,45,0.060160428
"Portland, OR",97231,4372,103,86,74,263,0.060155535
Bismarck-Mnt-Dcknsn(Wlstn),58483,266,8,3,5,16,0.060150376
Bismarck-Mnt-Dcknsn(Wlstn),58487,532,9,11,12,32,0.060150376
Terre Haute,62425,532,14,10,8,32,0.060150376
St. Louis,63665,266,7,6,3,16,0.060150376
Lincoln & Hastings-Krny,68318,399,12,6,6,24,0.060150376
Albuquerque-Santa Fe,87530,1064,27,19,18,64,0.060150376
Orlando-Daytona Bch-Melbrn,34737,4007,86,77,78,241,0.060144747
Charlotte,28684,1962,44,36,38,118,0.060142712
Fresno-Visalia,95338,10725,247,205,193,645,0.06013986
Burlington-Plattsburgh,12952,449,10,9,8,27,0.06013363
Pittsburgh,16059,9995,253,171,177,601,0.060130065
Quincy-Hannibal-Keokuk,63465,499,12,10,8,30,0.06012024
New York,11109,5872,31,55,267,353,0.060115804
"Tri-Cities, TN-VA",24657,183,5,3,3,11,0.06010929
Norfolk-Portsmth-Newpt Nws,27978,183,4,3,4,11,0.06010929
Traverse City-Cadillac,48647,3843,91,64,76,231,0.06010929
Duluth-Superior,56637,183,6,2,3,11,0.06010929
Rapid City,57724,183,4,3,4,11,0.06010929
Wichita-Hutchinson Plus,67572,366,10,4,8,22,0.06010929
Davenport-R.Island-Moline,61242,1065,23,23,18,64,0.060093897
Houston,78935,1065,23,22,19,64,0.060093897
Richmond-Petersburg,23065,1531,36,27,29,92,0.060091444
"Washington, DC (Hagrstwn)",22720,1115,25,20,22,67,0.060089686
Sacramnto-Stkton-Modesto,95606,233,5,4,5,14,0.060085837
Burlington-Plattsburgh,5682,1215,35,20,18,73,0.060082305
Norfolk-Portsmth-Newpt Nws,27953,982,21,14,24,59,0.060081466
Wilkes Barre-Scranton-Hztn,18616,799,19,16,13,48,0.060075094
Los Angeles,89010,283,8,6,3,17,0.060070671
Phoenix (Prescott),85545,616,13,15,9,37,0.060064935
Savannah,29941,333,7,8,5,20,0.06006006
Duluth-Superior,56623,2864,80,53,39,172,0.060055866
Norfolk-Portsmth-Newpt Nws,27959,3447,83,62,62,207,0.060052219
Des Moines-Ames,50034,383,9,6,8,23,0.060052219
Traverse City-Cadillac,49617,3264,79,51,66,196,0.06004902
Minneapolis-St. Paul,56683,583,15,9,11,35,0.060034305
Tampa-St. Pete (Sarasota),34684,27068,522,536,567,1625,0.060033988
Bismarck-Mnt-Dcknsn(Wlstn),58652,1316,36,25,18,79,0.060030395
Sacramnto-Stkton-Modesto,95922,683,20,10,11,41,0.060029283
Reno,96120,983,17,21,21,59,0.060020346
Butte-Bozeman,59086,1033,26,16,20,62,0.060019361
Rockford,61078,1333,29,30,21,80,0.060015004
Albany-Schenectady-Troy,1008,1650,37,29,33,99,0.06
New York,8528,50,1,1,1,3,0.06
Pittsburgh,15334,50,1,1,1,3,0.06
Baltimore,21647,250,4,5,6,15,0.06
Bluefield-Beckley-Oak Hill,25977,50,1,1,1,3,0.06
Birmingham (Ann and Tusc),35183,600,13,12,11,36,0.06
Evansville,47585,450,10,9,8,27,0.06
Omaha,50837,300,6,6,6,18,0.06
Sioux Falls(Mitchell),56125,50,1,1,1,3,0.06
Bismarck-Mnt-Dcknsn(Wlstn),58656,450,10,9,8,27,0.06
Bismarck-Mnt-Dcknsn(Wlstn),59344,350,11,4,6,21,0.06
Ottumwa-Kirksville,63535,50,1,1,1,3,0.06
Wichita-Hutchinson Plus,67423,250,6,4,5,15,0.06
Wichita-Hutchinson Plus,67470,500,11,10,9,30,0.06
Lincoln & Hastings-Krny,67628,100,3,1,2,6,0.06
Wichita-Hutchinson Plus,67739,250,6,4,5,15,0.06
Denver,81642,100,1,3,2,6,0.06
Mobile-Pensacola (Ft Walt),32535,6168,128,129,113,370,0.05998703
Flint-Saginaw-Bay City,48755,2951,62,51,64,177,0.059979668
Hartford & New Haven,6355,12873,262,258,252,772,0.059970481
"Jackson, MS",39656,667,14,12,14,40,0.059970015
Bismarck-Mnt-Dcknsn(Wlstn),58346,617,12,11,14,37,0.059967585
Des Moines-Ames,50271,567,13,9,12,34,0.059964727
Reno,89460,13742,331,260,233,824,0.05996216
Seattle-Tacoma,98342,1551,31,35,27,93,0.059961315
Minneapolis-St. Paul,56023,467,12,8,8,28,0.059957173
"Columbus, OH",43146,14228,360,268,225,853,0.059952207
Wilkes Barre-Scranton-Hztn,18708,11009,234,230,196,660,0.059950949
Duluth-Superior,54546,1201,27,19,26,72,0.059950042
Albuquerque-Santa Fe,87008,2469,67,42,39,148,0.059943297
Traverse City-Cadillac,49656,1735,40,34,30,104,0.059942363
Shreveport,71064,4321,90,89,80,259,0.059939829
Greensboro-H.Point-W.Salem,28627,1635,37,32,29,98,0.059938838
Fargo,56324,951,24,18,15,57,0.059936909
Fargo,58244,317,5,6,8,19,0.059936909
Charleston-Huntington,41121,1702,33,33,36,102,0.059929495
Wilkes Barre-Scranton-Hztn,18438,1285,24,25,28,77,0.059922179
Albany-Schenectady-Troy,12035,484,7,12,10,29,0.059917355
Duluth-Superior,55775,1185,22,21,28,71,0.059915612
Chattanooga,35766,217,6,4,3,13,0.059907834
Lincoln & Hastings-Krny,68441,217,5,4,4,13,0.059907834
Lubbock,79377,217,5,4,4,13,0.059907834
Lincoln & Hastings-Krny,68360,551,16,12,5,33,0.059891107
Denver,80118,6245,165,129,80,374,0.05988791
Rapid City,57531,167,3,2,5,10,0.05988024
Great Falls,59250,167,4,2,4,10,0.05988024
Denver,82832,785,20,13,14,47,0.059872611
Colorado Springs-Pueblo,81240,4660,118,90,71,279,0.059871245
Harrisonburg,26804,284,8,4,5,17,0.059859155
"Tri-Cities, TN-VA",41819,284,8,5,4,17,0.059859155
Sioux Falls(Mitchell),57422,284,7,4,6,17,0.059859155
Lincoln & Hastings-Krny,68756,2122,46,40,41,127,0.059849199
Boston (Manchester),2655,3643,78,72,68,218,0.059840791
Butte-Bozeman,59843,351,9,5,7,21,0.05982906
Lincoln & Hastings-Krny,68315,117,3,2,2,7,0.05982906
Green Bay-Appleton,54111,2173,42,41,47,130,0.059825127
Seattle-Tacoma,98339,3878,84,72,76,232,0.059824652
Phoenix (Prescott),85374,41063,858,839,759,2456,0.059810535
Binghamton,12474,1020,23,18,20,61,0.059803922
Portland-Auburn,4556,1204,32,22,18,72,0.059800664
Minneapolis-St. Paul,54893,4097,89,79,77,245,0.059799854
Norfolk-Portsmth-Newpt Nws,23149,3077,65,57,62,184,0.059798505
Boston (Manchester),3255,2174,50,43,37,130,0.059797608
Boston (Manchester),3287,1455,30,27,30,87,0.059793814
Pittsburgh,15444,502,9,10,11,30,0.059760956
Houston,78940,2008,50,37,33,120,0.059760956
Spokane,83522,2259,46,45,44,135,0.059760956
Missoula,59858,1707,45,28,29,102,0.059753954
Jacksonville,32058,4452,109,78,79,266,0.059748428
Sioux Falls(Mitchell),57051,318,7,5,7,19,0.059748428
Orlando-Daytona Bch-Melbrn,32903,13809,309,269,247,825,0.059743645
Green Bay-Appleton,54977,1155,32,24,13,69,0.05974026
Minneapolis-St. Paul,56450,1155,33,16,20,69,0.05974026
Harrisonburg,22811,519,12,9,10,31,0.05973025
Binghamton,13155,586,18,8,9,35,0.059726962
Albany-Schenectady-Troy,12059,1842,39,36,35,110,0.059717698
Seattle-Tacoma,98237,4388,102,72,88,262,0.059708295
Portland-Auburn,4237,268,5,6,5,16,0.059701493
Fargo,56734,402,8,6,10,24,0.059701493
Great Falls,59469,134,3,2,3,8,0.059701493
Dallas-Ft. Worth,76490,67,1,1,2,4,0.059701493
Casper-Riverton,82430,67,2,1,1,4,0.059701493
Salisbury,19939,7923,187,144,142,473,0.059699609
Missoula,59820,1625,40,22,35,97,0.059692308
Lincoln & Hastings-Krny,68720,486,12,7,10,29,0.059670782
Sioux Falls(Mitchell),57213,419,7,8,10,25,0.059665871
Fargo,58461,352,11,6,4,21,0.059659091
Myrtle Beach-Florence,29543,637,12,12,14,38,0.059654631
Knoxville,42635,4962,106,102,88,296,0.059653366
Great Falls,59442,1844,37,37,36,110,0.059652928
Richmond-Petersburg,22436,570,13,10,11,34,0.059649123
Charleston-Huntington,25187,503,10,11,9,30,0.059642147
Portland-Auburn,4843,5215,119,116,76,311,0.059635666
Albany-Schenectady-Troy,12134,3337,73,73,53,199,0.059634402
Burlington-Plattsburgh,12855,218,7,2,4,13,0.059633028
Missoula,59872,2616,75,37,44,156,0.059633028
Orlando-Daytona Bch-Melbrn,32168,33592,707,627,669,2003,0.059627292
Indianapolis,47448,7547,178,140,132,450,0.059626342
"Springfield, MO",65326,2130,54,47,26,127,0.059624413
Denver,69339,1325,31,23,25,79,0.059622642
Albany-Schenectady-Troy,5262,2432,59,53,33,145,0.059621711
Wausau-Rhinelander,53934,4277,100,82,73,255,0.05962123
Paducah-Cape Girard-Harsbg,63964,889,20,18,15,53,0.059617548
Seattle-Tacoma,98830,520,16,8,7,31,0.059615385
Duluth-Superior,49968,2097,50,48,27,125,0.059608965
Lincoln & Hastings-Krny,68359,1426,32,25,28,85,0.059607293
Eureka,95567,1879,42,30,40,112,0.059606173
Burlington-Plattsburgh,12943,453,11,9,7,27,0.059602649
Richmond-Petersburg,22476,302,8,4,6,18,0.059602649
Fresno-Visalia,93207,302,6,6,6,18,0.059602649
Tampa-St. Pete (Sarasota),34453,11662,246,223,226,695,0.059595267
Harrisonburg,24476,386,10,7,6,23,0.059585492
Portland-Auburn,4863,1393,28,27,28,83,0.059583632
Madison,53950,5589,127,106,100,333,0.05958132
"Portland, OR",97864,235,5,5,4,14,0.059574468
Utica,13320,1813,41,36,31,108,0.059569774
Tampa-St. Pete (Sarasota),34428,10257,220,209,182,611,0.059569075
Wichita Falls & Lawton,73549,319,10,4,5,19,0.059561129
Seattle-Tacoma,98020,20367,411,402,400,1213,0.059557127
Watertown,13625,2183,58,39,33,130,0.059551077
Spokane,83871,2116,59,36,31,126,0.059546314
Sioux Falls(Mitchell),57441,571,15,8,11,34,0.059544658
Savannah,29926,24103,562,499,374,1435,0.059536157
Sacramnto-Stkton-Modesto,96146,1075,20,13,31,64,0.059534884
Wichita-Hutchinson Plus,66866,1579,36,27,31,94,0.059531349
Mobile-Pensacola (Ft Walt),36561,9693,226,183,168,577,0.059527494
Burlington-Plattsburgh,3282,840,19,14,17,50,0.05952381
Charlotte,28617,2268,44,43,48,135,0.05952381
Wichita-Hutchinson Plus,67658,84,3,1,1,5,0.05952381
Wichita-Hutchinson Plus,67673,84,3,1,1,5,0.05952381
Chico-Redding,96104,504,13,11,6,30,0.05952381
Seattle-Tacoma,98593,1260,27,26,22,75,0.05952381
Orlando-Daytona Bch-Melbrn,32141,18414,399,337,360,1096,0.05951993
Philadelphia,18930,2504,52,56,41,149,0.059504792
Pittsburgh,21538,605,15,7,14,36,0.059504132
Des Moines-Ames,50518,353,10,5,6,21,0.059490085
Wichita-Hutchinson Plus,67491,353,9,7,5,21,0.059490085
Albuquerque-Santa Fe,88341,622,19,8,10,37,0.059485531
Traverse City-Cadillac,49733,1698,40,30,31,101,0.059481743
Des Moines-Ames,50557,723,17,14,12,43,0.059474412
Boston (Manchester),3607,370,11,7,4,22,0.059459459
Great Falls,59480,370,10,6,6,22,0.059459459
Lincoln & Hastings-Krny,68357,370,9,6,7,22,0.059459459
Wichita Falls & Lawton,73539,185,6,2,3,11,0.059459459
Burlington-Plattsburgh,5161,656,18,12,9,39,0.05945122
Oklahoma City,73038,1531,33,28,30,91,0.059438276
Charlotte,28611,673,13,14,13,40,0.059435364
Rapid City,57787,387,12,6,5,23,0.059431525
Omaha,51542,875,19,18,15,52,0.059428571
Minneapolis-St. Paul,55370,875,22,19,11,52,0.059428571
Richmond-Petersburg,23868,6226,120,131,119,370,0.059428204
Austin,78949,488,11,8,10,29,0.05942623
Spokane,83823,1565,45,24,24,93,0.05942492
Little Rock-Pine Bluff,72017,589,15,10,10,35,0.05942275
Norfolk-Portsmth-Newpt Nws,23432,1279,23,22,31,76,0.059421423
Champaign&Sprngfld-Decatur,61876,690,16,10,15,41,0.05942029
Traverse City-Cadillac,49718,791,14,17,16,47,0.059418458
Greenvll-Spart-Ashevll-And,28773,3265,63,66,65,194,0.05941807
Philadelphia,8511,909,21,14,19,54,0.059405941
Butte-Bozeman,59736,101,2,2,2,6,0.059405941
Lincoln & Hastings-Krny,68759,202,5,3,4,12,0.059405941
Lincoln & Hastings-Krny,68813,505,11,9,10,30,0.059405941
Denver,80721,101,3,2,1,6,0.059405941
Casper-Riverton,82310,101,2,2,2,6,0.059405941
Albuquerque-Santa Fe,88321,202,4,4,4,12,0.059405941
St. Louis,62049,8048,188,155,135,478,0.059393638
Roanoke-Lynchburg,24351,522,8,11,12,31,0.059386973
Bismarck-Mnt-Dcknsn(Wlstn),58651,421,12,8,5,25,0.059382423
Hartford & New Haven,6796,1162,18,24,27,69,0.059380379
Spokane,99161,1482,40,31,17,88,0.059379217
Burlington-Plattsburgh,12955,320,7,6,6,19,0.059375
Fargo,58032,640,15,9,14,38,0.059375
Boston (Manchester),1503,3655,71,70,76,217,0.059370725
Spokane,59923,11353,279,194,201,674,0.059367568
Minneapolis-St. Paul,55072,4127,80,81,84,245,0.059365156
Roanoke-Lynchburg,24313,876,20,16,16,52,0.059360731
Little Rock-Pine Bluff,72003,657,13,12,14,39,0.059360731
Orlando-Daytona Bch-Melbrn,32667,4178,83,82,83,248,0.059358545
Traverse City-Cadillac,49759,1550,28,33,31,92,0.059354839
Greenvll-Spart-Ashevll-And,29689,4482,87,78,101,266,0.059348505
Burlington-Plattsburgh,5828,2140,57,39,31,127,0.059345794
La Crosse-Eau Claire,55925,910,21,19,14,54,0.059340659
Bismarck-Mnt-Dcknsn(Wlstn),58456,573,15,9,10,34,0.059336824
Dallas-Ft. Worth,75855,2309,50,44,43,137,0.059333045
Minneapolis-St. Paul,56385,809,22,16,10,48,0.059332509
Utica,13450,118,2,3,2,7,0.059322034
Great Falls,59418,118,3,2,2,7,0.059322034
Paducah-Cape Girard-Harsbg,62976,354,6,9,6,21,0.059322034
Houston,78931,236,6,4,4,14,0.059322034
Chico-Redding,96071,118,3,2,2,7,0.059322034
"Portland, OR",97759,8749,225,155,139,519,0.059321065
Omaha,68716,843,23,14,13,50,0.059311981
Denver,69346,860,20,15,16,51,0.059302326
Traverse City-Cadillac,49621,3204,73,57,60,190,0.059300874
New York,12406,624,13,11,13,37,0.059294872
Sioux Falls(Mitchell),57452,253,7,4,4,15,0.059288538
"Springfield, MO",72520,253,7,4,4,15,0.059288538
Colorado Springs-Pueblo,80813,506,7,12,11,30,0.059288538
Rochestr-Mason City-Austin,50424,1400,36,24,23,83,0.059285714
Charleston-Huntington,25650,388,8,7,8,23,0.059278351
Orlando-Daytona Bch-Melbrn,32174,56655,1222,1101,1035,3358,0.059271026
Buffalo,14113,658,10,13,16,39,0.059270517
Portland-Auburn,3903,6766,158,117,126,401,0.059266923
Burlington-Plattsburgh,5762,540,16,9,7,32,0.059259259
Duluth-Superior,56653,1215,30,20,22,72,0.059259259
Rapid City,57651,135,3,2,3,8,0.059259259
St. Louis,62070,135,4,2,2,8,0.059259259
Chico-Redding,96047,540,13,11,8,32,0.059259259
Sioux City,51364,692,18,8,15,41,0.059248555
Hartford & New Haven,6031,1401,32,29,22,83,0.059243398
Omaha,68376,1266,26,28,21,75,0.059241706
Fargo,58225,996,15,16,28,59,0.059236948
Phoenix (Prescott),85935,3984,98,64,74,236,0.059236948
Norfolk-Portsmth-Newpt Nws,23883,2178,41,41,47,129,0.05922865
Richmond-Petersburg,22576,1621,34,27,35,96,0.059222702
Harlingen-Wslco-Brnsvl-Mca,78597,2398,51,44,47,142,0.059216013
Fargo,58273,304,7,4,7,18,0.059210526
Lincoln & Hastings-Krny,68458,152,4,2,3,9,0.059210526
Tucson (Sierra Vista),85650,14896,398,277,207,882,0.059210526
Davenport-R.Island-Moline,52649,929,20,20,15,55,0.059203445
Seattle-Tacoma,98564,2669,60,49,49,158,0.059198202
Marquette,49884,473,12,9,7,28,0.059196617
Lincoln & Hastings-Krny,68835,473,12,9,7,28,0.059196617
Pittsburgh,15459,1301,27,25,25,77,0.059185242
Pittsburgh,16374,1808,40,37,30,107,0.059181416
Eugene,97434,659,17,12,10,39,0.059180577
Traverse City-Cadillac,49780,2822,65,62,40,167,0.059177888
Portland-Auburn,3890,845,19,13,18,50,0.059171598
Omaha,51550,169,4,3,3,10,0.059171598
Omaha,51647,169,4,3,3,10,0.059171598
Pittsburgh,15362,693,16,14,11,41,0.059163059
Sioux Falls(Mitchell),57345,1048,14,21,27,62,0.059160305
Pittsburgh,15450,355,9,7,5,21,0.05915493
Buffalo,14753,1082,21,21,22,64,0.059149723
St. Louis,62065,186,6,3,2,11,0.059139785
St. Louis,62244,930,19,19,17,55,0.059139785
Portland-Auburn,3875,761,15,15,15,45,0.05913272
Medford-Klamath Falls,97523,6985,156,133,124,413,0.0591267
Watertown,13640,389,10,5,8,23,0.059125964
Fargo,58031,389,10,5,8,23,0.059125964
Burlington-Plattsburgh,5035,592,9,14,12,35,0.059121622
Casper-Riverton,82443,4449,106,81,76,263,0.059114408
"Portland, OR",97825,203,3,4,5,12,0.0591133
Green Bay-Appleton,54979,1303,26,21,30,77,0.059094398
Baltimore,21679,440,11,9,6,26,0.059090909
Hartford & New Haven,6783,2217,55,32,44,131,0.059088859
Little Rock-Pine Bluff,71957,2894,66,49,56,171,0.059087768
Montgomery-Selma,36069,1574,30,29,34,93,0.059085133
Billings,59001,1388,35,23,24,82,0.05907781
Davenport-R.Island-Moline,61036,6942,150,133,127,410,0.059060789
Providence-New Bedford,2835,5503,142,93,90,325,0.059058695
Utica,12036,254,5,4,6,15,0.059055118
Wichita-Hutchinson Plus,67464,1016,23,15,22,60,0.059055118
Tampa-St. Pete (Sarasota),33875,11955,270,226,210,706,0.059054789
Boston (Manchester),1464,7451,156,139,145,440,0.059052476
Green Bay-Appleton,53057,1558,40,20,32,92,0.059050064
Albuquerque-Santa Fe,88025,525,12,11,8,31,0.059047619
Yakima-Pasco-Rchlnd-Knnwck,98922,7130,150,134,137,421,0.059046283
Minneapolis-St. Paul,56271,1321,28,28,22,78,0.059046177
Erie,16424,4336,94,95,67,256,0.05904059
"Springfield, MO",65627,542,9,12,11,32,0.05904059
Norfolk-Portsmth-Newpt Nws,27964,559,16,8,9,33,0.059033989
La Crosse-Eau Claire,54624,1440,34,28,23,85,0.059027778
Eugene,97461,864,22,16,13,51,0.059027778
Paducah-Cape Girard-Harsbg,62928,593,13,12,10,35,0.059021922
Idaho Fals-Pocatllo(Jcksn),83429,898,28,17,8,53,0.059020045
Eugene,97480,305,5,8,5,18,0.059016393
Jacksonville,32033,5000,117,92,86,295,0.059
Norfolk-Portsmth-Newpt Nws,23021,339,7,7,6,20,0.05899705
New York,12748,2102,46,34,44,124,0.058991437
New York,18435,1068,24,15,24,63,0.058988764
Greenvll-Spart-Ashevll-And,28735,356,9,7,5,21,0.058988764
Fargo,58231,356,8,5,8,21,0.058988764
Davenport-R.Island-Moline,61256,1780,40,33,32,105,0.058988764
Great Falls,59241,390,10,5,8,23,0.058974359
Oklahoma City,73058,390,10,6,7,23,0.058974359
Pittsburgh,26562,797,18,16,13,47,0.058971142
Traverse City-Cadillac,49749,4070,85,79,76,240,0.058968059
Atlanta,30559,5122,99,99,104,302,0.058961343
Kansas City,64740,1849,47,34,28,109,0.058950784
Cedar Rapids-Wtrlo-IWC&Dub,52171,950,24,14,18,56,0.058947368
San Francisco-Oak-San Jose,95441,1917,45,37,31,113,0.05894627
Sherman-Ada,76245,2019,49,35,35,119,0.058940069
Waco-Temple-Bryan,76687,1527,41,26,23,90,0.058939096
Seattle-Tacoma,98267,543,5,13,14,32,0.05893186
Minneapolis-St. Paul,56468,4871,109,94,84,287,0.05892014
Burlington-Plattsburgh,12942,628,15,13,9,37,0.058917197
"Washington, DC (Hagrstwn)",25434,1290,25,23,28,76,0.058914729
Binghamton,13801,1307,33,23,21,77,0.058913542
Boise,83631,1358,31,27,22,80,0.058910162
Burlington-Plattsburgh,5660,2054,46,37,38,121,0.058909445
New York,12494,713,18,12,12,42,0.058906031
Quincy-Hannibal-Keokuk,61450,1443,32,24,29,85,0.058905059
Bangor,4472,2207,50,35,45,130,0.058903489
"Springfield, MO",72529,4924,115,97,78,290,0.058895207
Rochestr-Mason City-Austin,55918,1002,22,17,20,59,0.058882236
Los Angeles,92536,4093,83,69,89,241,0.058881016
Wichita-Hutchinson Plus,67548,1359,35,26,19,80,0.058866814
San Diego,91917,1767,37,32,35,104,0.058856819
Orlando-Daytona Bch-Melbrn,33513,12728,292,234,223,749,0.058846637
Portland-Auburn,4347,2635,44,40,71,155,0.058823529
Bangor,4777,391,10,7,6,23,0.058823529
Albany-Schenectady-Troy,12115,51,1,1,1,3,0.058823529
New York,12787,85,2,1,2,5,0.058823529
Burlington-Plattsburgh,12857,510,14,9,7,30,0.058823529
Watertown,13687,204,6,3,3,12,0.058823529
"Rochester, NY",14441,289,6,4,7,17,0.058823529
Pittsburgh,15316,102,2,2,2,6,0.058823529
Clarksburg-Weston,26443,187,5,4,2,11,0.058823529
Montgomery-Selma,36759,1326,31,30,17,78,0.058823529
"Jackson, MS",39088,68,1,1,2,4,0.058823529
Lexington,41310,17,1,0,0,1,0.058823529
Cedar Rapids-Wtrlo-IWC&Dub,50608,17,1,0,0,1,0.058823529
Sioux Falls(Mitchell),57584,119,3,2,2,7,0.058823529
Fargo,58067,255,6,3,6,15,0.058823529
Bismarck-Mnt-Dcknsn(Wlstn),58711,204,4,2,6,12,0.058823529
Billings,59055,34,1,1,0,2,0.058823529
Billings,59058,51,1,1,1,3,0.058823529
Terre Haute,62478,306,8,5,5,18,0.058823529
Kansas City,64499,153,3,2,4,9,0.058823529
Columbia-Jefferson City,64676,136,4,2,2,8,0.058823529
"Springfield, MO",65650,1411,32,23,28,83,0.058823529
Joplin-Pittsburg,66711,561,13,7,13,33,0.058823529
Wichita-Hutchinson Plus,67521,136,3,3,2,8,0.058823529
Sherman-Ada,73488,34,1,1,0,2,0.058823529
Joplin-Pittsburg,74360,51,1,1,1,3,0.058823529
Waco-Temple-Bryan,76870,51,1,1,1,3,0.058823529
Abilene-Sweetwater,76873,85,2,2,1,5,0.058823529
Casper-Riverton,82646,34,1,0,1,2,0.058823529
Albuquerque-Santa Fe,87733,170,4,2,4,10,0.058823529
Bakersfield,93287,119,3,2,2,7,0.058823529
San Francisco-Oak-San Jose,94972,102,2,2,2,6,0.058823529
Reno,96123,51,2,0,1,3,0.058823529
Spokane,99167,867,22,12,17,51,0.058823529
Ft. Myers-Naples,33912,19298,309,401,425,1135,0.058814385
Traverse City-Cadillac,49751,1939,41,33,40,114,0.058793192
Pittsburgh,15340,1293,31,21,24,76,0.058778036
Hartford & New Haven,6488,19894,438,421,310,1169,0.058761436
Green Bay-Appleton,54161,2825,65,54,47,166,0.058761062
Duluth-Superior,54835,936,24,17,14,55,0.058760684
New York,10524,4527,121,85,60,266,0.05875856
Missoula,59846,1685,45,28,26,99,0.058753709
Hartford & New Haven,6409,800,18,15,14,47,0.05875
San Antonio,78133,23337,537,434,400,1371,0.058747911
Des Moines-Ames,50157,749,18,15,11,44,0.058744993
Minneapolis-St. Paul,54859,2043,41,42,37,120,0.058737151
Traverse City-Cadillac,49779,4665,103,76,95,274,0.058735263
Sioux Falls(Mitchell),57073,664,14,16,9,39,0.05873494
Wilkes Barre-Scranton-Hztn,18470,1975,41,40,35,116,0.058734177
Bangor,4848,579,11,13,10,34,0.058721934
Ottumwa-Kirksville,52626,1158,26,20,22,68,0.058721934
Topeka,66833,528,10,11,10,31,0.058712121
Austin,78645,16215,388,312,252,952,0.05871107
Butte-Bozeman,59721,511,13,9,8,30,0.058708415
Phoenix (Prescott),85248,39572,856,772,695,2323,0.058703123
"Washington, DC (Hagrstwn)",22749,477,12,8,8,28,0.05870021
Sacramnto-Stkton-Modesto,95637,426,9,7,9,25,0.058685446
"Portland, OR",97346,852,19,16,15,50,0.058685446
Wheeling-Steubenville,45746,409,10,9,5,24,0.058679707
Austin,78643,6953,168,117,123,408,0.058679707
Utica,13403,6664,168,131,92,391,0.058673469
Burlington-Plattsburgh,12996,1858,37,18,54,109,0.058665231
Albuquerque-Santa Fe,87547,5848,145,103,95,343,0.058652531
Atlanta,30512,24739,536,439,476,1451,0.05865233
Macon,31091,3666,75,75,65,215,0.058647027
Boston (Manchester),3447,2643,63,45,47,155,0.058645479
Tampa-St. Pete (Sarasota),34222,14955,329,298,250,877,0.058642594
Wichita-Hutchinson Plus,67142,324,8,6,5,19,0.058641975
Reno,89703,11272,241,211,209,661,0.05864088
Topeka,66933,307,6,5,7,18,0.058631922
Traverse City-Cadillac,49755,1791,35,37,33,105,0.058626466
Hartford & New Haven,6378,5271,106,110,93,309,0.058622652
Omaha,68337,290,6,6,5,17,0.05862069
Santabarbra-Sanmar-Sanluob,93402,14381,285,292,266,843,0.058619011
Burlington-Plattsburgh,12923,546,10,10,12,32,0.058608059
Fargo,58049,273,8,4,4,16,0.058608059
Champaign&Sprngfld-Decatur,62438,273,6,6,4,16,0.058608059
"Springfield, MO",63941,273,6,5,5,16,0.058608059
Orlando-Daytona Bch-Melbrn,34748,50344,1004,970,976,2950,0.058596854
Portland-Auburn,4966,1502,37,26,25,88,0.058588549
Medford-Klamath Falls,97522,734,18,13,12,43,0.058583106
Wilkes Barre-Scranton-Hztn,18347,3790,78,67,77,222,0.058575198
Sioux City,51056,461,8,9,10,27,0.05856833
Marquette,49862,4542,109,79,78,266,0.058564509
Seattle-Tacoma,98283,444,4,11,11,26,0.058558559
Spokane,83809,410,11,7,6,24,0.058536585
Boston (Manchester),3043,1606,41,27,26,94,0.058530511
Spokane,98849,1196,30,20,20,70,0.058528428
Hartford & New Haven,6027,1384,32,28,21,81,0.058526012
Lincoln & Hastings-Krny,68978,2153,48,43,35,126,0.058522991
Davenport-R.Island-Moline,61436,769,19,15,11,45,0.058517555
Minneapolis-St. Paul,56021,1060,26,15,21,62,0.058490566
Bluefield-Beckley-Oak Hill,24993,171,3,2,5,10,0.058479532
St. Louis,62268,684,15,14,11,40,0.058479532
Abilene-Sweetwater,76845,171,5,3,2,10,0.058479532
Fargo,58041,1522,40,21,28,89,0.05847569
Phoenix (Prescott),86426,16726,367,301,310,978,0.05847184
St. Louis,62027,667,14,14,11,39,0.058470765
Johnstown-Altoona-St Colge,16845,992,17,16,25,58,0.058467742
St. Louis,62037,1813,40,36,30,106,0.05846663
Kansas City,64113,11700,292,205,187,684,0.058461538
Augusta-Aiken,30668,1779,37,35,32,104,0.058459809
Raleigh-Durham (Fayetvlle),27862,804,17,10,20,47,0.058457711
Portland-Auburn,3864,2087,51,39,32,122,0.058457115
Des Moines-Ames,50048,787,18,15,13,46,0.058449809
Wilkes Barre-Scranton-Hztn,18463,154,3,3,3,9,0.058441558
Missoula,59853,924,27,18,9,54,0.058441558
Las Vegas,89027,20417,416,421,356,1193,0.058431699
Rochestr-Mason City-Austin,56043,445,10,10,6,26,0.058426966
Lincoln & Hastings-Krny,68820,445,11,8,7,26,0.058426966
Raleigh-Durham (Fayetvlle),27509,6710,134,132,126,392,0.058420268
Topeka,66830,291,6,6,5,17,0.058419244
Idaho Fals-Pocatllo(Jcksn),83466,291,7,5,5,17,0.058419244
Bangor,4622,1301,30,24,22,76,0.058416603
Topeka,66948,428,12,5,8,25,0.058411215
Pittsburgh,15349,1558,32,30,29,91,0.058408216
West Palm Beach-Ft. Pierce,33418,45561,888,851,922,2661,0.058405215
Portland-Auburn,3588,1644,33,30,33,96,0.058394161
New York,12455,1781,43,23,38,104,0.058394161
Greenville-N.Bern-Washngtn,28552,137,3,3,2,8,0.058394161
Duluth-Superior,55771,1507,42,25,21,88,0.058394161
Topeka,66438,274,7,3,6,16,0.058394161
Topeka,67417,137,3,2,3,8,0.058394161
Amarillo,88427,137,4,1,3,8,0.058394161
"Washington, DC (Hagrstwn)",21779,942,22,17,16,55,0.058386412
Wichita-Hutchinson Plus,67578,1268,25,22,27,74,0.058359621
Eugene,97486,634,15,12,10,37,0.058359621
Phoenix (Prescott),85258,25178,464,484,521,1469,0.058344587
Traverse City-Cadillac,49788,4902,98,99,89,286,0.058343533
Boston (Manchester),2056,11690,282,238,162,682,0.058340462
Wilkes Barre-Scranton-Hztn,18350,1440,29,23,32,84,0.058333333
Roanoke-Lynchburg,24920,360,10,6,5,21,0.058333333
Quincy-Hannibal-Keokuk,63457,240,6,5,3,14,0.058333333
Albuquerque-Santa Fe,87831,120,3,2,2,7,0.058333333
Spokane,98833,240,4,5,5,14,0.058333333
Tampa-St. Pete (Sarasota),33761,17882,350,348,345,1043,0.058326809
Elmira (Corning),14818,1766,42,32,29,103,0.058323896
Shreveport,71040,7973,182,146,137,465,0.058321836
Baltimore,20751,2264,42,36,54,132,0.058303887
Albany-Schenectady-Troy,1026,1012,17,20,22,59,0.058300395
Erie,16329,446,11,7,8,26,0.058295964
Marquette,49822,223,6,4,3,13,0.058295964
Topeka,67466,669,14,12,13,39,0.058295964
Lincoln & Hastings-Krny,67638,223,6,3,4,13,0.058295964
Nashville,38222,2642,61,50,43,154,0.058289175
New York,12719,875,16,15,20,51,0.058285714
Portland-Auburn,4353,2351,52,44,41,137,0.058273075
Pittsburgh,15777,103,3,2,1,6,0.058252427
Norfolk-Portsmth-Newpt Nws,23056,103,2,2,2,6,0.058252427
Bismarck-Mnt-Dcknsn(Wlstn),58625,206,5,4,3,12,0.058252427
Kansas City,64166,309,6,7,5,18,0.058252427
Lincoln & Hastings-Krny,68416,206,6,2,4,12,0.058252427
Dallas-Ft. Worth,75412,618,15,8,13,36,0.058252427
Salt Lake City,82922,206,5,3,4,12,0.058252427
Albuquerque-Santa Fe,87009,103,2,2,2,6,0.058252427
Anchorage,99540,309,7,5,6,18,0.058252427
Burlington-Plattsburgh,5832,910,24,14,15,53,0.058241758
Portland-Auburn,3894,6731,164,124,104,392,0.058238003
Lincoln & Hastings-Krny,69032,498,7,5,17,29,0.058232932
Dallas-Ft. Worth,76484,893,20,17,15,52,0.058230683
Wichita Falls & Lawton,73530,395,7,7,9,23,0.058227848
Presque Isle,4746,378,8,9,5,22,0.058201058
La Crosse-Eau Claire,54748,1134,28,19,19,66,0.058201058
Portland-Auburn,4947,1787,37,30,37,104,0.058198097
Sacramnto-Stkton-Modesto,95635,1220,26,19,26,71,0.058196721
Fargo,56524,739,18,13,12,43,0.058186739
Madison,54457,8697,206,140,160,506,0.058180982
Norfolk-Portsmth-Newpt Nws,27942,636,17,14,6,37,0.058176101
Portland-Auburn,4555,1805,39,31,35,105,0.058171745
Norfolk-Portsmth-Newpt Nws,23354,361,8,6,7,21,0.058171745
Rapid City,57744,2527,67,46,34,147,0.058171745
Fargo,58061,361,9,5,7,21,0.058171745
Cedar Rapids-Wtrlo-IWC&Dub,52225,447,14,8,4,26,0.058165548
Pittsburgh,15860,1066,23,22,17,62,0.058161351
Pittsburgh,26525,9130,145,158,228,531,0.058159912
Sioux Falls(Mitchell),57037,877,21,15,15,51,0.058152794
New York,12776,2098,49,34,39,122,0.05815062
Utica,13315,1204,26,21,23,70,0.058139535
Chattanooga,28781,860,16,15,19,50,0.058139535
Rapid City,57779,430,12,7,6,25,0.058139535
Fargo,58311,86,2,1,2,5,0.058139535
Denver,69127,688,18,11,11,40,0.058139535
Denver,81325,172,4,4,2,10,0.058139535
Medford-Klamath Falls,95568,172,4,3,3,10,0.058139535
Traverse City-Cadillac,49746,3406,66,66,66,198,0.058132707
New York,10968,2357,40,42,55,137,0.058124735
Hartford & New Haven,6423,4955,105,97,86,288,0.058123108
Burlington-Plattsburgh,5760,1170,20,16,32,68,0.058119658
Miami-Ft. Lauderdale,33037,13887,281,260,266,807,0.058111903
Flint-Saginaw-Bay City,48725,1979,38,41,36,115,0.058110157
Raleigh-Durham (Fayetvlle),27853,327,7,5,7,19,0.058103976
Sioux Falls(Mitchell),57249,895,21,12,19,52,0.058100559
Johnstown-Altoona-St Colge,15530,7074,133,152,126,411,0.058100085
Bakersfield,93531,568,15,6,12,33,0.058098592
St. Louis,62233,7936,183,143,135,461,0.058089718
Boise,83670,637,17,12,8,37,0.058084772
"Rochester, NY",14543,2703,58,53,46,157,0.058083611
Sioux Falls(Mitchell),57040,396,6,9,8,23,0.058080808
Minneapolis-St. Paul,56381,2600,60,35,56,151,0.058076923
Phoenix (Prescott),85215,15878,319,288,315,922,0.058067767
Champaign&Sprngfld-Decatur,61735,310,6,7,5,18,0.058064516
Houston,78950,2239,54,38,38,130,0.058061635
Burlington-Plattsburgh,3251,1688,30,32,36,98,0.058056872
Nashville,37078,689,14,12,14,40,0.058055152
Bismarck-Mnt-Dcknsn(Wlstn),58341,2291,47,49,37,133,0.058053252
Madison,53920,379,10,5,7,22,0.058047493
Kansas City,66033,758,24,10,10,44,0.058047493
Boise,83633,379,11,7,4,22,0.058047493
Portland-Auburn,3872,4273,72,81,95,248,0.058038849
Lincoln & Hastings-Krny,68947,448,12,4,10,26,0.058035714
San Angelo,76852,224,5,4,4,13,0.058035714
Seattle-Tacoma,98552,448,11,7,8,26,0.058035714
Tampa-St. Pete (Sarasota),34465,19059,408,330,368,1106,0.058030327
Buffalo,14884,293,7,6,4,17,0.058020478
Idaho Fals-Pocatllo(Jcksn),83226,2482,62,44,38,144,0.058017728
Panama City,32440,7481,173,144,117,434,0.058013635
Bismarck-Mnt-Dcknsn(Wlstn),58531,431,11,7,7,25,0.05800464
"Springfield, MO",72519,3345,62,63,69,194,0.05799701
St. Louis,63673,1983,46,35,34,115,0.05799294
San Diego,91962,1983,44,38,33,115,0.05799294
Philadelphia,8203,7623,130,162,150,442,0.057982422
Fargo,58455,276,7,5,4,16,0.057971014
Wichita-Hutchinson Plus,67635,138,4,2,2,8,0.057971014
Denver,82325,966,29,19,8,56,0.057971014
"Portland, OR",97752,138,3,2,3,8,0.057971014
Rochestr-Mason City-Austin,55949,1915,49,28,34,111,0.057963446
Ft. Myers-Naples,34105,16252,296,342,304,942,0.057962097
Bismarck-Mnt-Dcknsn(Wlstn),58563,2036,45,33,40,118,0.057956778
Sacramnto-Stkton-Modesto,95346,1018,21,15,23,59,0.057956778
Clarksburg-Weston,25267,673,16,13,10,39,0.05794948
Sacramnto-Stkton-Modesto,95960,604,13,9,13,35,0.05794702
Austin,76856,3521,81,57,66,204,0.057938086
Bluefield-Beckley-Oak Hill,24715,397,10,7,6,23,0.057934509
Minneapolis-St. Paul,56435,2503,59,43,43,145,0.057930483
"Springfield, MO",65727,259,6,3,6,15,0.057915058
Fargo,58492,449,9,11,6,26,0.057906459
Madison,53561,2107,54,35,33,122,0.057902231
Philadelphia,18972,3316,70,66,56,192,0.057901086
Panama City,32328,4249,104,69,73,246,0.057895976
Burlington-Plattsburgh,5355,570,13,11,9,33,0.057894737
Richmond-Petersburg,23176,760,17,13,14,44,0.057894737
Bismarck-Mnt-Dcknsn(Wlstn),58580,380,7,9,6,22,0.057894737
Spokane,99017,190,5,4,2,11,0.057894737
Seattle-Tacoma,98333,4025,103,81,49,233,0.057888199
"Springfield, MO",72623,691,16,15,9,40,0.05788712
Amarillo,79034,501,13,8,8,29,0.057884232
Duluth-Superior,54849,1935,42,38,32,112,0.057881137
Bangor,4451,311,6,7,5,18,0.057877814
Lincoln & Hastings-Krny,68665,674,11,15,13,39,0.057863501
"Portland, OR",97367,11926,221,214,255,690,0.057856783
Des Moines-Ames,50516,726,16,12,14,42,0.05785124
Quincy-Hannibal-Keokuk,61452,242,6,5,3,14,0.05785124
Paducah-Cape Girard-Harsbg,63783,121,3,2,2,7,0.05785124
Columbia-Jefferson City,65286,121,3,2,2,7,0.05785124
Richmond-Petersburg,23936,8021,186,146,132,464,0.057848149
Columbia-Jefferson City,63558,778,20,12,13,45,0.057840617
Eugene,97429,640,20,10,7,37,0.0578125
Denver,80512,1972,48,35,31,114,0.057809331
Spokane,83860,7871,183,133,139,455,0.05780714
Baltimore,21156,346,4,8,8,20,0.057803468
Topeka,66544,346,7,7,6,20,0.057803468
San Francisco-Oak-San Jose,94576,173,3,2,5,10,0.057803468
Tampa-St. Pete (Sarasota),34231,30509,617,574,572,1763,0.057786227
Greenvll-Spart-Ashevll-And,28729,3323,63,67,62,192,0.057779115
Portland-Auburn,3813,3998,92,75,64,231,0.057778889
Baltimore,21082,675,17,13,9,39,0.057777778
Bismarck-Mnt-Dcknsn(Wlstn),58442,450,14,4,8,26,0.057777778
"Washington, DC (Hagrstwn)",26801,1281,24,21,29,74,0.057767369
New York,12777,779,17,14,14,45,0.057766367
Seattle-Tacoma,98136,15961,318,280,324,922,0.057765804
Burlington-Plattsburgh,5747,277,7,6,3,16,0.057761733
St. Joseph,64480,329,7,8,4,19,0.05775076
Burlington-Plattsburgh,5769,1420,35,23,24,82,0.057746479
Cleveland-Akron (Canton),44702,1091,12,17,34,63,0.057745188
Burlington-Plattsburgh,5820,381,9,6,7,22,0.057742782
Salt Lake City,82923,381,9,7,6,22,0.057742782
Fargo,58243,433,9,8,8,25,0.057736721
Reno,93517,641,12,9,16,37,0.057722309
Louisville,47175,797,12,17,17,46,0.057716437
Spokane,97828,3448,83,77,39,199,0.057714617
Burlington-Plattsburgh,12853,1473,28,27,30,85,0.057705363
Medford-Klamath Falls,97544,2461,54,43,45,142,0.057700122
Greenvll-Spart-Ashevll-And,28782,6101,128,115,109,352,0.05769546
Providence-New Bedford,2875,52,1,1,1,3,0.057692308
Wilkes Barre-Scranton-Hztn,18817,52,1,1,1,3,0.057692308
Clarksburg-Weston,26161,364,8,7,6,21,0.057692308
Panama City,32430,1092,20,19,24,63,0.057692308
Lexington,41351,52,1,1,1,3,0.057692308
Duluth-Superior,55725,104,2,2,2,6,0.057692308
Rochestr-Mason City-Austin,56089,156,5,2,2,9,0.057692308
Fargo,58238,156,3,3,3,9,0.057692308
Bismarck-Mnt-Dcknsn(Wlstn),58838,208,5,4,3,12,0.057692308
St. Louis,63330,104,2,2,2,6,0.057692308
St. Louis,63675,104,3,2,1,6,0.057692308
Kansas City,64441,156,3,2,4,9,0.057692308
Wichita-Hutchinson Plus,67751,208,5,3,4,12,0.057692308
Lincoln & Hastings-Krny,69042,104,1,3,2,6,0.057692308
Eugene,97489,624,14,11,11,36,0.057692308
Greenville-N.Bern-Washngtn,28515,2774,59,48,53,160,0.057678443
"Tri-Cities, TN-VA",24378,1075,19,21,22,62,0.057674419
Presque Isle,4785,2324,48,50,36,134,0.057659208
San Antonio,78055,1717,41,33,25,99,0.057658707
Spokane,59935,3677,92,73,47,212,0.057655698
Columbia-Jefferson City,65072,1787,41,25,37,103,0.0576385
Albuquerque-Santa Fe,87048,8902,192,186,135,513,0.057627499
Fargo,58433,1076,28,15,19,62,0.057620818
Raleigh-Durham (Fayetvlle),23927,4218,93,74,76,243,0.057610242
Albany-Schenectady-Troy,1235,2795,46,55,60,161,0.057602862
Traverse City-Cadillac,49615,4323,75,89,85,249,0.05759889
"Springfield, MO",65768,816,5,16,26,47,0.057598039
Sioux City,51006,1007,26,14,18,58,0.057596822
Burlington-Plattsburgh,5362,191,5,2,4,11,0.057591623
Pittsburgh,15015,1146,29,24,13,66,0.057591623
Duluth-Superior,55784,191,4,4,3,11,0.057591623
Sioux Falls(Mitchell),57576,191,3,3,5,11,0.057591623
Austin,76842,191,5,3,3,11,0.057591623
Binghamton,12430,903,22,17,13,52,0.057585825
Minneapolis-St. Paul,54006,903,23,15,14,52,0.057585825
Greenvll-Spart-Ashevll-And,28722,6252,130,115,115,360,0.057581574
Albuquerque-Santa Fe,81328,4446,101,75,80,256,0.057579847
Seattle-Tacoma,98377,2119,49,35,38,122,0.057574328
Lincoln & Hastings-Krny,66952,469,14,6,7,27,0.057569296
Fargo,58265,417,8,9,7,24,0.057553957
Oklahoma City,73729,556,12,8,12,32,0.057553957
Traverse City-Cadillac,49776,1981,43,34,37,114,0.057546694
Traverse City-Cadillac,49719,1286,29,23,22,74,0.057542768
Lincoln & Hastings-Krny,67646,643,17,11,9,37,0.057542768
Wilkes Barre-Scranton-Hztn,18818,1008,19,19,20,58,0.057539683
Fargo,58214,365,11,6,4,21,0.057534247
Lincoln & Hastings-Krny,68958,591,18,7,9,34,0.057529611
New York,7851,226,4,4,5,13,0.057522124
Houston,77359,678,10,12,17,39,0.057522124
Binghamton,13782,765,15,13,16,44,0.05751634
Sacramnto-Stkton-Modesto,95703,1843,31,43,32,106,0.057514921
Sacramnto-Stkton-Modesto,95335,539,11,9,11,31,0.057513915
Alpena,48740,2556,58,40,49,147,0.057511737
Johnstown-Altoona-St Colge,16836,1026,17,17,25,59,0.057504873
Corpus Christi,78373,3044,65,55,55,175,0.057490145
Harrisburg-Lncstr-Leb-York,17021,922,22,17,14,53,0.057483731
Wausau-Rhinelander,54548,5637,125,97,102,324,0.057477382
Green Bay-Appleton,54943,1966,49,36,28,113,0.057477111
Richmond-Petersburg,22509,87,2,1,2,5,0.057471264
Cedar Rapids-Wtrlo-IWC&Dub,52232,174,4,3,3,10,0.057471264
Sioux Falls(Mitchell),57540,87,1,2,2,5,0.057471264
Wichita-Hutchinson Plus,67744,87,2,1,2,5,0.057471264
Oklahoma City,73659,87,2,2,1,5,0.057471264
Portland-Auburn,4348,3289,66,63,60,189,0.057464275
Detroit,48069,2593,64,50,35,149,0.057462399
Sacramnto-Stkton-Modesto,95633,2889,52,59,55,166,0.057459328
Lincoln & Hastings-Krny,69044,644,11,6,20,37,0.057453416
Fargo,56673,940,25,14,15,54,0.057446809
Minneapolis-St. Paul,56467,2681,77,44,33,154,0.057441253
Burlington-Plattsburgh,12851,296,8,5,4,17,0.057432432
Spokane,99180,888,20,12,19,51,0.057432432
Rapid City,57759,418,9,11,4,24,0.057416268
Salisbury,21865,453,10,9,7,26,0.057395143
Pittsburgh,15623,697,17,12,11,40,0.057388809
Chattanooga,28906,20702,419,381,388,1188,0.05738576
Wichita-Hutchinson Plus,67656,122,4,1,2,7,0.057377049
Lincoln & Hastings-Krny,68932,366,8,6,7,21,0.057377049
Shreveport,75630,2580,62,45,41,148,0.057364341
Chico-Redding,95969,6084,139,90,120,349,0.057363577
Seattle-Tacoma,98281,1238,28,24,19,71,0.057350565
Seattle-Tacoma,98232,4098,88,79,68,235,0.057345046
New York,12766,436,7,8,10,25,0.05733945
Denver,81413,5494,135,104,76,315,0.057335275
Denver,80440,3436,58,70,69,197,0.057334109
Little Rock-Pine Bluff,72067,2564,64,44,39,147,0.057332293
Burlington-Plattsburgh,5677,2285,57,37,37,131,0.057330416
Casper-Riverton,82620,157,4,2,3,9,0.057324841
Portland-Auburn,3902,2582,59,33,56,148,0.057319907
Knoxville,37774,22420,431,410,444,1285,0.057314897
Traverse City-Cadillac,49664,2216,48,40,39,127,0.057310469
Baltimore,21676,349,5,7,8,20,0.05730659
Albany-Schenectady-Troy,1253,1274,20,26,27,73,0.057299843
Mobile-Pensacola (Ft Walt),36584,733,15,14,13,42,0.057298772
Burlington-Plattsburgh,12861,576,9,11,13,33,0.057291667
Omaha,68433,192,4,4,3,11,0.057291667
Grand Junction-Montrose,81527,1920,53,32,25,110,0.057291667
Eureka,95570,2601,51,57,41,149,0.057285659
Wichita-Hutchinson Plus,67745,419,10,6,8,24,0.057279236
Greenville-N.Bern-Washngtn,27814,1519,33,27,27,87,0.057274523
Portland-Auburn,4001,2654,57,39,56,152,0.057272042
Denver,81063,2654,58,52,42,152,0.057272042
Little Rock-Pine Bluff,72686,227,6,4,3,13,0.057268722
Denver,81415,1694,39,27,31,97,0.057260921
Albany-Schenectady-Troy,12175,594,11,11,12,34,0.057239057
Denver,69146,297,8,5,4,17,0.057239057
Atlanta,30571,3407,71,67,57,195,0.057235104
Johnstown-Altoona-St Colge,15538,664,14,11,13,38,0.057228916
Salt Lake City,89316,1066,30,13,18,61,0.057223265
Binghamton,13786,402,6,7,10,23,0.05721393
Houston,77597,1206,18,21,30,69,0.05721393
Ft. Smith-Fay-Sprngdl-Rgrs,72715,18982,380,346,360,1086,0.057212096
Sioux City,51049,437,12,5,8,25,0.057208238
Bakersfield,93205,2168,38,38,48,124,0.057195572
Traverse City-Cadillac,49612,1154,22,23,21,66,0.057192374
Austin,78671,647,14,14,9,37,0.057187017
"Springfield, MO",72632,4669,94,76,97,267,0.057185693
Medford-Klamath Falls,97538,2011,42,37,36,115,0.05718548
Eureka,95543,857,20,13,16,49,0.057176196
Minneapolis-St. Paul,56253,927,20,19,14,53,0.057173679
Fresno-Visalia,93653,997,20,20,17,57,0.057171515
Monterey-Salinas,93426,1557,36,22,31,89,0.057161207
Ft. Myers-Naples,33471,6543,136,112,126,374,0.057160324
Minneapolis-St. Paul,55735,1802,45,31,27,103,0.057158713
Springfield-Holyoke,1084,105,2,2,2,6,0.057142857
Philadelphia,19492,35,0,1,1,2,0.057142857
Raleigh-Durham (Fayetvlle),27845,1680,37,31,28,96,0.057142857
Traverse City-Cadillac,49705,840,17,18,13,48,0.057142857
Sioux City,51431,420,11,7,6,24,0.057142857
Omaha,51636,385,9,6,7,22,0.057142857
Sioux Falls(Mitchell),57065,385,9,6,7,22,0.057142857
Bismarck-Mnt-Dcknsn(Wlstn),58422,175,4,3,3,10,0.057142857
Bismarck-Mnt-Dcknsn(Wlstn),58428,245,4,5,5,14,0.057142857
St. Louis,62553,455,8,8,10,26,0.057142857
Topeka,66946,105,2,3,1,6,0.057142857
Lincoln & Hastings-Krny,68865,980,20,22,14,56,0.057142857
Abilene-Sweetwater,76865,140,3,3,2,8,0.057142857
Amarillo,79056,70,2,1,1,4,0.057142857
Colorado Springs-Pueblo,81021,35,1,0,1,2,0.057142857
Champaign&Sprngfld-Decatur,60948,1523,37,25,25,87,0.057124097
Roanoke-Lynchburg,24070,1436,28,26,28,82,0.057103064
Traverse City-Cadillac,49619,1121,26,19,19,64,0.057091882
Presque Isle,4745,1086,16,19,27,62,0.057090239
Bismarck-Mnt-Dcknsn(Wlstn),58793,508,10,5,14,29,0.057086614
Sioux Falls(Mitchell),57446,473,6,8,13,27,0.057082452
Rochestr-Mason City-Austin,50478,806,15,14,17,46,0.05707196
Albany-Schenectady-Troy,12814,1174,16,27,24,67,0.057069847
Sioux City,51450,1507,35,24,27,86,0.057067021
Albany-Schenectady-Troy,12496,1437,27,22,33,82,0.057063326
Pittsburgh,26590,701,13,16,11,40,0.057061341
Seattle-Tacoma,98585,964,22,16,17,55,0.057053942
Traverse City-Cadillac,49827,929,17,19,17,53,0.057050592
Tampa-St. Pete (Sarasota),33541,28116,558,533,513,1604,0.057049367
Lima,45808,298,8,4,5,17,0.05704698
Lincoln & Hastings-Krny,68981,298,7,4,6,17,0.05704698
Norfolk-Portsmth-Newpt Nws,23025,526,10,11,9,30,0.057034221
Traverse City-Cadillac,48621,1315,30,21,24,75,0.057034221
Topeka,66412,263,7,2,6,15,0.057034221
Flint-Saginaw-Bay City,48763,4875,95,90,93,278,0.057025641
Omaha,50857,228,5,4,4,13,0.057017544
Portland-Auburn,3814,2421,47,44,47,138,0.057001239
Bismarck-Mnt-Dcknsn(Wlstn),58575,895,17,15,19,51,0.05698324
Des Moines-Ames,50858,702,15,12,13,40,0.056980057
Omaha,68431,351,7,7,6,20,0.056980057
Cleveland-Akron (Canton),44675,1896,35,37,36,108,0.056962025
Great Falls,59450,474,11,6,10,27,0.056962025
Lincoln & Hastings-Krny,69043,474,11,11,5,27,0.056962025
Duluth-Superior,55605,597,13,9,12,34,0.056951424
Spokane,99347,2388,57,33,46,136,0.056951424
Richmond-Petersburg,23857,439,8,9,8,25,0.056947608
Portland-Auburn,4231,281,5,6,5,16,0.056939502
New York,12764,1704,34,31,32,97,0.056924883
Paducah-Cape Girard-Harsbg,42076,1142,24,20,21,65,0.056917688
La Crosse-Eau Claire,54626,1265,32,19,21,72,0.056916996
Lexington,41843,615,14,12,9,35,0.056910569
Eugene,97455,2759,53,57,47,157,0.056904676
Wilmington,28428,6907,155,136,102,393,0.056898798
Providence-New Bedford,2833,457,10,7,9,26,0.056892779
Reno,96107,1125,18,23,23,64,0.056888889
Las Vegas,89044,34085,846,540,553,1939,0.056887194
Wilkes Barre-Scranton-Hztn,18241,334,7,5,7,19,0.056886228
Billings,59014,1635,41,28,24,93,0.056880734
Lincoln & Hastings-Krny,66951,545,15,7,9,31,0.056880734
Lincoln & Hastings-Krny,68722,422,11,9,4,24,0.056872038
Spokane,83872,844,24,10,14,48,0.056872038
Chico-Redding,96008,1319,28,27,20,75,0.056861259
Billings,59347,299,7,6,4,17,0.056856187
Davenport-R.Island-Moline,61274,299,7,4,6,17,0.056856187
Springfield-Holyoke,1346,387,8,7,7,22,0.056847545
Sioux Falls(Mitchell),57385,1337,38,19,19,76,0.05684368
Roanoke-Lynchburg,24348,4662,79,117,69,265,0.056842557
Houston,77018,29578,613,502,566,1681,0.056832781
Pittsburgh,16351,1654,36,25,33,94,0.056831923
Portland-Auburn,3583,1179,28,20,19,67,0.05682782
Orlando-Daytona Bch-Melbrn,34476,30356,669,573,483,1725,0.056825669
Sacramnto-Stkton-Modesto,95631,6212,143,91,119,353,0.056825499
Gainesville,32631,264,5,5,5,15,0.056818182
Columbus-Tupelo-West Point,39771,88,2,1,2,5,0.056818182
Cedar Rapids-Wtrlo-IWC&Dub,52036,176,5,3,2,10,0.056818182
Paducah-Cape Girard-Harsbg,63966,2112,37,43,40,120,0.056818182
Wichita-Hutchinson Plus,67518,88,2,1,2,5,0.056818182
Wichita-Hutchinson Plus,67634,264,5,5,5,15,0.056818182
Cheyenne-Scottsbluff,82081,88,2,2,1,5,0.056818182
"Portland, OR",97751,88,2,1,2,5,0.056818182
Greenvll-Spart-Ashevll-And,28739,21325,466,365,380,1211,0.056787808
Marquette,49814,1356,29,30,18,77,0.056784661
Wichita-Hutchinson Plus,67516,317,7,7,4,18,0.056782334
Cedar Rapids-Wtrlo-IWC&Dub,52224,1867,41,26,39,106,0.056775576
Richmond-Petersburg,23169,1233,25,23,22,70,0.056772101
Bismarck-Mnt-Dcknsn(Wlstn),58440,229,7,2,4,13,0.056768559
Rapid City,82842,687,15,11,13,39,0.056768559
"Springfield, MO",72651,1198,24,25,19,68,0.056761269
Phoenix (Prescott),85119,21549,406,415,402,1223,0.056754374
Sioux Falls(Mitchell),57449,141,1,3,4,8,0.056737589
Austin,78618,282,7,5,4,16,0.056737589
Tampa-St. Pete (Sarasota),34695,17736,377,335,294,1006,0.056720794
Duluth-Superior,54862,335,9,5,5,19,0.056716418
San Francisco-Oak-San Jose,95459,582,13,12,8,33,0.056701031
"Rochester, NY",14471,2628,48,53,48,149,0.056697108
Ft. Myers-Naples,33983,17779,354,314,340,1008,0.056696102
Traverse City-Cadillac,49622,2540,56,43,45,144,0.056692913
Flint-Saginaw-Bay City,48745,1323,33,25,17,75,0.056689342
Omaha,51526,1764,36,27,37,100,0.056689342
Salisbury,19968,15488,338,280,260,878,0.05668905
Sacramnto-Stkton-Modesto,95949,20957,464,390,334,1188,0.056687503
Boston (Manchester),2540,8715,139,191,164,494,0.056683878
New York,12743,247,4,4,6,14,0.056680162
Bismarck-Mnt-Dcknsn(Wlstn),58454,353,9,4,7,20,0.056657224
La Crosse-Eau Claire,54726,1977,50,31,31,112,0.056651492
Burlington-Plattsburgh,3266,2083,43,38,37,118,0.056649064
Greenville-N.Bern-Washngtn,27843,865,19,14,16,49,0.056647399
Eugene,97430,512,13,10,6,29,0.056640625
Sacramnto-Stkton-Modesto,95383,4202,87,80,71,238,0.056639695
Pittsburgh,15055,1342,28,22,26,76,0.056631893
South Bend-Elkhart,49117,3691,81,71,57,209,0.056624221
Wichita-Hutchinson Plus,66956,1307,27,23,24,74,0.05661821
Quincy-Hannibal-Keokuk,62353,5070,111,82,94,287,0.056607495
Boston (Manchester),3852,583,15,9,9,33,0.056603774
Portland-Auburn,4221,1219,22,25,22,69,0.056603774
Pittsburgh,16217,53,1,1,1,3,0.056603774
Bluefield-Beckley-Oak Hill,25936,53,1,1,1,3,0.056603774
Beaumont-Port Arthur,75932,1272,27,20,25,72,0.056603774
Amarillo,88436,106,2,2,2,6,0.056603774
Medford-Klamath Falls,97531,530,10,10,10,30,0.056603774
Beaumont-Port Arthur,75938,2509,56,42,44,142,0.056596253
Albuquerque-Santa Fe,81323,4524,116,74,66,256,0.056587091
Green Bay-Appleton,54962,1255,33,20,18,71,0.056573705
Orlando-Daytona Bch-Melbrn,34431,9280,175,172,178,525,0.056573276
Kansas City,64145,5144,85,111,95,291,0.056570762
Bangor,4616,831,18,16,13,47,0.056558363
Albany-Schenectady-Troy,12076,1167,21,23,22,66,0.05655527
Denver,80726,389,7,5,10,22,0.05655527
Spokane,83553,1167,33,21,12,66,0.05655527
Raleigh-Durham (Fayetvlle),27850,6171,107,109,133,349,0.056554853
Marquette,49878,3572,71,66,65,202,0.056550952
Green Bay-Appleton,54119,566,13,8,11,32,0.056537102
Burlington-Plattsburgh,12989,867,21,11,17,49,0.056516724
Tampa-St. Pete (Sarasota),34235,14881,250,269,322,841,0.056515019
Davenport-R.Island-Moline,52729,814,21,12,13,46,0.056511057
San Francisco-Oak-San Jose,94956,1575,29,30,30,89,0.056507937
Greenvll-Spart-Ashevll-And,28785,8584,164,158,163,485,0.056500466
Omaha,68324,177,4,3,3,10,0.056497175
Spokane,83821,531,11,9,10,30,0.056497175
Norfolk-Portsmth-Newpt Nws,27949,8710,188,170,134,492,0.056486797
Birmingham (Ann and Tusc),35136,1505,24,32,29,85,0.056478405
Richmond-Petersburg,23071,1399,32,23,24,79,0.056468906
Omaha,68450,3347,73,60,56,189,0.056468479
Albany-Schenectady-Troy,12846,2922,62,55,48,165,0.056468172
Los Angeles,92305,549,13,11,7,31,0.056466302
Phoenix (Prescott),85390,10378,218,200,168,586,0.0564656
New York,12732,797,13,12,20,45,0.056461731
Davenport-R.Island-Moline,61428,1063,29,16,15,60,0.056444026
Denver,81201,10367,233,189,163,585,0.056429054
Baltimore,21662,514,8,11,10,29,0.056420233
Sacramnto-Stkton-Modesto,95918,2127,50,39,31,120,0.056417489
Denver,82215,195,5,4,2,11,0.056410256
Idaho Fals-Pocatllo(Jcksn),83464,585,14,3,16,33,0.056410256
Medford-Klamath Falls,96014,195,5,3,3,11,0.056410256
Eugene,97466,922,20,13,19,52,0.056399132
Portland-Auburn,4860,1915,42,29,37,108,0.056396867
Helena,59648,727,20,12,9,41,0.056396149
Montgomery-Selma,36861,3316,69,44,74,187,0.056393245
Duluth-Superior,54847,2394,56,45,34,135,0.056390977
Paducah-Cape Girard-Harsbg,42055,2749,55,54,46,155,0.05638414
Portland-Auburn,3590,1011,20,18,19,57,0.056379822
Burlington-Plattsburgh,5456,1224,22,20,27,69,0.056372549
Denver,81418,1632,47,24,21,92,0.056372549
San Francisco-Oak-San Jose,94965,10486,181,176,234,591,0.056360862
Bangor,4640,2484,49,41,50,140,0.056360709
"Portland, OR",97368,3247,66,63,54,183,0.056359717
Denver,80540,4667,108,92,63,263,0.056353118
Philadelphia,8247,976,17,26,12,55,0.056352459
Burlington-Plattsburgh,5681,71,2,1,1,4,0.056338028
Burlington-Plattsburgh,5748,355,9,8,3,20,0.056338028
Charlottesville,22946,142,3,3,2,8,0.056338028
Ottumwa-Kirksville,52548,71,2,1,1,4,0.056338028
Duluth-Superior,55703,710,16,13,11,40,0.056338028
"Springfield, MO",65784,71,2,1,1,4,0.056338028
Shreveport,71029,142,4,3,1,8,0.056338028
Waco-Temple-Bryan,76890,994,23,13,20,56,0.056338028
Albuquerque-Santa Fe,87743,284,6,4,6,16,0.056338028
Amarillo,88121,142,4,1,3,8,0.056338028
Orlando-Daytona Bch-Melbrn,32137,51246,1055,985,847,2887,0.056336104
Boston (Manchester),3230,1243,32,17,21,70,0.056315366
Billings,59317,1101,15,28,19,62,0.056312443
Eugene,97443,2149,51,43,27,121,0.056305258
Salisbury,19951,2522,52,49,41,142,0.05630452
Albuquerque-Santa Fe,87732,817,24,13,9,46,0.05630355
Sioux Falls(Mitchell),57373,373,9,5,7,21,0.056300268
San Diego,92070,1048,18,20,21,59,0.05629771
Flint-Saginaw-Bay City,48467,2256,37,47,43,127,0.056294326
Knoxville,37765,533,11,12,7,30,0.056285178
Bangor,4490,231,6,4,3,13,0.056277056
Joplin-Pittsburg,66015,693,15,11,13,39,0.056277056
Lincoln & Hastings-Krny,68882,462,8,8,10,26,0.056277056
Bangor,4981,2257,41,35,51,127,0.056269384
Bismarck-Mnt-Dcknsn(Wlstn),58541,391,7,9,6,22,0.056265985
San Francisco-Oak-San Jose,95432,391,6,8,8,22,0.056265985
New York,12461,1653,31,35,27,93,0.056261343
Rockford,61067,711,17,12,11,40,0.05625879
Denver,80470,3573,78,74,49,201,0.056255248
Bismarck-Mnt-Dcknsn(Wlstn),58782,320,10,5,3,18,0.05625
Duluth-Superior,55710,1405,36,25,18,79,0.056227758
Bangor,4414,1334,26,22,27,75,0.056221889
Joplin-Pittsburg,66039,587,15,10,8,33,0.056218058
Norfolk-Portsmth-Newpt Nws,23436,925,21,20,11,52,0.056216216
Portland-Auburn,4342,1886,42,31,33,106,0.056203606
San Diego,92036,3452,74,51,69,194,0.056199305
Boston (Manchester),3443,712,15,13,12,40,0.056179775
Denver,80747,445,8,6,11,25,0.056179775
Salt Lake City,89311,178,4,2,4,10,0.056179775
Boston (Manchester),3269,3098,59,52,63,174,0.056165268
Columbus-Tupelo-West Point,35544,641,16,10,10,36,0.056162246
Spokane,83813,1478,37,24,22,83,0.056156969
Burlington-Plattsburgh,12969,374,7,5,9,21,0.056149733
Wilkes Barre-Scranton-Hztn,17948,6839,161,106,117,384,0.05614856
Green Bay-Appleton,54970,3776,80,72,60,212,0.056144068
Knoxville,37882,3028,64,47,59,170,0.056142668
Chico-Redding,96069,1247,31,19,20,70,0.056134723
Phoenix (Prescott),85920,588,14,12,7,33,0.056122449
Spokane,98856,2744,71,49,34,154,0.056122449
Savannah,29920,10033,233,161,169,563,0.056114821
Eugene,97467,5578,115,111,87,313,0.056113302
Abilene-Sweetwater,76443,1800,41,36,24,101,0.056111111
Chico-Redding,96065,713,18,9,13,40,0.056100982
Flint-Saginaw-Bay City,48880,10482,212,184,192,588,0.056096165
Grand Junction-Montrose,81422,517,8,11,10,29,0.056092843
Green Bay-Appleton,54159,1355,38,19,19,76,0.056088561
Orlando-Daytona Bch-Melbrn,32702,3031,66,56,48,170,0.0560871
Billings,59007,107,4,1,1,6,0.056074766
San Angelo,76937,214,5,4,3,12,0.056074766
Spokane,99143,642,16,12,8,36,0.056074766
Chico-Redding,96041,5886,100,101,129,330,0.05606524
Lincoln & Hastings-Krny,66967,1980,38,34,39,111,0.056060606
Great Falls,59446,553,13,7,11,31,0.056057866
Minneapolis-St. Paul,55787,446,9,8,8,25,0.056053812
Denver,82083,339,5,6,8,19,0.056047198
Marquette,49970,232,4,5,4,13,0.056034483
Sioux City,51044,232,4,4,5,13,0.056034483
San Antonio,78832,3034,60,70,40,170,0.056031641
Billings,82410,1660,39,32,22,93,0.056024096
Little Rock-Pine Bluff,71970,714,15,11,14,40,0.056022409
Burlington-Plattsburgh,5345,1714,43,21,32,96,0.056009335
Waco-Temple-Bryan,75850,857,18,13,17,48,0.056009335
Duluth-Superior,54555,4821,114,82,74,270,0.056004978
Clarksburg-Weston,26148,125,3,2,2,7,0.056
Bangor,4462,4483,92,83,76,251,0.055989293
Burlington-Plattsburgh,5462,1929,42,29,37,108,0.055987558
St. Louis,62032,643,13,14,9,36,0.055987558
Quincy-Hannibal-Keokuk,62370,393,12,7,3,22,0.055979644
Missoula,59859,4216,98,77,61,236,0.05597723
Boise,83657,268,7,5,3,15,0.055970149
Tucson (Sierra Vista),85610,1090,24,21,16,61,0.055963303
Portland-Auburn,4090,11992,251,193,227,671,0.055953969
Bismarck-Mnt-Dcknsn(Wlstn),58451,143,3,2,3,8,0.055944056
Albuquerque-Santa Fe,88301,1430,26,27,27,80,0.055944056
West Palm Beach-Ft. Pierce,33483,12906,157,234,331,722,0.055942972
Austin,78631,2896,69,53,40,162,0.055939227
Baltimore,21610,304,8,4,5,17,0.055921053
Lincoln & Hastings-Krny,68377,304,8,4,5,17,0.055921053
Denver,80468,304,5,7,5,17,0.055921053
Eugene,97412,304,9,5,3,17,0.055921053
Springfield-Holyoke,1337,2611,53,51,42,146,0.055917273
Albuquerque-Santa Fe,87047,5723,143,94,83,320,0.05591473
Seattle-Tacoma,98070,11250,281,182,166,629,0.055911111
Orlando-Daytona Bch-Melbrn,32080,22858,384,418,476,1278,0.055910403
La Crosse-Eau Claire,55919,948,22,13,18,53,0.055907173
Rapid City,59311,161,4,3,2,9,0.055900621
Quincy-Hannibal-Keokuk,63473,322,9,6,3,18,0.055900621
San Francisco-Oak-San Jose,95446,5492,95,110,102,307,0.05589949
Las Vegas,89060,12970,243,257,225,725,0.055898227
Burlington-Plattsburgh,5151,1485,33,22,28,83,0.055892256
Topeka,67436,501,12,6,10,28,0.055888224
Dallas-Ft. Worth,76455,1002,20,16,20,56,0.055888224
Denver,81133,1038,15,20,23,58,0.055876686
Boston (Manchester),2645,10917,239,173,198,610,0.055876156
Albany-Schenectady-Troy,1240,4833,96,91,83,270,0.055865922
Burlington-Plattsburgh,5040,537,13,9,8,30,0.055865922
Burlington-Plattsburgh,5867,716,17,11,12,40,0.055865922
Tulsa,67346,358,9,6,5,20,0.055865922
Duluth-Superior,55723,2184,46,43,33,122,0.055860806
Pittsburgh,15687,1200,26,22,19,67,0.055833333
"Columbus, GA (Opelika, AL)",36016,4048,78,73,75,226,0.05583004
Idaho Fals-Pocatllo(Jcksn),83467,6323,150,91,112,353,0.05582793
Greenvll-Spart-Ashevll-And,28718,627,13,12,10,35,0.055821372
New York,12792,430,7,6,11,24,0.055813953
Little Rock-Pine Bluff,71961,860,20,13,15,48,0.055813953
Bangor,4691,448,8,8,9,25,0.055803571
Gainesville,32648,448,9,8,8,25,0.055803571
Boise,83612,2258,49,42,35,126,0.055801594
Richmond-Petersburg,23092,681,14,12,12,38,0.055800294
Albany-Schenectady-Troy,5260,233,6,3,4,13,0.055793991
Lexington,41772,233,6,3,4,13,0.055793991
Quincy-Hannibal-Keokuk,62374,233,4,6,3,13,0.055793991
Albuquerque-Santa Fe,87036,1649,47,24,21,92,0.055791389
Jacksonville,32034,42341,948,743,671,2362,0.055785173
Portland-Auburn,4349,1219,29,20,19,68,0.055783429
Anchorage,99556,2689,66,47,37,150,0.055782819
Traverse City-Cadillac,48656,3891,78,54,85,217,0.055769725
Duluth-Superior,54856,1578,35,25,28,88,0.055766793
Watertown,13618,1596,38,27,24,89,0.055764411
Columbus-Tupelo-West Point,39737,269,6,3,6,15,0.055762082
Norfolk-Portsmth-Newpt Nws,23119,305,7,4,6,17,0.055737705
Boise,97907,610,11,9,14,34,0.055737705
San Diego,92004,3373,75,49,64,188,0.055736733
Orlando-Daytona Bch-Melbrn,32759,3068,83,48,40,171,0.055736636
"Charleston, SC",29451,4647,103,102,54,259,0.055734883
Rapid City,57732,2189,43,43,36,122,0.055733212
Marquette,49818,969,20,20,14,54,0.055727554
"Portland, OR",97869,1023,17,22,18,57,0.055718475
New York,12410,359,7,6,7,20,0.055710306
Little Rock-Pine Bluff,72680,718,14,13,13,40,0.055710306
Medford-Klamath Falls,97537,7791,153,130,151,434,0.055705301
"Washington, DC (Hagrstwn)",22747,1167,27,16,22,65,0.055698372
Boston (Manchester),2659,1203,21,21,25,67,0.055694098
Eureka,95589,1203,23,22,22,67,0.055694098
Presque Isle,4768,413,8,7,8,23,0.055690073
Pittsburgh,15677,413,9,7,7,23,0.055690073
Bluefield-Beckley-Oak Hill,24951,826,16,16,14,46,0.055690073
Lincoln & Hastings-Krny,68940,431,12,5,7,24,0.055684455
Billings,59074,449,9,5,11,25,0.055679287
Duluth-Superior,54552,4257,91,67,79,237,0.055673009
Minneapolis-St. Paul,56336,1473,33,21,28,82,0.055668703
Minneapolis-St. Paul,56443,1473,37,26,19,82,0.055668703
Marquette,49879,1006,21,17,18,56,0.055666004
Raleigh-Durham (Fayetvlle),23917,2569,52,52,39,143,0.055663682
"Charleston, SC",29082,521,9,7,13,29,0.055662188
Santabarbra-Sanmar-Sanluob,93430,2767,50,57,47,154,0.055655945
Salt Lake City,83123,557,11,9,11,31,0.055655296
Duluth-Superior,54836,1132,29,18,16,63,0.05565371
"Tri-Cities, TN-VA",41835,611,14,9,11,34,0.055646481
Burlington-Plattsburgh,5489,3361,72,71,44,187,0.055638203
South Bend-Elkhart,49129,719,16,15,9,40,0.055632823
Portland-Auburn,3849,2211,48,38,37,123,0.055630936
Kansas City,64071,737,15,13,13,41,0.055630936
"Alexandria, LA",71467,8323,167,145,151,463,0.05562898
Buffalo,14167,1582,29,26,33,88,0.05562579
Quincy-Hannibal-Keokuk,61420,935,11,20,21,52,0.055614973
Traverse City-Cadillac,49675,1061,16,24,19,59,0.055607917
Oklahoma City,73024,1061,18,20,21,59,0.055607917
Medford-Klamath Falls,97541,1529,33,27,25,85,0.05559189
Albany-Schenectady-Troy,12521,1691,37,32,25,94,0.055588409
Traverse City-Cadillac,49629,2015,40,39,33,112,0.055583127
Green Bay-Appleton,54968,3059,70,56,44,170,0.055573717
Albany-Schenectady-Troy,12041,36,1,0,1,2,0.055555556
Philadelphia,19453,1278,27,22,22,71,0.055555556
Bluefield-Beckley-Oak Hill,24815,108,3,1,2,6,0.055555556
Greenville-N.Bern-Washngtn,28579,522,10,11,8,29,0.055555556
Greensboro-H.Point-W.Salem,28668,54,1,1,1,3,0.055555556
Knoxville,40913,108,2,3,1,6,0.055555556
Duluth-Superior,55606,252,5,4,5,14,0.055555556
Mankato,56162,252,7,3,4,14,0.055555556
Fargo,56729,126,2,2,3,7,0.055555556
Fargo,58046,486,12,6,9,27,0.055555556
Bismarck-Mnt-Dcknsn(Wlstn),58423,72,2,1,1,4,0.055555556
Bismarck-Mnt-Dcknsn(Wlstn),58778,108,2,2,2,6,0.055555556
Missoula,59845,1332,33,25,16,74,0.055555556
Topeka,66518,162,4,1,4,9,0.055555556
Lincoln & Hastings-Krny,66932,144,4,2,2,8,0.055555556
Memphis,72368,828,16,17,13,46,0.055555556
"Springfield, MO",72531,792,18,14,12,44,0.055555556
Shreveport,74755,108,1,2,3,6,0.055555556
Albuquerque-Santa Fe,87063,198,3,4,4,11,0.055555556
Albuquerque-Santa Fe,87580,36,1,0,1,2,0.055555556
Albuquerque-Santa Fe,88338,126,2,3,2,7,0.055555556
Chico-Redding,96096,792,19,14,11,44,0.055555556
"Portland, OR",97122,594,15,9,9,33,0.055555556
"Portland, OR",97710,126,3,2,2,7,0.055555556
Rapid City,82730,1333,30,19,25,74,0.055513878
Wilkes Barre-Scranton-Hztn,18211,1261,26,22,22,70,0.055511499
Harrisonburg,22967,2451,56,40,40,136,0.055487556
Tyler-Longview(Lfkn&Ncgd),75959,775,18,14,11,43,0.055483871
Medford-Klamath Falls,97543,775,16,13,14,43,0.055483871
Phoenix (Prescott),85342,1514,33,25,26,84,0.055482166
Portland-Auburn,4535,721,15,11,14,40,0.055478502
Topeka,66854,721,17,12,11,40,0.055478502
Albuquerque-Santa Fe,87017,721,15,17,8,40,0.055478502
Minneapolis-St. Paul,56667,667,13,12,12,37,0.055472264
Memphis,38066,3263,69,54,58,181,0.055470426
Albany-Schenectady-Troy,5261,2452,51,44,41,136,0.055464927
Traverse City-Cadillac,49740,7951,169,141,131,441,0.055464721
"Columbia, SC",29332,2434,51,43,41,135,0.055464256
Richmond-Petersburg,22473,5463,119,99,85,303,0.055464031
Bakersfield,93518,1064,20,16,23,59,0.055451128
"Portland, OR",97823,1028,21,14,22,57,0.055447471
Atlanta,30560,5195,99,95,94,288,0.055437921
Medford-Klamath Falls,96050,469,12,7,7,26,0.0554371
Albuquerque-Santa Fe,87575,1840,44,32,26,102,0.055434783
Wichita-Hutchinson Plus,67070,902,17,12,21,50,0.055432373
Des Moines-Ames,50103,433,14,6,4,24,0.055427252
Fresno-Visalia,93271,2093,47,42,27,116,0.055422838
Duluth-Superior,55793,415,11,8,4,23,0.055421687
"Springfield, MO",65762,397,8,7,7,22,0.055415617
Binghamton,13839,1552,34,27,25,86,0.055412371
Waco-Temple-Bryan,76864,776,23,11,9,43,0.055412371
"Washington, DC (Hagrstwn)",22639,722,16,11,13,40,0.055401662
Flint-Saginaw-Bay City,48635,1390,29,26,22,77,0.055395683
Duluth-Superior,55742,325,8,6,4,18,0.055384615
Orlando-Daytona Bch-Melbrn,32102,2763,58,47,48,153,0.055374593
Chico-Redding,96016,307,8,4,5,17,0.055374593
New York,11941,2908,61,53,47,161,0.055364512
Bangor,4464,578,17,10,5,32,0.055363322
Fargo,58233,289,6,5,5,16,0.055363322
Eureka,95549,849,20,12,15,47,0.055359246
"Springfield, MO",65739,1355,29,23,23,75,0.055350554
Sacramnto-Stkton-Modesto,95925,271,7,4,4,15,0.055350554
Albany-Schenectady-Troy,12503,759,14,14,14,42,0.055335968
Fargo,58272,253,7,2,5,14,0.055335968
Boston (Manchester),2664,9851,179,178,188,545,0.055324333
Minneapolis-St. Paul,56183,1193,25,19,22,66,0.055322716
Portland-Auburn,4040,3073,69,51,50,170,0.055320534
Seattle-Tacoma,98325,2278,48,34,44,126,0.055311677
Fargo,56534,1320,33,17,23,73,0.05530303
Orlando-Daytona Bch-Melbrn,32132,8446,136,153,178,467,0.055292446
Wausau-Rhinelander,54521,8446,173,158,136,467,0.055292446
Bangor,4448,1230,27,19,22,68,0.055284553
Denver,80433,8249,216,150,90,456,0.055279428
Traverse City-Cadillac,49762,597,11,10,12,33,0.055276382
Champaign&Sprngfld-Decatur,61930,398,9,5,8,22,0.055276382
"Springfield, MO",65733,597,10,13,10,33,0.055276382
Greenville-N.Bern-Washngtn,28553,380,7,8,6,21,0.055263158
St. Louis,63386,380,8,5,8,21,0.055263158
Great Falls,59412,1701,44,22,28,94,0.055261611
Albany-Schenectady-Troy,12502,923,17,17,17,51,0.055254605
Sacramnto-Stkton-Modesto,95975,1846,41,20,41,102,0.055254605
Bangor,4849,4000,96,70,55,221,0.05525
Burlington-Plattsburgh,5077,1267,28,24,18,70,0.055248619
San Francisco-Oak-San Jose,95420,362,7,6,7,20,0.055248619
Boston (Manchester),3445,688,16,10,12,38,0.055232558
Little Rock-Pine Bluff,72152,326,6,4,8,18,0.055214724
Odessa-Midland,78851,163,4,3,2,9,0.055214724
Denver,81431,489,12,7,8,27,0.055214724
Denver,80421,8875,190,162,138,490,0.055211268
Denver,69149,634,17,6,12,35,0.055205047
Charleston-Huntington,41171,4765,90,96,77,263,0.055194124
Alpena,48742,1522,31,25,28,84,0.055190539
Memphis,38963,3751,78,73,56,207,0.055185284
Ottumwa-Kirksville,52533,1196,21,28,17,66,0.055183946
Springfield-Holyoke,1341,1631,36,34,20,90,0.055180871
Cedar Rapids-Wtrlo-IWC&Dub,50630,1613,43,17,29,89,0.055176689
"Washington, DC (Hagrstwn)",26865,580,10,10,12,32,0.055172414
Fargo,58056,145,4,2,2,8,0.055172414
Amarillo,79230,145,4,2,2,8,0.055172414
Albuquerque-Santa Fe,88347,145,2,2,4,8,0.055172414
Portland-Auburn,3576,3118,63,55,54,172,0.055163566
Spokane,99139,1124,31,18,13,62,0.055160142
Abilene-Sweetwater,79566,272,7,4,4,15,0.055147059
Spokane,99134,544,11,11,8,30,0.055147059
Tampa-St. Pete (Sarasota),33763,19641,292,388,403,1083,0.055139759
Miami-Ft. Lauderdale,33306,3428,76,60,53,189,0.055134189
Seattle-Tacoma,98221,23528,467,422,408,1297,0.055125808
Green Bay-Appleton,54941,2449,56,48,31,135,0.055124541
Traverse City-Cadillac,49752,508,10,9,9,28,0.05511811
Bismarck-Mnt-Dcknsn(Wlstn),59222,254,7,4,3,14,0.05511811
Rapid City,59332,127,3,2,2,7,0.05511811
Miami-Ft. Lauderdale,33066,16385,262,285,356,903,0.055111382
Burlington-Plattsburgh,5774,1343,29,25,20,74,0.055100521
Roanoke-Lynchburg,24292,363,7,5,8,20,0.055096419
Ottumwa-Kirksville,63541,363,6,8,6,20,0.055096419
Roanoke-Lynchburg,26294,581,13,11,8,32,0.055077453
Raleigh-Durham (Fayetvlle),27551,2197,49,45,27,121,0.055075102
Billings,59008,345,10,5,4,19,0.055072464
Billings,59059,345,8,6,5,19,0.055072464
Roanoke-Lynchburg,24176,1253,23,26,20,69,0.055067837
Portland-Auburn,4858,1526,31,26,27,84,0.055045872
Sioux Falls(Mitchell),57050,218,6,3,3,12,0.055045872
Salt Lake City,84540,109,2,2,2,6,0.055045872
Albuquerque-Santa Fe,87901,6995,128,118,139,385,0.055039314
Seattle-Tacoma,98257,4470,114,68,64,246,0.055033557
Billings,59052,200,5,3,3,11,0.055
Bismarck-Mnt-Dcknsn(Wlstn),58723,291,5,5,6,16,0.054982818
Cedar Rapids-Wtrlo-IWC&Dub,52049,1346,25,21,28,74,0.054977712
Billings,59069,673,18,9,10,37,0.054977712
Portland-Auburn,4285,382,8,7,6,21,0.054973822
Lincoln & Hastings-Krny,68957,473,8,8,10,26,0.054968288
Little Rock-Pine Bluff,71726,1128,24,20,18,62,0.054964539
Phoenix (Prescott),85132,42419,897,722,712,2331,0.05495179
Springfield-Holyoke,1032,91,2,2,1,5,0.054945055
Burlington-Plattsburgh,5037,819,19,15,11,45,0.054945055
Lincoln & Hastings-Krny,68972,182,4,3,3,10,0.054945055
Lubbock,79234,91,3,1,1,5,0.054945055
Spokane,98834,182,6,1,3,10,0.054945055
New York,12582,6046,130,108,94,332,0.054912339
"Columbus, OH",43724,9069,182,166,150,498,0.054912339
Medford-Klamath Falls,97624,4298,102,65,69,236,0.05490926
Traverse City-Cadillac,49756,4117,79,63,84,226,0.054894341
Butte-Bozeman,59727,328,7,7,4,18,0.054878049
Wichita-Hutchinson Plus,66942,164,4,2,3,9,0.054878049
Seattle-Tacoma,98546,3189,54,59,62,175,0.054876137
Boston (Manchester),3457,802,19,12,13,44,0.054862843
Sioux Falls(Mitchell),57468,237,5,3,5,13,0.054852321
Greenville-N.Bern-Washngtn,28538,3464,76,63,51,190,0.054849885
Davenport-R.Island-Moline,52070,1094,16,20,24,60,0.054844607
Mobile-Pensacola (Ft Walt),39451,6674,139,113,114,366,0.054839676
Bangor,4657,310,6,5,6,17,0.05483871
Denver,69147,620,15,11,8,34,0.05483871
Albuquerque-Santa Fe,88041,1149,28,18,17,63,0.054830287
"Portland, OR",97011,839,16,14,16,46,0.054827175
New York,10975,456,9,8,8,25,0.054824561
Wilmington,28449,1952,44,39,24,107,0.054815574
Baltimore,21663,3047,63,49,55,167,0.054808008
Flint-Saginaw-Bay City,48738,1186,30,22,13,65,0.054806071
La Crosse-Eau Claire,54895,949,22,15,15,52,0.054794521
Duluth-Superior,56654,73,3,0,1,4,0.054794521
Fargo,56761,438,9,7,8,24,0.054794521
Topeka,66944,219,4,4,4,12,0.054794521
Chicago,60551,5092,101,94,84,279,0.05479183
New York,18325,2318,34,35,58,127,0.054788611
"Portland, OR",97131,3030,55,53,58,166,0.054785479
Fargo,56728,1223,22,22,23,67,0.05478332
Albany-Schenectady-Troy,12051,5568,100,101,104,305,0.054777299
Santabarbra-Sanmar-Sanluob,93449,8179,134,148,166,448,0.054774422
Lincoln & Hastings-Krny,68652,639,8,12,15,35,0.054773083
Tulsa,67353,493,13,8,6,27,0.054766734
Marquette,49835,840,19,17,10,46,0.054761905
Albany-Schenectady-Troy,12136,1114,21,21,19,61,0.05475763
Grand Junction-Montrose,81523,895,21,16,12,49,0.054748603
Denver,69128,274,6,4,5,15,0.054744526
Tyler-Longview(Lfkn&Ncgd),75948,5682,128,106,77,311,0.054734249
Burlington-Plattsburgh,5079,731,15,13,12,40,0.054719562
Missoula,59823,1791,34,30,34,98,0.054718035
Quincy-Hannibal-Keokuk,62624,457,6,12,7,25,0.054704595
Fargo,58344,1097,28,10,22,60,0.054694622
Lincoln & Hastings-Krny,68424,640,17,8,10,35,0.0546875
Amarillo,79046,384,10,5,6,21,0.0546875
Norfolk-Portsmth-Newpt Nws,23395,1079,23,19,17,59,0.054680259
Boston (Manchester),3224,2396,39,45,47,131,0.054674457
Burlington-Plattsburgh,12870,1555,32,24,29,85,0.054662379
Boston (Manchester),2556,3403,65,57,64,186,0.054657655
Albany-Schenectady-Troy,1222,677,11,9,17,37,0.05465288
Wausau-Rhinelander,54424,1720,37,28,29,94,0.054651163
Medford-Klamath Falls,97532,3367,78,53,53,184,0.054648055
Marquette,49919,183,3,4,3,10,0.054644809
Billings,82441,183,6,1,3,10,0.054644809
Portland-Auburn,4982,421,9,7,7,23,0.054631829
Sacramnto-Stkton-Modesto,95919,1318,28,20,24,72,0.054628225
Traverse City-Cadillac,49836,952,16,19,17,52,0.054621849
Augusta-Aiken,29845,1172,24,20,20,64,0.054607509
Spokane,99150,348,5,7,7,19,0.054597701
Butte-Bozeman,59759,3700,79,57,66,202,0.054594595
Tampa-St. Pete (Sarasota),34436,8939,202,140,146,488,0.054592236
"Portland, OR",97112,1887,42,34,27,103,0.054583996
Spokane,83544,6229,122,107,111,340,0.0545834
Sioux City,51058,971,19,14,20,53,0.054582904
Birmingham (Ann and Tusc),35034,5478,111,82,106,299,0.054581964
Lincoln & Hastings-Krny,68636,1026,14,12,30,56,0.054580897
Seattle-Tacoma,98592,2419,50,40,42,132,0.054568003
Rapid City,82720,898,18,13,18,49,0.054565702
Fargo,58220,2181,44,37,38,119,0.054562127
Richmond-Petersburg,23919,2346,55,41,32,128,0.054560955
Colorado Springs-Pueblo,81023,1338,33,22,18,73,0.054559043
Phoenix (Prescott),86324,5737,115,101,97,313,0.054558131
Burlington-Plattsburgh,3580,1430,34,22,22,78,0.054545455
Portland-Auburn,4284,1100,18,21,21,60,0.054545455
Burlington-Plattsburgh,5675,990,21,20,13,54,0.054545455
Wilkes Barre-Scranton-Hztn,18455,165,3,3,3,9,0.054545455
Rapid City,57650,55,1,1,1,3,0.054545455
Wichita-Hutchinson Plus,67138,275,8,4,3,15,0.054545455
Phoenix (Prescott),85194,8837,188,148,146,482,0.054543397
Montgomery-Selma,36025,7683,159,130,130,419,0.054535989
Boston (Manchester),1366,1302,27,20,24,71,0.05453149
Greenville-N.Bern-Washngtn,28594,3796,72,70,65,207,0.054531085
Great Falls,59474,3576,56,66,73,195,0.054530201
Tampa-St. Pete (Sarasota),34287,26426,459,470,512,1441,0.05452963
Lincoln & Hastings-Krny,68361,2531,50,37,51,138,0.054523904
Wheeling-Steubenville,43950,16785,341,302,272,915,0.054512958
"Jackson, TN",38326,2550,48,44,47,139,0.054509804
Boston (Manchester),1966,7118,132,125,131,388,0.054509694
Duluth-Superior,54867,477,13,7,6,26,0.054507338
Abilene-Sweetwater,76827,422,10,8,5,23,0.05450237
"Portland, OR",97830,734,11,14,15,40,0.054495913
Hartford & New Haven,6752,1670,33,29,29,91,0.054491018
Wilkes Barre-Scranton-Hztn,18614,2111,43,42,30,115,0.054476551
Greenville-N.Bern-Washngtn,28520,257,6,4,4,14,0.054474708
Lincoln & Hastings-Krny,66940,257,6,4,4,14,0.054474708
Sacramnto-Stkton-Modesto,95665,4517,101,61,84,246,0.054460925
Traverse City-Cadillac,48651,4536,89,70,88,247,0.054453263
Seattle-Tacoma,98590,496,11,9,7,27,0.054435484
Billings,59046,588,12,8,12,32,0.054421769
Presque Isle,4732,1452,30,25,24,79,0.054407713
Sioux Falls(Mitchell),57437,1416,27,18,32,77,0.054378531
Medford-Klamath Falls,97415,15247,304,239,286,829,0.054371352
Portland-Auburn,4095,1711,37,21,35,93,0.054354179
Boston (Manchester),2559,3496,64,65,61,190,0.054347826
Salisbury,21840,368,8,6,6,20,0.054347826
Marquette,49962,276,5,5,5,15,0.054347826
Butte-Bozeman,59762,276,5,7,3,15,0.054347826
Wichita-Hutchinson Plus,66941,276,6,4,5,15,0.054347826
Medford-Klamath Falls,97525,5172,95,87,99,281,0.054331013
Minneapolis-St. Paul,56028,1270,22,27,20,69,0.054330709
Atlanta,30148,589,12,11,9,32,0.054329372
Phoenix (Prescott),86406,26363,547,465,420,1432,0.054318553
"Washington, DC (Hagrstwn)",20130,313,6,6,5,17,0.054313099
Fargo,58420,313,7,5,5,17,0.054313099
Salt Lake City,84781,313,6,6,5,17,0.054313099
Portland-Auburn,4290,1547,27,31,26,84,0.054298643
Albany-Schenectady-Troy,12454,221,4,4,4,12,0.054298643
Minneapolis-St. Paul,56160,221,5,3,4,12,0.054298643
Springfield-Holyoke,1340,1584,27,25,34,86,0.054292929
Lincoln & Hastings-Krny,68780,921,25,17,8,50,0.054288817
Sioux City,51366,350,9,4,6,19,0.054285714
Buffalo,14070,6908,129,123,123,375,0.054284887
Minneapolis-St. Paul,55749,479,12,6,8,26,0.054279749
San Francisco-Oak-San Jose,95445,2561,51,42,46,139,0.054275674
Phoenix (Prescott),86333,6247,132,102,105,339,0.054266048
Roanoke-Lynchburg,26264,387,9,6,6,21,0.054263566
Lincoln & Hastings-Krny,68658,645,16,10,9,35,0.054263566
Wichita Falls & Lawton,76491,387,5,6,10,21,0.054263566
Albuquerque-Santa Fe,87059,9768,221,153,156,530,0.054258804
Missoula,59911,9493,215,160,140,515,0.0542505
Fargo,56736,885,19,17,12,48,0.054237288
Wichita-Hutchinson Plus,66936,295,7,4,5,16,0.054237288
Wichita-Hutchinson Plus,67490,1088,16,15,28,59,0.054227941
Philadelphia,18936,996,20,16,18,54,0.054216867
Lexington,41390,166,5,2,2,9,0.054216867
Wichita-Hutchinson Plus,66970,166,4,2,3,9,0.054216867
Portland-Auburn,4864,4833,92,77,93,262,0.054210635
Greensboro-H.Point-W.Salem,27212,2269,45,41,37,123,0.054208903
Tucson (Sierra Vista),85321,3081,58,53,56,167,0.054203181
Seattle-Tacoma,98351,1347,36,19,18,73,0.054194506
Shreveport,71043,406,11,8,3,22,0.054187192
Minneapolis-St. Paul,56672,1975,42,38,27,107,0.054177215
Lincoln & Hastings-Krny,68755,240,6,5,2,13,0.054166667
Minneapolis-St. Paul,56444,3028,71,53,40,164,0.054161162
Macon,31068,4211,81,69,78,228,0.054143909
Wilkes Barre-Scranton-Hztn,18439,628,11,12,11,34,0.054140127
Minneapolis-St. Paul,56311,702,14,10,14,38,0.054131054
Monterey-Salinas,93923,12157,288,220,150,658,0.054125195
Marquette,49840,776,17,11,14,42,0.054123711
Macon,31037,3566,71,71,51,193,0.054122266
Charleston-Huntington,26160,887,21,11,16,48,0.054114994
Albuquerque-Santa Fe,88337,2292,41,38,45,124,0.054101222
Traverse City-Cadillac,49640,1627,36,26,26,88,0.054087277
Myrtle Beach-Florence,29572,12277,188,223,253,664,0.054084874
Seattle-Tacoma,98595,2903,55,53,49,157,0.054081984
Tyler-Longview(Lfkn&Ncgd),75929,1239,27,22,18,67,0.054075868
Albany-Schenectady-Troy,12052,1461,32,29,18,79,0.054072553
Fargo,56528,1535,39,22,22,83,0.054071661
Wilkes Barre-Scranton-Hztn,18430,111,2,2,2,6,0.054054054
"Washington, DC (Hagrstwn)",22845,74,2,1,1,4,0.054054054
Fargo,58496,259,6,4,4,14,0.054054054
Lincoln & Hastings-Krny,68375,111,3,1,2,6,0.054054054
Lincoln & Hastings-Krny,69036,74,2,1,1,4,0.054054054
Boise,83610,962,20,17,15,52,0.054054054
Albuquerque-Santa Fe,88049,444,10,7,7,24,0.054054054
Sacramnto-Stkton-Modesto,95636,481,9,7,10,26,0.054054054
Springfield-Holyoke,1370,4090,83,66,72,221,0.05403423
Jacksonville,31522,16993,321,322,275,918,0.054022244
Portland-Auburn,4216,796,18,16,9,43,0.054020101
Burlington-Plattsburgh,5253,537,10,9,10,29,0.054003724
Bangor,4681,1037,17,13,26,56,0.054001929
Rapid City,57747,6038,127,103,96,326,0.053991388
Flint-Saginaw-Bay City,48748,1871,38,35,28,101,0.053981828
Savannah,29827,3391,50,56,77,183,0.053966382
Medford-Klamath Falls,96031,278,6,4,5,15,0.053956835
Baton Rouge,70775,15461,344,274,216,834,0.053942177
Abilene-Sweetwater,76429,241,5,4,4,13,0.053941909
Grand Junction-Montrose,81522,241,6,4,3,13,0.053941909
Watertown,13345,445,8,7,9,24,0.053932584
Nashville,38380,575,14,10,7,31,0.053913043
Oklahoma City,73860,1113,30,20,10,60,0.053908356
Wilkes Barre-Scranton-Hztn,18461,334,5,7,6,18,0.053892216
Great Falls,59464,631,14,8,12,34,0.053882726
Fargo,58063,297,8,4,4,16,0.053872054
Denver,81152,1021,16,22,17,55,0.053868756
Medford-Klamath Falls,96067,7110,134,141,108,383,0.053867792
Des Moines-Ames,50575,836,25,10,10,45,0.053827751
Duluth-Superior,56657,353,6,7,6,19,0.053824363
Paducah-Cape Girard-Harsbg,63931,353,6,8,5,19,0.053824363
Medford-Klamath Falls,97539,3512,75,58,56,189,0.05381549
Omaha,68332,223,5,3,4,12,0.053811659
Duluth-Superior,55790,1840,40,27,32,99,0.053804348
Joplin-Pittsburg,67336,1450,31,22,25,78,0.053793103
Albuquerque-Santa Fe,88039,409,7,8,7,22,0.053789731
Billings,59029,781,19,13,10,42,0.053777209
Sacramnto-Stkton-Modesto,95321,3905,60,76,74,210,0.053777209
Roanoke-Lynchburg,24326,967,17,17,18,52,0.05377456
Sioux Falls(Mitchell),57523,967,25,14,13,52,0.05377456
Burlington-Plattsburgh,5757,837,20,15,10,45,0.053763441
Traverse City-Cadillac,49820,186,3,5,2,10,0.053763441
Minneapolis-St. Paul,55111,93,1,2,2,5,0.053763441
Amarillo,79257,930,27,14,9,50,0.053763441
Minneapolis-St. Paul,56431,9005,184,150,150,484,0.053747918
Paducah-Cape Girard-Harsbg,42038,5452,104,92,97,293,0.053741746
Seattle-Tacoma,98588,2047,37,35,38,110,0.053737176
Sacramnto-Stkton-Modesto,94571,11111,193,182,222,597,0.053730537
Wausau-Rhinelander,54487,9605,219,152,145,516,0.05372202
Sioux City,51343,242,6,3,4,13,0.053719008
Idaho Fals-Pocatllo(Jcksn),83253,242,5,4,4,13,0.053719008
"Portland, OR",98619,484,11,8,7,26,0.053719008
Burlington-Plattsburgh,3779,782,16,11,15,42,0.05370844
Louisville,42715,391,4,8,9,21,0.05370844
Marquette,49883,149,2,3,3,8,0.053691275
Madison,53569,1099,22,22,15,59,0.053685168
Reno,89423,11534,274,191,154,619,0.053667418
Spokane,83555,559,17,2,11,30,0.053667263
Boise,83654,1845,42,27,30,99,0.053658537
Anchorage,99676,2274,51,40,31,122,0.053649956
Tampa-St. Pete (Sarasota),33872,14353,297,242,231,770,0.053647321
Medford-Klamath Falls,96039,988,20,16,17,53,0.053643725
Wichita-Hutchinson Plus,67505,2480,48,46,39,133,0.053629032
Eugene,97453,1007,21,16,17,54,0.053624628
San Antonio,78884,690,13,10,14,37,0.053623188
Tampa-St. Pete (Sarasota),34449,3992,76,69,69,214,0.053607214
Minneapolis-St. Paul,55760,2836,53,40,59,152,0.053596615
Boston (Manchester),3082,1698,33,28,30,91,0.053592462
Norfolk-Portsmth-Newpt Nws,23138,877,19,14,14,47,0.05359179
Marquette,49927,392,10,6,5,21,0.053571429
Duluth-Superior,56659,168,4,2,3,9,0.053571429
Wichita-Hutchinson Plus,67849,392,8,8,5,21,0.053571429
San Angelo,76858,224,4,4,4,12,0.053571429
Twin Falls,83348,56,1,1,1,3,0.053571429
Chico-Redding,96017,56,1,1,1,3,0.053571429
San Angelo,76945,1774,36,39,20,95,0.053551297
Albany-Schenectady-Troy,12824,803,11,17,15,43,0.053549191
Springfield-Holyoke,1012,635,10,14,10,34,0.053543307
Bangor,4476,1158,17,18,27,62,0.053540587
Cedar Rapids-Wtrlo-IWC&Dub,52326,523,12,7,9,28,0.053537285
Tampa-St. Pete (Sarasota),34450,10797,227,174,177,578,0.053533389
Bangor,4978,897,15,15,18,48,0.053511706
Chico-Redding,96108,299,7,4,5,16,0.053511706
Denver,81155,243,4,4,5,13,0.053497942
Burlington-Plattsburgh,5486,1664,33,28,28,89,0.053485577
Helena,59633,374,9,5,6,20,0.053475936
Pittsburgh,26705,954,18,15,18,51,0.053459119
Des Moines-Ames,50551,131,4,1,2,7,0.053435115
Bismarck-Mnt-Dcknsn(Wlstn),58581,262,5,5,4,14,0.053435115
Bismarck-Mnt-Dcknsn(Wlstn),58643,131,4,2,1,7,0.053435115
Wichita-Hutchinson Plus,67427,337,8,4,6,18,0.053412463
San Francisco-Oak-San Jose,95436,5205,102,92,84,278,0.053410183
"Springfield, MO",65779,1723,36,29,27,92,0.053395241
West Palm Beach-Ft. Pierce,33472,20040,424,357,289,1070,0.053393214
Lincoln & Hastings-Krny,68406,356,9,4,6,19,0.053370787
Medford-Klamath Falls,97534,581,9,11,11,31,0.053356282
New York,12412,600,9,11,12,32,0.053333333
Duluth-Superior,56680,75,2,1,1,4,0.053333333
Fargo,58362,75,2,1,1,4,0.053333333
Bismarck-Mnt-Dcknsn(Wlstn),58486,225,5,3,4,12,0.053333333
Omaha,68345,225,4,5,3,12,0.053333333
Sioux Falls(Mitchell),69333,225,4,4,4,12,0.053333333
Austin,76820,75,2,1,1,4,0.053333333
Rapid City,82710,300,6,4,6,16,0.053333333
Atlanta,28904,9526,189,159,160,508,0.053327735
St. Louis,63127,5683,142,92,69,303,0.05331691
Green Bay-Appleton,54202,1482,28,22,29,79,0.053306343
Roanoke-Lynchburg,24161,394,8,7,6,21,0.053299492
Colorado Springs-Pueblo,80814,3810,84,64,55,203,0.05328084
Denver,81235,732,17,12,10,39,0.053278689
Sacramnto-Stkton-Modesto,95245,2440,35,43,52,130,0.053278689
Wilmington,28422,10173,189,168,185,542,0.053278286
Binghamton,12468,1389,22,20,32,74,0.053275738
"Portland, OR",97049,1896,32,33,36,101,0.053270042
Quincy-Hannibal-Keokuk,63453,413,9,8,5,22,0.053268765
Wichita-Hutchinson Plus,67651,413,10,5,7,22,0.053268765
Albany-Schenectady-Troy,12835,2741,57,52,37,146,0.053265232
New York,12480,582,13,9,9,31,0.053264605
Bluefield-Beckley-Oak Hill,24801,6834,137,120,107,364,0.053263096
Sacramnto-Stkton-Modesto,95959,19113,395,317,306,1018,0.053262178
Austin,78623,1840,42,26,30,98,0.05326087
Fargo,58324,1258,26,20,21,67,0.053259141
Lincoln & Hastings-Krny,67639,169,4,2,3,9,0.053254438
Bluefield-Beckley-Oak Hill,25813,8809,166,142,161,469,0.053241004
Los Angeles,92586,22372,407,400,384,1191,0.053236188
Bangor,4481,733,18,12,9,39,0.053206003
Greenville-N.Bern-Washngtn,27808,2199,40,41,36,117,0.053206003
Baton Rouge,70748,6542,124,115,109,348,0.053194742
Bangor,4674,282,6,4,5,15,0.053191489
Bismarck-Mnt-Dcknsn(Wlstn),58460,188,4,3,3,10,0.053191489
Ft. Smith-Fay-Sprngdl-Rgrs,72760,282,7,5,3,15,0.053191489
Medford-Klamath Falls,96086,282,7,4,4,15,0.053191489
"Portland, OR",97760,8217,154,146,137,437,0.053182427
Denver,82213,583,14,12,5,31,0.053173242
Phoenix (Prescott),85324,2727,66,34,45,145,0.053171984
Spokane,99118,790,13,13,16,42,0.053164557
Houston,77364,3066,58,50,55,163,0.053163731
Presque Isle,4763,696,14,13,10,37,0.05316092
Minneapolis-St. Paul,54876,1900,44,33,24,101,0.053157895
Boston (Manchester),3449,1731,42,28,22,92,0.053148469
Lincoln & Hastings-Krny,67644,207,5,2,4,11,0.053140097
Indianapolis,47468,1205,25,21,18,64,0.053112033
Burlington-Plattsburgh,5846,1318,24,17,29,70,0.053110774
Colorado Springs-Pueblo,81252,4952,95,70,98,263,0.053109855
Jacksonville,32202,6402,53,125,162,340,0.053108404
Kansas City,64437,452,8,8,8,24,0.053097345
Orlando-Daytona Bch-Melbrn,34788,20982,388,352,374,1114,0.053093127
Ft. Myers-Naples,33928,33490,531,619,628,1778,0.053090475
Tulsa,74367,584,10,11,10,31,0.053082192
Sioux City,51047,603,12,9,11,32,0.053067993
Albany-Schenectady-Troy,1255,980,19,16,17,52,0.053061224
Des Moines-Ames,52569,490,11,10,5,26,0.053061224
Glendive,59326,245,6,4,3,13,0.053061224
Topeka,66958,245,4,5,4,13,0.053061224
Denver,81638,245,6,5,2,13,0.053061224
Traverse City-Cadillac,48653,9990,196,176,158,530,0.053053053
Denver,81320,377,7,7,6,20,0.053050398
Savannah,30426,886,14,16,17,47,0.053047404
Rochestr-Mason City-Austin,50453,509,13,7,7,27,0.053045187
Burlington-Plattsburgh,5872,1037,18,15,22,55,0.053037608
Charlotte,28631,660,11,11,13,35,0.053030303
Medford-Klamath Falls,97621,132,3,2,2,7,0.053030303
Seattle-Tacoma,98376,2169,38,37,40,115,0.053019825
Marquette,54103,453,9,7,8,24,0.052980132
Roanoke-Lynchburg,24121,10459,201,157,196,554,0.052968735
Burlington-Plattsburgh,5738,1114,23,15,21,59,0.052962298
Sacramnto-Stkton-Modesto,96118,1435,35,25,16,76,0.052961672
Burlington-Plattsburgh,5837,340,7,6,5,18,0.052941176
Bismarck-Mnt-Dcknsn(Wlstn),58418,359,8,4,7,19,0.052924791
"Washington, DC (Hagrstwn)",20688,2003,36,38,32,106,0.052920619
Fargo,58380,378,9,5,6,20,0.052910053
San Antonio,78883,189,5,3,2,10,0.052910053
Sacramnto-Stkton-Modesto,95251,794,15,13,14,42,0.052896725
Denver,81211,7998,147,145,131,423,0.052888222
Sioux City,68747,208,4,4,3,11,0.052884615
Sioux City,68020,643,13,8,13,34,0.052877138
Bismarck-Mnt-Dcknsn(Wlstn),58558,1078,32,14,11,57,0.052875696
Reno,96056,2289,46,42,33,121,0.052861512
Corpus Christi,78402,946,13,18,19,50,0.052854123
Sioux Falls(Mitchell),57382,1230,27,15,23,65,0.052845528
Wichita-Hutchinson Plus,67524,492,11,6,9,26,0.052845528
Fargo,58227,511,8,7,12,27,0.052837573
New York,10963,3956,82,65,62,209,0.052831143
Seattle-Tacoma,98560,265,4,5,5,14,0.052830189
Boston (Manchester),2667,3578,66,66,57,189,0.052822806
Syracuse,14841,833,16,13,15,44,0.052821128
Roanoke-Lynchburg,24934,284,5,5,5,15,0.052816901
Butte-Bozeman,59729,2878,58,44,50,152,0.052814454
Tampa-St. Pete (Sarasota),34209,33276,616,595,546,1757,0.052800817
Anchorage,99610,1932,40,37,25,102,0.052795031
Fargo,56576,1004,23,16,14,53,0.052788845
Anchorage,99688,2596,53,48,36,137,0.052773498
Johnstown-Altoona-St Colge,15773,379,8,6,6,20,0.052770449
Missoula,59926,379,8,6,6,20,0.052770449
Boise,83632,379,8,6,6,20,0.052770449
Portland-Auburn,3816,1630,34,27,25,86,0.052760736
Myrtle Beach-Florence,29566,25099,488,389,447,1324,0.052751106
Minneapolis-St. Paul,56350,474,9,9,7,25,0.052742616
San Francisco-Oak-San Jose,95423,4192,67,66,88,221,0.052719466
Columbia-Jefferson City,65069,607,19,9,4,32,0.052718287
Green Bay-Appleton,54209,1575,35,29,19,83,0.052698413
Tulsa,74427,1329,27,21,22,70,0.052671181
Albany-Schenectady-Troy,12439,342,6,5,7,18,0.052631579
Philadelphia,18933,19,1,0,0,1,0.052631579
Philadelphia,19736,38,1,1,0,2,0.052631579
Clarksburg-Weston,26215,57,1,1,1,3,0.052631579
Nashville,38333,456,9,7,8,24,0.052631579
Nashville,38542,19,1,0,0,1,0.052631579
Fargo,58372,95,2,1,2,5,0.052631579
Bismarck-Mnt-Dcknsn(Wlstn),58430,95,2,2,1,5,0.052631579
Missoula,59848,171,4,3,2,9,0.052631579
"Springfield, MO",65715,76,2,1,1,4,0.052631579
Wichita-Hutchinson Plus,67143,76,2,1,1,4,0.052631579
Little Rock-Pine Bluff,72663,456,8,8,8,24,0.052631579
Austin,78635,152,3,3,2,8,0.052631579
Amarillo,79240,57,1,1,1,3,0.052631579
Abilene-Sweetwater,79519,95,2,2,1,5,0.052631579
Abilene-Sweetwater,79560,152,2,2,4,8,0.052631579
Albuquerque-Santa Fe,87025,1121,28,16,15,59,0.052631579
Albuquerque-Santa Fe,87516,57,1,1,1,3,0.052631579
Sacramnto-Stkton-Modesto,95735,76,3,1,0,4,0.052631579
Austin,78657,7050,138,125,108,371,0.052624113
Portland-Auburn,4047,1863,30,29,39,98,0.052603328
Denver,81147,13221,298,215,182,695,0.052567884
Flint-Saginaw-Bay City,48739,3597,86,51,52,189,0.052543786
Boston (Manchester),3280,1104,22,20,16,58,0.052536232
Bangor,4459,552,12,11,6,29,0.052536232
Watertown,13650,1447,32,25,19,76,0.05252246
West Palm Beach-Ft. Pierce,32958,30429,562,519,517,1598,0.052515692
New York,12458,3677,68,63,62,193,0.052488442
Fargo,58429,343,6,8,4,18,0.052478134
Duluth-Superior,55706,1658,32,25,30,87,0.052472859
Burlington-Plattsburgh,5039,972,24,14,13,51,0.052469136
Cedar Rapids-Wtrlo-IWC&Dub,50612,305,6,4,6,16,0.052459016
Fargo,58424,305,6,4,6,16,0.052459016
Sioux City,51365,286,7,5,3,15,0.052447552
Fargo,58476,286,6,5,4,15,0.052447552
Missoula,59916,267,6,4,4,14,0.052434457
Harrisonburg,24459,763,15,11,14,40,0.05242464
Burlington-Plattsburgh,5674,2003,40,30,35,105,0.052421368
Idaho Fals-Pocatllo(Jcksn),83251,1145,32,14,14,60,0.052401747
Atlanta,30546,8187,163,123,143,429,0.052400147
Atlanta,30572,1298,26,21,21,68,0.05238829
Des Moines-Ames,51453,592,14,6,11,31,0.052364865
Colorado Springs-Pueblo,81059,191,4,3,3,10,0.052356021
Eugene,97411,7927,135,139,141,415,0.052352719
New York,12464,917,20,14,14,48,0.052344602
"Columbus, GA (Opelika, AL)",36017,3114,61,59,43,163,0.052344252
Ft. Smith-Fay-Sprngdl-Rgrs,72752,363,8,7,4,19,0.052341598
Tampa-St. Pete (Sarasota),33707,24762,338,443,515,1296,0.05233826
Duluth-Superior,54873,3038,64,47,48,159,0.052337064
San Francisco-Oak-San Jose,95460,2312,43,31,47,121,0.05233564
Fargo,58062,172,5,1,3,9,0.052325581
Elmira (Corning),16921,497,12,7,7,26,0.052313883
Bakersfield,93226,325,7,5,5,17,0.052307692
Eureka,95547,1300,34,17,17,68,0.052307692
Eureka,95558,650,14,11,9,34,0.052307692
Roanoke-Lynchburg,24944,478,9,8,8,25,0.052301255
Pittsburgh,16342,2046,38,37,32,107,0.052297165
Spokane,97857,459,7,8,9,24,0.052287582
West Palm Beach-Ft. Pierce,34957,25009,470,465,372,1307,0.052261186
Albuquerque-Santa Fe,87508,19423,396,317,302,1015,0.052257633
Ottumwa-Kirksville,52567,555,11,10,8,29,0.052252252
Billings,59068,3732,85,56,54,195,0.052250804
"Springfield, MO",65355,11260,248,180,160,588,0.052220249
Bangor,4430,1532,31,17,32,80,0.052219321
Orlando-Daytona Bch-Melbrn,34432,14499,280,255,222,757,0.052210497
Binghamton,13846,249,4,5,4,13,0.052208835
Wichita-Hutchinson Plus,66949,498,10,8,8,26,0.052208835
Minneapolis-St. Paul,56465,2107,52,33,25,110,0.052206929
Minneapolis-St. Paul,54759,1475,29,24,24,77,0.05220339
Tampa-St. Pete (Sarasota),34607,8678,176,147,130,453,0.052200968
Knoxville,37885,6533,114,110,117,341,0.052196541
Austin,78663,843,23,15,6,44,0.052194543
Seattle-Tacoma,98245,5270,88,86,101,275,0.052182163
Harrisonburg,26884,575,18,7,5,30,0.052173913
Wausau-Rhinelander,54511,1208,25,18,20,63,0.052152318
Chico-Redding,96040,326,8,4,5,17,0.052147239
Boston (Manchester),1908,3337,59,55,60,174,0.052142643
"Charleston, SC",29585,17186,360,313,223,896,0.052135459
Sacramnto-Stkton-Modesto,95247,3971,94,54,59,207,0.052127927
Lincoln & Hastings-Krny,68637,307,4,5,7,16,0.052117264
Medford-Klamath Falls,97636,403,9,6,6,21,0.052109181
Dallas-Ft. Worth,75497,3820,68,67,64,199,0.052094241
Albuquerque-Santa Fe,87012,96,2,2,1,5,0.052083333
Ft. Myers-Naples,33982,18060,361,278,301,940,0.052048726
Kansas City,64497,538,11,9,8,28,0.05204461
Denver,80517,9838,175,148,189,512,0.052043098
Norfolk-Portsmth-Newpt Nws,23336,3305,66,50,56,172,0.05204236
Panama City,32456,8014,169,131,117,417,0.052033941
Seattle-Tacoma,98524,3748,87,49,59,195,0.052027748
Seattle-Tacoma,98282,17818,337,297,293,927,0.052026041
Boise,83645,692,16,12,8,36,0.052023121
Myrtle Beach-Florence,29575,23013,398,355,444,1197,0.052014079
Milwaukee,53933,4211,75,76,68,219,0.052006649
Denver,69133,327,7,4,6,17,0.051987768
Burlington-Plattsburgh,5036,1058,18,19,18,55,0.051984877
"Washington, DC (Hagrstwn)",25431,404,8,7,6,21,0.051980198
Sioux City,50546,404,8,6,7,21,0.051980198
Albuquerque-Santa Fe,87830,1116,20,20,18,58,0.051971326
Spokane,83554,635,13,10,10,33,0.051968504
Portland-Auburn,3812,2213,35,38,42,115,0.051965657
Orlando-Daytona Bch-Melbrn,32134,8104,140,153,128,421,0.051949654
Denver,69148,154,3,3,2,8,0.051948052
"Portland, OR",97870,616,13,9,10,32,0.051948052
Sacramnto-Stkton-Modesto,95946,9857,188,171,153,512,0.051942782
Traverse City-Cadillac,49648,2561,54,45,34,133,0.051932839
Corpus Christi,78071,4237,89,64,67,220,0.051923531
Greenvll-Spart-Ashevll-And,29635,1387,26,24,22,72,0.051910598
Butte-Bozeman,59761,289,4,6,5,15,0.051903114
Duluth-Superior,54832,501,10,8,8,26,0.051896208
Duluth-Superior,49969,1484,25,27,25,77,0.051886792
Portland-Auburn,3254,5243,111,74,87,272,0.051878695
Gainesville,32625,1677,32,25,30,87,0.051878354
Ft. Myers-Naples,33904,33065,558,538,619,1715,0.051867534
Marquette,49861,617,11,12,9,32,0.051863857
Salisbury,21814,270,6,4,4,14,0.051851852
Minneapolis-St. Paul,55026,405,9,7,5,21,0.051851852
Bismarck-Mnt-Dcknsn(Wlstn),58467,540,10,8,10,28,0.051851852
Billings,59039,135,3,2,2,7,0.051851852
Seattle-Tacoma,98845,135,4,2,1,7,0.051851852
Spokane,99166,3086,49,53,58,160,0.051847051
Billings,82432,521,12,8,7,27,0.051823417
Fargo,56515,2914,57,48,46,151,0.051818806
Bangor,4985,193,4,3,3,10,0.051813472
Bluefield-Beckley-Oak Hill,25985,386,7,7,6,20,0.051813472
Rapid City,57738,193,5,3,2,10,0.051813472
Minneapolis-St. Paul,56661,888,24,11,11,46,0.051801802
Phoenix (Prescott),85328,695,11,12,13,36,0.051798561
Wichita-Hutchinson Plus,67439,3534,78,51,54,183,0.051782683
Bismarck-Mnt-Dcknsn(Wlstn),58438,618,12,5,15,32,0.051779935
Sioux City,51331,1294,27,20,20,67,0.051777434
Chattanooga,35755,734,16,11,11,38,0.051771117
Little Rock-Pine Bluff,72533,367,7,4,8,19,0.051771117
Ft. Myers-Naples,33922,4445,87,66,77,230,0.051743532
Springfield-Holyoke,1053,2242,45,39,32,116,0.051739518
West Palm Beach-Ft. Pierce,33473,12196,348,181,102,631,0.051738275
Ft. Myers-Naples,33948,17921,313,307,307,927,0.051727024
Wichita-Hutchinson Plus,67623,232,5,3,4,12,0.051724138
Portland-Auburn,4255,793,12,14,15,41,0.051702396
Albuquerque-Santa Fe,88317,2650,54,44,39,137,0.051698113
Los Angeles,90740,24336,401,384,473,1258,0.051692965
Birmingham (Ann and Tusc),36026,1064,21,17,17,55,0.051691729
West Palm Beach-Ft. Pierce,34987,25695,514,415,399,1328,0.051683207
Roanoke-Lynchburg,24315,3233,60,61,46,167,0.05165481
Clarksburg-Weston,26421,213,6,4,1,11,0.051643192
Reno,89704,4474,99,65,67,231,0.05163165
Spokane,83539,2092,47,36,25,108,0.051625239
Fargo,58016,155,3,2,3,8,0.051612903
Lincoln & Hastings-Krny,69168,310,8,4,4,16,0.051612903
Anchorage,99568,775,16,14,10,40,0.051612903
La Crosse-Eau Claire,54628,1182,24,23,14,61,0.051607445
Duluth-Superior,55763,562,11,8,10,29,0.051601423
Richmond-Petersburg,23887,543,8,10,10,28,0.051565378
Phoenix (Prescott),86303,19005,309,348,323,980,0.051565378
Eureka,95526,543,10,7,11,28,0.051565378
Cedar Rapids-Wtrlo-IWC&Dub,52066,97,3,1,1,5,0.051546392
Lincoln & Hastings-Krny,68327,291,7,3,5,15,0.051546392
Little Rock-Pine Bluff,72048,97,2,2,1,5,0.051546392
Ft. Myers-Naples,34112,28115,459,519,471,1449,0.051538325
Chicago,46391,8751,165,147,139,451,0.051536967
Seattle-Tacoma,98236,6385,137,105,87,329,0.051527016
Spokane,98814,524,15,5,7,27,0.051526718
Rapid City,57722,369,8,6,5,19,0.051490515
Spokane,83552,1282,35,16,15,66,0.051482059
Colorado Springs-Pueblo,81027,136,3,2,2,7,0.051470588
West Palm Beach-Ft. Pierce,33469,14689,262,259,235,756,0.051467084
Eugene,97488,991,19,15,17,51,0.051463169
Austin,78938,311,7,4,5,16,0.051446945
Yuma-El Centro,92257,2080,35,37,35,107,0.051442308
Albany-Schenectady-Troy,12812,175,3,3,3,9,0.051428571
Bakersfield,93283,1750,37,35,18,90,0.051428571
Milwaukee,53023,2431,50,38,37,125,0.051419169
Denver,80515,778,16,13,11,40,0.051413882
Colorado Springs-Pueblo,81226,9434,161,156,168,485,0.051409794
Traverse City-Cadillac,49689,1634,34,27,23,84,0.051407589
Portland-Auburn,4079,4008,73,63,70,206,0.051397206
Des Moines-Ames,50569,798,13,9,19,41,0.051378446
Norfolk-Portsmth-Newpt Nws,23163,545,15,6,7,28,0.051376147
Greenville-N.Bern-Washngtn,28587,292,5,5,5,15,0.051369863
"Springfield, MO",65638,857,23,12,9,44,0.05134189
Traverse City-Cadillac,49304,4110,80,76,55,211,0.0513382
Minneapolis-St. Paul,55712,526,13,6,8,27,0.051330798
Seattle-Tacoma,98356,2533,52,39,39,130,0.051322542
Orlando-Daytona Bch-Melbrn,34491,32180,580,531,540,1651,0.051305158
Sioux City,68038,1267,29,16,20,65,0.051302289
Rochestr-Mason City-Austin,50426,78,2,1,1,4,0.051282051
Fargo,58338,78,1,2,1,4,0.051282051
Billings,59065,195,5,2,3,10,0.051282051
"Springfield, MO",65735,195,4,3,3,10,0.051282051
Topeka,67458,234,5,4,3,12,0.051282051
San Antonio,78833,741,15,15,8,38,0.051282051
Albuquerque-Santa Fe,87939,234,5,3,4,12,0.051282051
Sacramnto-Stkton-Modesto,95311,2106,38,33,37,108,0.051282051
Portland-Auburn,3226,1112,18,23,16,57,0.051258993
Minneapolis-St. Paul,54817,2439,51,38,36,125,0.051250513
"Springfield, MO",65324,1288,23,25,18,66,0.051242236
West Palm Beach-Ft. Pierce,33455,21120,371,390,321,1082,0.051231061
Norfolk-Portsmth-Newpt Nws,23433,1308,29,18,20,67,0.051223242
Duluth-Superior,55732,1308,27,23,17,67,0.051223242
Medford-Klamath Falls,97739,13712,257,210,235,702,0.051196033
Denver,80823,293,6,3,6,15,0.051194539
Denver,81432,3361,72,53,47,172,0.051175245
Denver,69154,1192,26,21,14,61,0.051174497
Fargo,56571,2013,45,32,26,103,0.051167412
Philadelphia,8317,1075,19,13,23,55,0.051162791
Duluth-Superior,55724,782,16,12,12,40,0.051150895
Lincoln & Hastings-Krny,68319,567,14,6,9,29,0.051146384
Rockford,61050,352,8,5,5,18,0.051136364
Seattle-Tacoma,98239,7648,144,124,123,391,0.051124477
Johnstown-Altoona-St Colge,16651,5027,91,84,82,257,0.051123931
Tucson (Sierra Vista),85755,19267,439,357,189,985,0.051123683
Toledo,43440,4675,90,77,72,239,0.051122995
Boston (Manchester),3462,1565,30,25,25,80,0.051118211
Albuquerque-Santa Fe,87029,313,5,7,4,16,0.051118211
Medford-Klamath Falls,97536,998,20,17,14,51,0.051102204
Lubbock,79356,6047,110,97,102,309,0.051099719
Glendive,59339,137,2,3,2,7,0.051094891
Wichita-Hutchinson Plus,66963,137,3,2,2,7,0.051094891
Spokane,99121,137,2,2,3,7,0.051094891
Denver,81428,3663,69,72,46,187,0.051051051
Spokane,99371,431,14,4,4,22,0.051044084
Little Rock-Pine Bluff,72038,98,2,2,1,5,0.051020408
Miami-Ft. Lauderdale,33305,10095,103,193,219,515,0.051015354
Portland-Auburn,4970,1588,25,25,31,81,0.051007557
Green Bay-Appleton,54984,3059,63,44,49,156,0.050997058
Duluth-Superior,55614,2569,42,40,49,131,0.050992604
"Washington, DC (Hagrstwn)",25422,2295,37,38,42,117,0.050980392
Sioux City,50578,510,10,8,8,26,0.050980392
Wichita-Hutchinson Plus,67430,510,12,5,9,26,0.050980392
Albuquerque-Santa Fe,87942,510,11,7,8,26,0.050980392
Albany-Schenectady-Troy,12844,314,5,5,6,16,0.050955414
Lincoln & Hastings-Krny,68622,314,4,5,7,16,0.050955414
Denver,80466,3494,63,52,63,178,0.050944476
"Springfield, MO",72544,589,10,12,8,30,0.050933786
Sacramnto-Stkton-Modesto,95640,13529,263,221,205,689,0.050927637
Mobile-Pensacola (Ft Walt),36602,1080,8,16,31,55,0.050925926
"Tri-Cities, TN-VA",24631,2455,38,42,45,125,0.050916497
Colorado Springs-Pueblo,81069,1807,45,24,23,92,0.050913116
Philadelphia,8243,2082,30,43,33,106,0.050912584
Spokane,83526,275,6,4,4,14,0.050909091
Medford-Klamath Falls,97530,8056,152,137,121,410,0.050893744
New York,18451,393,8,6,6,20,0.050890585
Phoenix (Prescott),85541,25093,469,437,370,1276,0.050850835
Bismarck-Mnt-Dcknsn(Wlstn),58313,59,2,0,1,3,0.050847458
Wichita-Hutchinson Plus,67559,59,1,1,1,3,0.050847458
Eugene,97484,295,7,5,3,15,0.050847458
Orlando-Daytona Bch-Melbrn,32124,13756,257,200,242,699,0.05081419
Boise,83611,2893,63,37,47,147,0.050812306
Tampa-St. Pete (Sarasota),34667,34232,590,584,565,1739,0.050800421
Butte-Bozeman,59754,1063,16,16,22,54,0.050799624
Sacramnto-Stkton-Modesto,95962,1004,22,16,13,51,0.050796813
Richmond-Petersburg,22504,256,5,5,3,13,0.05078125
Glendive,59349,906,22,14,10,46,0.050772627
Erie,16401,6405,139,106,80,325,0.050741608
Binghamton,13804,276,7,4,3,14,0.050724638
Reno,89430,414,9,5,7,21,0.050724638
Burlington-Plattsburgh,5341,493,13,8,4,25,0.050709939
Portland-Auburn,3593,355,5,7,6,18,0.050704225
Fargo,58259,355,9,3,6,18,0.050704225
Greenville-N.Bern-Washngtn,27821,217,4,3,4,11,0.050691244
Bismarck-Mnt-Dcknsn(Wlstn),58559,217,6,3,2,11,0.050691244
Wichita-Hutchinson Plus,67066,217,4,3,4,11,0.050691244
Bismarck-Mnt-Dcknsn(Wlstn),58631,1046,18,10,25,53,0.050669216
Portland-Auburn,4022,1185,21,19,20,60,0.050632911
New York,8752,1975,28,38,34,100,0.050632911
Johnstown-Altoona-St Colge,15953,79,2,1,1,4,0.050632911
Duluth-Superior,54527,988,23,13,14,50,0.050607287
Omaha,68437,257,3,5,5,13,0.050583658
Davenport-R.Island-Moline,61075,949,22,11,15,48,0.050579557
Wichita-Hutchinson Plus,67349,870,22,10,12,44,0.050574713
Oklahoma City,73547,1839,34,35,24,93,0.050570962
Los Angeles,93544,1226,19,21,22,62,0.050570962
Albany-Schenectady-Troy,12815,791,15,9,16,40,0.0505689
Tampa-St. Pete (Sarasota),34461,12400,252,193,182,627,0.050564516
New York,12416,178,4,3,2,9,0.050561798
Phoenix (Prescott),85927,178,4,3,2,9,0.050561798
New York,8758,7537,97,137,147,381,0.050550617
Wausau-Rhinelander,54562,2117,47,30,30,107,0.050543222
"Springfield, MO",65773,554,11,9,8,28,0.050541516
Wichita-Hutchinson Plus,67446,475,12,4,8,24,0.050526316
Raleigh-Durham (Fayetvlle),27839,3523,63,60,55,178,0.050525121
Billings,59033,99,2,2,1,5,0.050505051
Boise,83643,198,4,3,3,10,0.050505051
Las Vegas,89029,8812,152,140,153,445,0.050499319
Richmond-Petersburg,23043,1604,33,26,22,81,0.050498753
Portland-Auburn,3853,812,13,15,13,41,0.050492611
Fargo,58271,614,22,5,4,31,0.050488599
Richmond-Petersburg,22437,515,11,9,6,26,0.050485437
Seattle-Tacoma,98631,4140,78,68,63,209,0.050483092
Green Bay-Appleton,54177,2972,58,50,42,150,0.050471063
Rapid City,57751,892,16,15,14,45,0.05044843
Oklahoma City,73662,5750,112,94,84,290,0.050434783
Roanoke-Lynchburg,24458,357,7,5,6,18,0.050420168
Lubbock,79518,119,2,1,3,6,0.050420168
Wichita-Hutchinson Plus,67038,516,12,7,7,26,0.050387597
Spokane,97885,1469,24,23,27,74,0.050374404
Tampa-St. Pete (Sarasota),34698,37818,614,604,687,1905,0.050372838
New York,12465,278,5,4,5,14,0.050359712
Lincoln & Hastings-Krny,68447,417,7,8,6,21,0.050359712
Wausau-Rhinelander,54524,576,15,8,6,29,0.050347222
Flint-Saginaw-Bay City,48761,874,11,19,14,44,0.050343249
Des Moines-Ames,50633,298,5,5,5,15,0.05033557
Tampa-St. Pete (Sarasota),34448,11205,201,180,183,564,0.050334672
Quincy-Hannibal-Keokuk,65283,497,10,4,11,25,0.050301811
Albany-Schenectady-Troy,1223,2446,49,40,34,123,0.050286182
Fargo,58426,199,5,3,2,10,0.050251256
Lincoln & Hastings-Krny,68725,458,11,6,6,23,0.050218341
Salisbury,21648,239,5,3,4,12,0.050209205
Tampa-St. Pete (Sarasota),33762,8208,100,139,173,412,0.050194932
"Springfield, MO",72537,817,12,18,11,41,0.050183599
New York,10589,8490,161,154,111,426,0.050176678
Duluth-Superior,56681,299,7,4,4,15,0.050167224
Traverse City-Cadillac,49635,3609,62,62,57,181,0.050152397
Harrisonburg,24430,2892,46,48,51,145,0.050138313
Elmira (Corning),14840,3072,67,46,41,154,0.050130208
Seattle-Tacoma,98638,1616,28,30,23,81,0.050123762
Portland-Auburn,4261,479,10,6,8,24,0.050104384
Hartford & New Haven,6069,2435,39,44,39,122,0.050102669
Wausau-Rhinelander,54540,1038,17,17,18,52,0.050096339
Tampa-St. Pete (Sarasota),33857,1577,31,22,26,79,0.050095117
Bismarck-Mnt-Dcknsn(Wlstn),58495,1098,19,15,21,55,0.050091075
Salisbury,19975,12079,208,222,175,605,0.050086928
Flint-Saginaw-Bay City,48468,1238,17,23,22,62,0.050080775
Marquette,49950,1318,22,23,21,66,0.050075873
Tampa-St. Pete (Sarasota),33960,919,15,14,17,46,0.050054407
Philadelphia,8640,6833,67,121,154,342,0.050051222
Portland-Auburn,4548,1039,27,13,12,52,0.050048123
Macon,31001,4419,78,70,73,221,0.050011315
Boston (Manchester),2650,860,6,20,17,43,0.05
Burlington-Plattsburgh,12964,120,2,2,2,6,0.05
Roanoke-Lynchburg,24465,1360,20,24,24,68,0.05
Fargo,58224,40,1,0,1,2,0.05
Fargo,58330,320,4,9,3,16,0.05
Bismarck-Mnt-Dcknsn(Wlstn),58632,220,4,2,5,11,0.05
Bismarck-Mnt-Dcknsn(Wlstn),58744,260,6,3,4,13,0.05
Billings,59071,140,3,2,2,7,0.05
Butte-Bozeman,59746,160,4,2,2,8,0.05
Denver,69037,100,2,1,2,5,0.05
Lubbock,79528,560,10,6,12,28,0.05
Denver,81653,40,1,1,0,2,0.05
Idaho Fals-Pocatllo(Jcksn),83469,80,2,1,1,4,0.05
Albuquerque-Santa Fe,87943,140,3,2,2,7,0.05
Las Vegas,89124,860,19,14,10,43,0.05
Sacramnto-Stkton-Modesto,95364,60,1,1,1,3,0.05
"Portland, OR",98670,80,2,1,1,4,0.05
Yakima-Pasco-Rchlnd-Knnwck,99329,160,3,3,2,8,0.05
Phoenix (Prescott),85658,17562,368,262,248,878,0.049994306
Los Angeles,93527,2242,47,31,34,112,0.049955397
Boston (Manchester),2675,7248,123,127,112,362,0.049944812
Phoenix (Prescott),86325,5530,102,89,85,276,0.049909584
Marquette,49920,4268,80,73,60,213,0.049906279
Austin,78058,1263,21,27,15,63,0.049881235
"Washington, DC (Hagrstwn)",22488,1243,25,21,16,62,0.049879324
Savannah,31328,3129,51,59,46,156,0.049856184
Albany-Schenectady-Troy,12190,682,13,11,10,34,0.049853372
Greenwood-Greenville,38737,5798,110,92,87,289,0.049844774
Fargo,56586,1988,37,28,34,99,0.049798793
Clarksburg-Weston,26280,1446,30,21,21,72,0.049792531
Burlington-Plattsburgh,3586,703,15,10,10,35,0.049786629
Boston (Manchester),2535,1828,19,38,34,91,0.049781182
Minneapolis-St. Paul,54870,1708,34,32,19,85,0.049765808
Duluth-Superior,55781,623,13,10,8,31,0.04975923
Wichita-Hutchinson Plus,67065,201,5,3,2,10,0.049751244
Reno,89419,4784,96,72,70,238,0.049749164
Norfolk-Portsmth-Newpt Nws,23076,985,23,13,13,49,0.049746193
Marquette,49817,362,7,5,6,18,0.049723757
Billings,59067,181,4,2,3,9,0.049723757
Seattle-Tacoma,98355,704,13,9,13,35,0.049715909
Mobile-Pensacola (Ft Walt),36528,1730,27,25,34,86,0.049710983
Sioux Falls(Mitchell),57260,1006,22,18,10,50,0.049701789
Duluth-Superior,55602,302,6,4,5,15,0.049668874
Portland-Auburn,4854,1450,32,19,21,72,0.049655172
Bismarck-Mnt-Dcknsn(Wlstn),58787,141,4,2,1,7,0.04964539
Corpus Christi,78353,423,12,7,2,21,0.04964539
Lubbock,79256,282,8,3,3,14,0.04964539
New York,11939,1028,15,27,9,51,0.049610895
Albany-Schenectady-Troy,12147,484,8,8,8,24,0.049586777
Billings,59028,363,9,6,3,18,0.049586777
Richmond-Petersburg,23845,343,6,5,6,17,0.049562682
Albany-Schenectady-Troy,12847,666,14,11,8,33,0.04954955
Clarksburg-Weston,26263,323,7,4,5,16,0.049535604
"Springfield, MO",65641,1272,24,20,19,63,0.049528302
Lincoln & Hastings-Krny,68328,424,9,7,5,21,0.049528302
Burlington-Plattsburgh,5350,808,18,9,13,40,0.04950495
San Francisco-Oak-San Jose,95417,202,5,2,3,10,0.04950495
Ft. Myers-Naples,33903,24645,385,436,399,1220,0.049502942
Missoula,59874,2000,45,38,16,99,0.0495
Orlando-Daytona Bch-Melbrn,32118,17638,241,306,326,873,0.049495408
Macon,31012,2446,47,43,31,121,0.04946852
Wausau-Rhinelander,54428,1011,19,19,12,50,0.049455984
Bangor,4624,182,2,5,2,9,0.049450549
Little Rock-Pine Bluff,72528,182,3,3,3,9,0.049450549
New York,8008,6816,85,129,123,337,0.049442488
Salisbury,21821,890,17,12,15,44,0.049438202
Austin,78675,263,6,4,3,13,0.049429658
Ft. Myers-Naples,33980,12751,227,211,192,630,0.04940789
Burlington-Plattsburgh,3745,1518,25,27,23,75,0.049407115
Sioux City,51029,243,4,3,5,12,0.049382716
Sioux Falls(Mitchell),57538,243,6,3,3,12,0.049382716
Dallas-Ft. Worth,76453,1215,23,21,16,60,0.049382716
Las Vegas,89054,81,2,1,1,4,0.049382716
Spokane,97846,2127,38,34,33,105,0.049365303
Fresno-Visalia,95345,628,14,7,10,31,0.049363057
Greenville-N.Bern-Washngtn,28556,750,14,13,10,37,0.049333333
Bangor,4631,1257,20,20,22,62,0.049323787
Spokane,83839,1541,32,18,26,76,0.049318624
Seattle-Tacoma,98303,1379,24,22,22,68,0.049311095
Burlington-Plattsburgh,5742,568,12,8,8,28,0.049295775
Amarillo,88426,1116,25,17,13,55,0.049283154
Sacramnto-Stkton-Modesto,95941,487,14,6,4,24,0.049281314
Panama City,32460,5561,95,95,84,274,0.049271714
Utica,13420,1360,23,23,21,67,0.049264706
Duluth-Superior,55604,3796,74,53,60,187,0.049262381
Palm Springs,92211,28120,433,426,526,1385,0.049253201
Traverse City-Cadillac,49709,3614,77,46,55,178,0.049252905
New York,12457,731,14,12,10,36,0.049247606
Greenvll-Spart-Ashevll-And,28774,1584,22,30,26,78,0.049242424
Medford-Klamath Falls,97639,264,6,4,3,13,0.049242424
Philadelphia,8202,1341,15,24,27,66,0.049217002
Green Bay-Appleton,54114,5873,111,79,99,289,0.049208241
Phoenix (Prescott),86327,13128,268,192,186,646,0.0492078
Burlington-Plattsburgh,5067,122,3,1,2,6,0.049180328
Albany-Schenectady-Troy,12139,183,2,4,3,9,0.049180328
Macon,31045,61,1,1,1,3,0.049180328
Sioux Falls(Mitchell),57571,61,1,1,1,3,0.049180328
Helena,59640,61,1,1,1,3,0.049180328
Cleveland-Akron (Canton),44040,3071,72,49,30,151,0.049169652
West Palm Beach-Ft. Pierce,33408,19830,288,296,390,974,0.049117499
Portland-Auburn,4539,1405,33,17,19,69,0.04911032
Portland-Auburn,4537,2159,39,32,35,106,0.049096804
Marquette,49953,2587,57,34,36,127,0.049091612
Green Bay-Appleton,54960,2730,48,43,43,134,0.049084249
Bangor,4652,1528,29,24,22,75,0.04908377
Burlington-Plattsburgh,5358,326,6,5,5,16,0.049079755
Phoenix (Prescott),86404,19502,336,296,325,957,0.04907189
Eugene,97419,1121,20,20,15,55,0.049063336
Waco-Temple-Bryan,76871,693,13,11,10,34,0.049062049
Eugene,97731,265,5,5,3,13,0.049056604
Sacramnto-Stkton-Modesto,95629,897,16,13,15,44,0.049052397
Paducah-Cape Girard-Harsbg,38079,4363,91,64,59,214,0.04904882
Minneapolis-St. Paul,56174,367,8,5,5,18,0.049046322
Sacramnto-Stkton-Modesto,96105,571,11,9,8,28,0.049036778
Salisbury,19958,33997,577,561,529,1667,0.049033738
Sacramnto-Stkton-Modesto,95935,979,20,15,13,48,0.049029622
Chico-Redding,95930,102,3,1,1,5,0.049019608
Waco-Temple-Bryan,76872,653,13,8,11,32,0.049004594
Los Angeles,92285,2246,41,34,35,110,0.048975957
"Springfield, MO",65774,878,16,10,17,43,0.048974943
Sioux Falls(Mitchell),57054,429,12,5,4,21,0.048951049
Bismarck-Mnt-Dcknsn(Wlstn),58748,143,3,2,2,7,0.048951049
Albuquerque-Santa Fe,87501,15207,196,229,319,744,0.048924837
"Bend, OR",97707,8670,150,134,140,424,0.048904268
Binghamton,13740,532,12,9,5,26,0.04887218
Seattle-Tacoma,98533,532,12,7,7,26,0.04887218
Fargo,56686,839,18,12,11,41,0.0488677
Roanoke-Lynchburg,24924,348,7,4,6,17,0.048850575
Buffalo,16744,164,2,3,3,8,0.048780488
Sioux Falls(Mitchell),57648,369,9,5,4,18,0.048780488
Topeka,66955,82,1,1,2,4,0.048780488
San Antonio,78885,410,8,7,5,20,0.048780488
Denver,80467,2378,49,34,33,116,0.048780488
Denver,82332,82,2,1,1,4,0.048780488
Las Vegas,89039,205,5,4,1,10,0.048780488
Spokane,99131,123,2,2,2,6,0.048780488
Rapid City,82729,2340,37,38,39,114,0.048717949
Tampa-St. Pete (Sarasota),33876,5318,107,80,72,259,0.04870252
Burlington-Plattsburgh,3740,1027,19,17,14,50,0.048685492
Green Bay-Appleton,54125,493,8,9,7,24,0.048681542
"Springfield, MO",65724,1398,21,26,21,68,0.048640916
Watertown,13690,658,14,7,11,32,0.048632219
Bismarck-Mnt-Dcknsn(Wlstn),59274,329,5,6,5,16,0.048632219
Honolulu,96722,2406,47,40,30,117,0.048628429
Alpena,48721,473,10,6,7,23,0.048625793
Bismarck-Mnt-Dcknsn(Wlstn),58332,288,4,4,6,14,0.048611111
Denver,81434,144,3,1,3,7,0.048611111
Hartford & New Haven,6426,3477,65,52,52,169,0.048605119
Billings,82190,391,3,8,8,19,0.04859335
Ft. Myers-Naples,34135,51086,814,813,855,2482,0.048584739
Buffalo,17729,103,2,1,2,5,0.048543689
Fargo,58035,309,6,4,5,15,0.048543689
Traverse City-Cadillac,49853,1319,24,21,19,64,0.048521607
Denver,80804,371,7,4,7,18,0.04851752
Sacramnto-Stkton-Modesto,95255,1938,37,30,27,94,0.048503612
Lubbock,79330,165,3,3,2,8,0.048484848
Little Rock-Pine Bluff,72566,557,8,9,10,27,0.048473968
Tampa-St. Pete (Sarasota),34429,9201,147,135,164,446,0.048472992
Presque Isle,4783,454,8,7,7,22,0.04845815
Rochestr-Mason City-Austin,50433,227,4,3,4,11,0.04845815
Colorado Springs-Pueblo,81081,351,7,5,5,17,0.048433048
Missoula,59873,3511,54,45,71,170,0.048419254
Utica,13338,1219,19,18,22,59,0.048400328
Greenville-N.Bern-Washngtn,27826,1178,28,16,13,57,0.048387097
Tallahassee-Thomasville,32346,1860,29,37,24,90,0.048387097
Idaho Fals-Pocatllo(Jcksn),83227,62,1,1,1,3,0.048387097
Albuquerque-Santa Fe,87064,62,1,1,1,3,0.048387097
Sacramnto-Stkton-Modesto,95983,248,4,4,4,12,0.048387097
Wichita-Hutchinson Plus,67437,951,20,13,13,46,0.048370137
Tampa-St. Pete (Sarasota),34238,22700,431,364,303,1098,0.048370044
Denver,80816,7755,128,124,123,375,0.048355899
Sioux Falls(Mitchell),57631,331,8,5,3,16,0.048338369
New York,12495,207,4,4,2,10,0.048309179
Marquette,49952,145,3,2,2,7,0.048275862
Chico-Redding,96015,290,6,4,4,14,0.048275862
Minneapolis-St. Paul,55384,1678,23,27,31,81,0.048271752
Richmond-Petersburg,22578,2341,47,32,34,113,0.04826997
San Francisco-Oak-San Jose,95410,974,15,14,18,47,0.04825462
"Portland, OR",97394,5057,97,81,66,244,0.048249951
Traverse City-Cadillac,48619,539,9,9,8,26,0.048237477
Boston (Manchester),2631,10766,216,149,154,519,0.048207319
Bismarck-Mnt-Dcknsn(Wlstn),58444,166,3,3,2,8,0.048192771
Boise,83666,83,2,1,1,4,0.048192771
Sacramnto-Stkton-Modesto,96129,166,3,3,2,8,0.048192771
Phoenix (Prescott),85266,12056,252,211,118,581,0.048191772
New York,12498,4921,88,74,75,237,0.048160943
Abilene-Sweetwater,79538,270,5,5,3,13,0.048148148
Sacramnto-Stkton-Modesto,95327,8456,157,125,125,407,0.048131504
Spokane,83533,187,4,3,2,9,0.048128342
Sacramnto-Stkton-Modesto,95979,665,14,7,11,32,0.048120301
Ft. Myers-Naples,33908,42677,666,693,694,2053,0.048105537
Roanoke-Lynchburg,24946,1310,26,21,16,63,0.048091603
Wilkes Barre-Scranton-Hztn,18437,104,1,2,2,5,0.048076923
Clarksburg-Weston,26228,104,2,1,2,5,0.048076923
Lincoln & Hastings-Krny,68711,104,3,1,1,5,0.048076923
Spokane,83523,728,18,7,10,35,0.048076923
"Springfield, MO",72642,1977,34,31,30,95,0.048052605
Tampa-St. Pete (Sarasota),34613,20417,355,336,290,981,0.048048195
Spokane,83542,229,4,4,3,11,0.048034934
"Charleston, SC",29590,3458,67,52,47,166,0.048004627
Raleigh-Durham (Fayetvlle),28374,20281,418,296,259,973,0.047975938
Boston (Manchester),2660,6548,112,106,96,314,0.047953574
Wilkes Barre-Scranton-Hztn,17758,1335,22,21,21,64,0.047940075
Denver,81154,1335,23,22,19,64,0.047940075
West Palm Beach-Ft. Pierce,33434,22112,414,372,274,1060,0.047937771
Spokane,98862,2879,60,42,36,138,0.04793331
Idaho Fals-Pocatllo(Jcksn),83463,167,4,2,2,8,0.047904192
Chico-Redding,96061,167,4,2,2,8,0.047904192
Phoenix (Prescott),86315,11231,227,156,155,538,0.047903125
Reno,96137,3027,54,42,49,145,0.047902213
Sacramnto-Stkton-Modesto,96020,2359,48,27,38,113,0.047901653
Sioux Falls(Mitchell),57075,1024,21,16,12,49,0.047851563
Missoula,59866,1233,20,22,17,59,0.04785077
"Washington, DC (Hagrstwn)",21766,627,10,4,16,30,0.04784689
Bismarck-Mnt-Dcknsn(Wlstn),58758,209,4,4,2,10,0.04784689
Bismarck-Mnt-Dcknsn(Wlstn),58721,481,7,4,12,23,0.047817048
Spokane,99157,523,11,7,7,25,0.047801147
Quincy-Hannibal-Keokuk,63474,565,10,11,6,27,0.047787611
Spokane,83876,1800,32,30,24,86,0.047777778
Wausau-Rhinelander,54485,335,8,4,4,16,0.047761194
Spokane,99137,461,7,8,7,22,0.047722343
Burlington-Plattsburgh,12836,503,11,9,4,24,0.047713718
Minneapolis-St. Paul,56662,524,9,10,6,25,0.047709924
Fresno-Visalia,95306,923,17,14,13,44,0.047670639
Pittsburgh,15647,21,0,0,1,1,0.047619048
Des Moines-Ames,50586,294,6,3,5,14,0.047619048
Milwaukee,53099,21,1,0,0,1,0.047619048
Minneapolis-St. Paul,55968,63,1,1,1,3,0.047619048
Bismarck-Mnt-Dcknsn(Wlstn),58716,168,4,2,2,8,0.047619048
Billings,59053,294,7,4,3,14,0.047619048
Great Falls,59430,420,8,5,7,20,0.047619048
Wichita-Hutchinson Plus,67112,210,4,3,3,10,0.047619048
Salt Lake City,89833,21,1,0,0,1,0.047619048
Los Angeles,92561,1722,25,29,28,82,0.047619048
Fresno-Visalia,93262,63,1,1,1,3,0.047619048
"Portland, OR",98602,252,5,3,4,12,0.047619048
Spokane,99160,105,2,2,1,5,0.047619048
Nashville,38256,3174,66,41,44,151,0.047574039
"Portland, OR",98651,967,21,13,12,46,0.047569804
Ft. Myers-Naples,34114,25332,403,405,397,1205,0.047568293
Greenville-N.Bern-Washngtn,28510,1430,19,18,31,68,0.047552448
Salisbury,21634,358,7,4,6,17,0.047486034
Spokane,99153,653,12,10,9,31,0.047473201
Flint-Saginaw-Bay City,48703,3097,48,58,41,147,0.047465289
Tucson (Sierra Vista),85638,1854,35,28,25,88,0.047464941
Wausau-Rhinelander,54560,611,10,11,8,29,0.047463175
Phoenix (Prescott),85623,5840,101,80,96,277,0.047431507
Billings,59061,253,6,4,2,12,0.04743083
Duluth-Superior,54514,1708,38,28,15,81,0.047423888
Spokane,97842,232,4,4,3,11,0.047413793
Los Angeles,92518,1519,24,22,26,72,0.047399605
Miami-Ft. Lauderdale,33019,15077,227,230,257,714,0.047356901
Wilkes Barre-Scranton-Hztn,18472,6850,110,117,97,324,0.04729927
Reno,95223,4253,87,57,57,201,0.047260757
"Portland, OR",97067,1947,34,30,28,92,0.047252183
Colorado Springs-Pueblo,81049,254,5,4,3,12,0.047244094
"Portland, OR",97366,1736,26,26,30,82,0.047235023
"Springfield, MO",65611,1970,30,34,29,93,0.047208122
Bangor,4961,954,18,12,15,45,0.047169811
Sacramnto-Stkton-Modesto,95232,106,1,2,2,5,0.047169811
Salt Lake City,83287,403,11,6,2,19,0.047146402
Marquette,54121,3119,66,45,36,147,0.047130491
Spokane,83525,679,12,13,7,32,0.04712813
Des Moines-Ames,50840,382,10,6,2,18,0.047120419
Atlanta,30545,871,12,14,15,41,0.047072331
Richmond-Petersburg,22511,1041,14,18,17,49,0.047070125
Clarksburg-Weston,26282,170,3,3,2,8,0.047058824
Miami-Ft. Lauderdale,33043,4845,74,65,89,228,0.047058824
Green Bay-Appleton,54156,1530,33,21,18,72,0.047058824
Fargo,58212,425,8,7,5,20,0.047058824
Spokane,83812,85,2,1,1,4,0.047058824
Chico-Redding,95942,1509,41,15,15,71,0.047051027
Roanoke-Lynchburg,22958,1828,26,33,27,86,0.047045952
Boston (Manchester),3450,978,16,16,14,46,0.047034765
Duluth-Superior,55738,489,12,6,5,23,0.047034765
Fargo,58229,149,2,2,3,7,0.046979866
"Portland, OR",97753,2768,56,40,34,130,0.046965318
Lincoln & Hastings-Krny,68879,362,7,4,6,17,0.046961326
Wausau-Rhinelander,54519,1299,25,20,16,61,0.046959199
Greenvll-Spart-Ashevll-And,28741,3985,66,54,67,187,0.046925972
Bismarck-Mnt-Dcknsn(Wlstn),58463,618,11,11,7,29,0.046925566
Greenvll-Spart-Ashevll-And,28745,682,12,8,12,32,0.046920821
Bismarck-Mnt-Dcknsn(Wlstn),58413,1023,17,17,14,48,0.046920821
Bangor,4607,1258,22,19,18,59,0.046899841
Seattle-Tacoma,98340,2730,51,36,41,128,0.046886447
Butte-Bozeman,59722,5759,111,77,82,270,0.046883139
Des Moines-Ames,50227,64,1,1,1,3,0.046875
Fargo,58325,64,1,1,1,3,0.046875
Spokane,83547,448,8,7,6,21,0.046875
Ft. Myers-Naples,34102,10696,192,187,122,501,0.04683994
Portland-Auburn,4571,342,7,4,5,16,0.046783626
Chico-Redding,96052,1668,31,23,24,78,0.04676259
Eugene,97410,877,8,15,18,41,0.046750285
Spokane,83836,1091,18,17,16,51,0.046746104
Sioux Falls(Mitchell),69366,214,3,4,3,10,0.046728972
Sacramnto-Stkton-Modesto,95981,257,6,3,3,12,0.046692607
Presque Isle,4762,557,12,9,5,26,0.046678636
Fargo,58260,150,4,2,1,7,0.046666667
"Springfield, MO",65618,150,3,2,2,7,0.046666667
Bismarck-Mnt-Dcknsn(Wlstn),58530,1286,25,14,21,60,0.046656299
Wausau-Rhinelander,54558,2273,38,35,33,106,0.046634404
Portland-Auburn,4853,386,4,8,6,18,0.046632124
Sacramnto-Stkton-Modesto,96124,386,7,5,6,18,0.046632124
Burlington-Plattsburgh,5767,1094,17,16,18,51,0.046617916
Albany-Schenectady-Troy,12424,236,5,2,4,11,0.046610169
Charleston-Huntington,26611,558,11,8,7,26,0.046594982
Springfield-Holyoke,1330,1331,22,21,19,62,0.046581518
West Palm Beach-Ft. Pierce,32966,21372,323,329,343,995,0.046556242
Portland-Auburn,4013,43,1,1,0,2,0.046511628
Bangor,4693,516,5,10,9,24,0.046511628
Roanoke-Lynchburg,24433,129,2,2,2,6,0.046511628
Atlanta,30522,1204,21,18,17,56,0.046511628
Miami-Ft. Lauderdale,33109,559,10,8,8,26,0.046511628
Fargo,58250,301,4,5,5,14,0.046511628
Presque Isle,4739,925,13,16,14,43,0.046486486
Baltimore,21654,1119,14,25,13,52,0.046470063
Bismarck-Mnt-Dcknsn(Wlstn),58348,689,9,10,13,32,0.046444122
Bangor,4684,1723,35,23,22,80,0.046430644
Rapid City,82712,280,6,4,3,13,0.046428571
Richmond-Petersburg,22482,2328,43,27,38,108,0.046391753
Memphis,38075,6814,103,113,100,316,0.04637511
Fargo,58230,626,11,7,11,29,0.046325879
Miami-Ft. Lauderdale,33308,27532,315,436,524,1275,0.046309749
Burlington-Plattsburgh,12932,1296,20,18,22,60,0.046296296
Charleston-Huntington,41214,2335,41,33,34,108,0.046252677
Richmond-Petersburg,22432,346,6,6,4,16,0.046242775
Odessa-Midland,79734,1687,39,23,16,78,0.046235922
Eugene,97492,584,13,7,7,27,0.046232877
Medford-Klamath Falls,97476,238,5,3,3,11,0.046218487
"Springfield, MO",65681,1861,32,29,25,86,0.046211714
Salisbury,19971,15672,253,232,239,724,0.046197039
Fargo,58355,65,2,1,0,3,0.046153846
Wichita Falls & Lawton,73551,65,1,1,1,3,0.046153846
Spokane,99154,65,1,1,1,3,0.046153846
Wichita Falls & Lawton,76305,9065,146,139,133,418,0.046111418
Wausau-Rhinelander,54568,5422,97,86,67,250,0.046108447
Tucson (Sierra Vista),85611,1410,26,19,20,65,0.046099291
Albuquerque-Santa Fe,88318,282,5,4,4,13,0.046099291
Denver,80447,1996,28,24,40,92,0.046092184
Utica,13494,217,3,3,4,10,0.046082949
Las Vegas,89061,9030,136,129,151,416,0.04606866
Clarksburg-Weston,26178,456,9,5,7,21,0.046052632
Topeka,66849,456,12,5,4,21,0.046052632
Lincoln & Hastings-Krny,66930,152,3,2,2,7,0.046052632
Burlington-Plattsburgh,5758,782,16,9,11,36,0.046035806
Medford-Klamath Falls,97627,630,12,10,7,29,0.046031746
Sherman-Ada,74540,239,4,3,4,11,0.046025105
Billings,82442,717,13,9,11,33,0.046025105
Green Bay-Appleton,54491,1608,33,20,21,74,0.0460199
Minneapolis-St. Paul,55767,4303,87,60,51,198,0.046014409
Medford-Klamath Falls,97444,5436,98,77,75,250,0.045989698
New York,12788,3588,45,54,66,165,0.045986622
Portland-Auburn,4360,609,14,6,8,28,0.045977011
Bangor,4613,261,5,3,4,12,0.045977011
New York,12433,435,9,6,5,20,0.045977011
San Angelo,76887,87,2,1,1,4,0.045977011
Minneapolis-St. Paul,55003,3981,80,61,42,183,0.04596835
Los Angeles,90067,2699,27,33,64,124,0.045942942
Salisbury,21677,392,8,6,4,18,0.045918367
Portland-Auburn,3838,806,14,13,10,37,0.045905707
Colorado Springs-Pueblo,81223,2508,46,37,32,115,0.04585327
Portland-Auburn,3836,1789,25,23,34,82,0.045835662
Greenvll-Spart-Ashevll-And,28717,1506,21,22,26,69,0.045816733
Chico-Redding,96112,131,3,2,1,6,0.045801527
San Francisco-Oak-San Jose,95421,1376,20,19,24,63,0.045784884
Fargo,56587,1529,35,17,18,70,0.045781557
Traverse City-Cadillac,48636,852,12,13,14,39,0.045774648
Great Falls,59451,284,5,3,5,13,0.045774648
Idaho Fals-Pocatllo(Jcksn),83246,1027,18,17,12,47,0.045764362
Portland-Auburn,4564,459,11,4,6,21,0.045751634
Idaho Fals-Pocatllo(Jcksn),83278,416,3,4,12,19,0.045673077
Ft. Smith-Fay-Sprngdl-Rgrs,74939,1533,22,24,24,70,0.0456621
Spokane,83808,219,5,3,2,10,0.0456621
Albany-Schenectady-Troy,1254,942,15,11,17,43,0.045647558
Albuquerque-Santa Fe,87820,241,4,4,3,11,0.045643154
Bismarck-Mnt-Dcknsn(Wlstn),58650,263,4,2,6,12,0.045627376
Omaha,68457,285,3,5,5,13,0.045614035
Phoenix (Prescott),85924,3223,55,51,41,147,0.04560968
Presque Isle,4774,636,11,8,10,29,0.045597484
Butte-Bozeman,59720,417,6,6,7,19,0.045563549
Medford-Klamath Falls,97737,461,8,6,7,21,0.045553145
Orlando-Daytona Bch-Melbrn,32176,14513,219,222,220,661,0.045545373
Portland-Auburn,4538,1933,30,23,35,88,0.045525091
Spokane,83803,681,16,7,8,31,0.045521292
Colorado Springs-Pueblo,81055,1582,27,24,21,72,0.04551201
"Springfield, MO",65747,3340,70,40,42,152,0.045508982
Macon,30411,4462,71,75,57,203,0.045495294
Albany-Schenectady-Troy,12842,1143,19,17,16,52,0.045494313
Burlington-Plattsburgh,12911,22,1,0,0,1,0.045454545
Wilkes Barre-Scranton-Hztn,18825,132,2,2,2,6,0.045454545
Cedar Rapids-Wtrlo-IWC&Dub,52562,44,1,0,1,2,0.045454545
Duluth-Superior,54565,66,1,1,1,3,0.045454545
Great Falls,59424,88,2,1,1,4,0.045454545
Denver,82224,22,0,0,1,1,0.045454545
Chico-Redding,96088,4906,93,65,65,223,0.045454545
Seattle-Tacoma,98261,2972,55,38,42,135,0.045423957
Burlington-Plattsburgh,5905,771,16,11,8,35,0.04539559
Bakersfield,93285,2820,54,24,50,128,0.045390071
Springfield-Holyoke,1098,1234,23,19,14,56,0.045380875
Portland-Auburn,3846,992,17,16,12,45,0.045362903
Spokane,99117,485,9,6,7,22,0.045360825
Baltimore,21671,772,14,6,15,35,0.045336788
Fargo,58416,375,6,4,7,17,0.045333333
Spokane,83549,750,13,12,9,34,0.045333333
Eugene,97449,2206,36,26,38,100,0.045330916
"Springfield, MO",65761,1148,21,18,13,52,0.045296167
Richmond-Petersburg,23922,4195,61,65,64,190,0.045292014
St. Louis,63036,1259,18,23,16,57,0.045274027
Wilkes Barre-Scranton-Hztn,17776,243,4,4,3,11,0.04526749
Salt Lake City,83272,221,6,3,1,10,0.045248869
Ft. Myers-Naples,34110,25866,437,380,353,1170,0.045233125
Spokane,83537,1216,22,17,16,55,0.045230263
Albany-Schenectady-Troy,12032,575,9,7,10,26,0.045217391
Portland-Auburn,3905,1947,36,29,23,88,0.04519774
Duluth-Superior,54517,177,3,2,3,8,0.04519774
Duluth-Superior,56639,354,7,3,6,16,0.04519774
Portland-Auburn,4562,2257,42,33,27,102,0.045192734
Denver,80818,332,6,4,5,15,0.045180723
Albany-Schenectady-Troy,12874,155,3,3,1,7,0.04516129
Orlando-Daytona Bch-Melbrn,32931,13812,229,218,176,623,0.045105705
Eugene,97450,754,16,10,8,34,0.045092838
Boston (Manchester),2642,5791,102,89,70,261,0.045069936
Tucson (Sierra Vista),85624,1487,26,23,18,67,0.045057162
Burlington-Plattsburgh,5056,444,7,7,6,20,0.045045045
"Springfield, MO",72619,1998,37,24,29,90,0.045045045
Miami-Ft. Lauderdale,33036,3511,54,48,56,158,0.045001424
Denver,81640,200,4,2,3,9,0.045
Oklahoma City,73726,489,8,8,6,22,0.044989775
"Springfield, MO",65668,1645,26,28,20,74,0.044984802
Sacramnto-Stkton-Modesto,95684,3246,64,44,38,146,0.044978435
Orlando-Daytona Bch-Melbrn,32949,3759,65,58,46,169,0.044958766
Tampa-St. Pete (Sarasota),33708,15726,229,251,227,707,0.044957395
Bismarck-Mnt-Dcknsn(Wlstn),58712,89,1,1,2,4,0.04494382
Oklahoma City,74632,445,4,6,10,20,0.04494382
Ft. Myers-Naples,34269,5051,82,73,72,227,0.044941596
Marquette,49947,512,9,8,6,23,0.044921875
Burlington-Plattsburgh,5730,490,10,5,7,22,0.044897959
Duluth-Superior,55752,490,7,6,9,22,0.044897959
Alpena,48762,869,11,15,13,39,0.044879171
Albany-Schenectady-Troy,12194,156,3,2,2,7,0.044871795
Pittsburgh,15828,312,6,4,4,14,0.044871795
Seattle-Tacoma,98575,156,4,1,2,7,0.044871795
Clarksburg-Weston,26260,1271,23,19,15,57,0.044846577
Spokane,98859,357,6,7,3,16,0.044817927
Amarillo,79255,424,11,5,3,19,0.044811321
Fargo,58269,201,6,2,1,9,0.044776119
Fargo,58484,67,1,1,1,3,0.044776119
Grand Junction-Montrose,81411,67,1,1,1,3,0.044776119
Missoula,59829,2527,45,37,31,113,0.044717056
Sacramnto-Stkton-Modesto,95666,5591,104,61,85,250,0.04471472
Austin,78672,1029,17,14,15,46,0.044703596
Ft. Myers-Naples,33917,33620,497,503,502,1502,0.044675788
Portland-Auburn,4109,112,1,3,1,5,0.044642857
Bangor,4487,784,12,14,9,35,0.044642857
Bangor,4669,112,1,3,1,5,0.044642857
Eugene,97473,224,5,3,2,10,0.044642857
Rapid City,57730,5668,104,72,77,253,0.044636556
Buffalo,16738,2423,30,34,44,108,0.044572844
Boston (Manchester),2633,4667,73,67,68,208,0.044568245
Tampa-St. Pete (Sarasota),33573,35224,585,499,485,1569,0.044543493
Denver,80834,292,6,2,5,13,0.044520548
Medford-Klamath Falls,96057,1168,14,16,22,52,0.044520548
Houston,75851,4493,85,69,46,200,0.044513688
Albany-Schenectady-Troy,5776,337,7,5,3,15,0.044510386
San Francisco-Oak-San Jose,94970,674,9,12,9,30,0.044510386
"Portland, OR",97102,337,4,7,4,15,0.044510386
Portland-Auburn,4108,899,17,12,11,40,0.044493882
Missoula,59868,2069,39,27,26,92,0.044465926
Sioux City,51015,45,1,1,0,2,0.044444444
Fargo,58210,225,3,3,4,10,0.044444444
Spokane,83802,45,1,1,0,2,0.044444444
Los Angeles,92242,1193,16,19,18,53,0.044425817
"Jackson, TN",38425,3602,59,54,47,160,0.044419767
Duluth-Superior,54838,1441,25,19,20,64,0.044413602
Tallahassee-Thomasville,32359,1869,29,28,26,83,0.044408775
Traverse City-Cadillac,49838,518,7,9,7,23,0.044401544
Minneapolis-St. Paul,55756,428,11,2,6,19,0.044392523
Omaha,68442,248,2,5,4,11,0.044354839
"Portland, OR",97364,496,7,8,7,22,0.044354839
Green Bay-Appleton,54234,2187,28,29,40,97,0.044352995
Burlington-Plattsburgh,5474,1015,15,14,16,45,0.044334975
Ft. Myers-Naples,33981,16219,284,225,210,719,0.044330723
Albany-Schenectady-Troy,12808,361,6,3,7,16,0.04432133
Wausau-Rhinelander,53936,1354,26,17,17,60,0.044313146
"Portland, OR",97063,1219,23,19,12,54,0.044298605
Flint-Saginaw-Bay City,48737,1016,15,17,13,45,0.044291339
Denver,80536,1874,37,22,24,83,0.044290288
San Francisco-Oak-San Jose,95462,1175,19,19,14,52,0.044255319
Minneapolis-St. Paul,54769,565,11,7,7,25,0.044247788
San Francisco-Oak-San Jose,94937,1130,20,18,12,50,0.044247788
Wilmington,28461,26345,448,381,336,1165,0.044220915
Peoria-Bloomington,61560,769,15,12,7,34,0.044213264
Duluth-Superior,54896,1742,42,14,21,77,0.044202067
Burlington-Plattsburgh,5669,543,11,9,4,24,0.044198895
Colorado Springs-Pueblo,81253,362,9,4,3,16,0.044198895
Eureka,95550,181,3,2,3,8,0.044198895
Fargo,58254,566,12,7,6,25,0.044169611
"Portland, OR",98643,317,5,6,3,14,0.044164038
Seattle-Tacoma,98361,1087,19,13,16,48,0.044158234
Oklahoma City,73716,385,6,6,5,17,0.044155844
"Portland, OR",97834,1133,18,14,18,50,0.044130627
Green Bay-Appleton,54104,1201,17,18,18,53,0.044129892
Jacksonville,32083,3196,58,49,34,141,0.044117647
Des Moines-Ames,50862,136,3,2,1,6,0.044117647
Missoula,59826,612,13,7,7,27,0.044117647
"Springfield, MO",72661,612,11,11,5,27,0.044117647
Minneapolis-St. Paul,56442,2745,53,33,35,121,0.044080146
Portland-Auburn,4936,363,5,6,5,16,0.044077135
New York,12409,1248,19,22,14,55,0.044070513
Santabarbra-Sanmar-Sanluob,93428,5859,87,86,85,258,0.044034818
Albany-Schenectady-Troy,12131,159,3,2,2,7,0.044025157
Reno,89444,2954,60,36,34,130,0.044008125
Bismarck-Mnt-Dcknsn(Wlstn),58783,341,6,3,6,15,0.04398827
Panama City,32550,8505,138,120,116,374,0.043974133
"Portland, OR",97341,2934,45,44,40,129,0.04396728
Albany-Schenectady-Troy,13436,91,2,1,1,4,0.043956044
Medford-Klamath Falls,97640,91,2,1,1,4,0.043956044
Marquette,54542,569,13,7,5,25,0.043936731
Orlando-Daytona Bch-Melbrn,32920,9471,98,148,170,416,0.043923556
Spokane,83846,797,9,7,19,35,0.04391468
Tucson (Sierra Vista),85606,1025,14,15,16,45,0.043902439
Madison,53952,4260,71,57,59,187,0.043896714
Seattle-Tacoma,98382,31516,482,463,438,1383,0.043882472
Portland-Auburn,4859,661,10,8,11,29,0.04387292
Bangor,4406,821,12,13,11,36,0.043848965
Rochestr-Mason City-Austin,50477,251,3,4,4,11,0.043824701
San Francisco-Oak-San Jose,94924,1461,30,15,19,64,0.043805613
Duluth-Superior,56628,1644,34,16,22,72,0.04379562
Bismarck-Mnt-Dcknsn(Wlstn),58646,1165,26,6,19,51,0.043776824
Watertown,13693,457,5,6,9,20,0.043763676
Seattle-Tacoma,98260,5896,101,85,72,258,0.04375848
"Charleston, SC",29576,36008,580,497,498,1575,0.04374028
Fargo,58361,206,4,3,2,9,0.04368932
Sacramnto-Stkton-Modesto,96125,252,3,3,5,11,0.043650794
Tucson (Sierra Vista),85617,1077,15,21,11,47,0.04363974
Sioux Falls(Mitchell),57216,848,15,11,11,37,0.043632075
Greenvll-Spart-Ashevll-And,29685,1880,22,34,26,82,0.043617021
"Portland, OR",98621,367,6,7,3,16,0.04359673
Panama City,32322,4019,64,54,57,175,0.04354317
Miami-Ft. Lauderdale,33042,6779,93,95,107,295,0.043516743
Albany-Schenectady-Troy,12854,23,1,0,0,1,0.043478261
Marquette,49967,529,9,7,7,23,0.043478261
Bismarck-Mnt-Dcknsn(Wlstn),58737,161,2,1,4,7,0.043478261
Denver,81243,138,2,3,1,6,0.043478261
Denver,81633,46,1,0,1,2,0.043478261
Denver,82323,115,3,1,1,5,0.043478261
Sacramnto-Stkton-Modesto,95910,138,2,1,3,6,0.043478261
New York,8757,35645,497,530,522,1549,0.043456305
Tampa-St. Pete (Sarasota),33785,5063,86,64,70,220,0.043452499
Greenvll-Spart-Ashevll-And,28746,2764,39,46,35,120,0.04341534
Wausau-Rhinelander,54531,1475,36,13,15,64,0.043389831
Rapid City,57735,1429,28,13,21,62,0.043386984
Marquette,49965,438,9,6,4,19,0.043378995
"Rochester, NY",14555,900,15,10,14,39,0.043333333
Baltimore,21051,416,9,6,3,18,0.043269231
Fargo,58277,208,3,2,4,9,0.043269231
Roanoke-Lynchburg,24413,185,2,3,3,8,0.043243243
Albuquerque-Santa Fe,88312,2960,50,37,41,128,0.043243243
Joplin-Pittsburg,67047,672,14,9,6,29,0.043154762
Spokane,99147,255,5,3,3,11,0.043137255
West Palm Beach-Ft. Pierce,33437,38212,505,506,637,1648,0.043127813
Wausau-Rhinelander,54613,1879,38,21,22,81,0.043108036
Sacramnto-Stkton-Modesto,95246,1417,25,14,22,61,0.043048694
Mobile-Pensacola (Ft Walt),36549,5831,97,83,71,251,0.04304579
Kansas City,64651,535,12,7,4,23,0.042990654
Boston (Manchester),2638,3490,59,52,39,150,0.042979943
Columbia-Jefferson City,65037,4843,93,52,63,208,0.042948586
Greenvll-Spart-Ashevll-And,28751,3915,59,44,65,168,0.042911877
Ft. Myers-Naples,34103,12309,205,175,148,528,0.042895442
Phoenix (Prescott),86429,7416,114,91,113,318,0.042880259
Fargo,58009,70,1,1,1,3,0.042857143
Bismarck-Mnt-Dcknsn(Wlstn),58772,140,2,1,3,6,0.042857143
Burlington-Plattsburgh,5053,257,5,3,3,11,0.042801556
Orlando-Daytona Bch-Melbrn,32951,11520,207,182,104,493,0.042795139
Oklahoma City,73741,1753,27,26,22,75,0.042783799
Albuquerque-Santa Fe,87829,374,7,6,3,16,0.042780749
Chico-Redding,96091,562,9,8,7,24,0.042704626
Sacramnto-Stkton-Modesto,95257,492,10,5,6,21,0.042682927
Medford-Klamath Falls,97733,1031,17,16,11,44,0.042677013
Butte-Bozeman,59749,2039,31,31,25,87,0.042667974
Fargo,58317,211,4,3,2,9,0.042654028
Seattle-Tacoma,98548,2393,42,30,30,102,0.042624321
Colorado Springs-Pueblo,81020,892,13,15,10,38,0.042600897
Denver,81610,329,6,3,5,14,0.042553191
Greenville-N.Bern-Washngtn,28531,1152,13,15,21,49,0.042534722
Fargo,58365,212,4,3,2,9,0.04245283
Norfolk-Portsmth-Newpt Nws,23130,165,2,3,2,7,0.042424242
Fargo,58448,283,4,3,5,12,0.042402827
New York,12448,236,4,4,2,10,0.042372881
Salisbury,19970,9160,136,126,126,388,0.042358079
Sioux Falls(Mitchell),69350,307,2,7,4,13,0.042345277
Roanoke-Lynchburg,26273,2008,37,24,24,85,0.042330677
Seattle-Tacoma,98249,5273,80,69,74,223,0.042290916
Anchorage,99639,1088,20,14,12,46,0.042279412
Bismarck-Mnt-Dcknsn(Wlstn),59214,142,2,2,2,6,0.042253521
Spokane,83520,213,6,2,1,9,0.042253521
"Portland, OR",97817,71,1,1,1,3,0.042253521
Seattle-Tacoma,98536,284,5,4,3,12,0.042253521
Seattle-Tacoma,98368,17040,258,209,252,719,0.042194836
Medford-Klamath Falls,97406,237,5,3,2,10,0.042194093
Bismarck-Mnt-Dcknsn(Wlstn),58736,403,6,4,7,17,0.042183623
Eugene,97493,261,5,3,3,11,0.042145594
West Palm Beach-Ft. Pierce,33446,34275,586,471,386,1443,0.042100656
Springfield-Holyoke,1070,594,9,10,6,25,0.042087542
Wausau-Rhinelander,54554,998,18,14,10,42,0.042084168
Minneapolis-St. Paul,56655,1474,26,19,17,62,0.042062415
Eugene,97439,16099,243,219,215,677,0.042052301
Denver,80510,452,8,8,3,19,0.042035398
Minneapolis-St. Paul,54830,3426,55,42,47,144,0.042031524
Buffalo,16732,119,1,2,2,5,0.042016807
Tampa-St. Pete (Sarasota),34446,19873,332,256,247,835,0.042016807
Kansas City,66031,762,3,15,14,32,0.041994751
Bismarck-Mnt-Dcknsn(Wlstn),58710,405,7,4,6,17,0.041975309
Albany-Schenectady-Troy,12444,429,8,4,6,18,0.041958042
Sioux Falls(Mitchell),57520,143,2,2,2,6,0.041958042
Boston (Manchester),2670,1502,18,17,28,63,0.041944075
Green Bay-Appleton,54210,1098,17,16,13,46,0.041894353
Las Vegas,89134,24014,388,331,287,1006,0.04189223
"Springfield, MO",65729,191,2,3,3,8,0.041884817
Albany-Schenectady-Troy,12821,979,15,13,13,41,0.041879469
Portland-Auburn,4544,717,11,9,10,30,0.041841004
Helena,59639,1243,32,9,11,52,0.041834272
Denver,80815,789,15,4,14,33,0.041825095
Richmond-Petersburg,22539,2200,36,30,26,92,0.041818182
Greenville-N.Bern-Washngtn,28511,550,8,7,8,23,0.041818182
Albuquerque-Santa Fe,88339,910,15,11,12,38,0.041758242
"Springfield, MO",65686,4508,87,59,42,188,0.041703638
Burlington-Plattsburgh,5084,168,3,2,2,7,0.041666667
Burlington-Plattsburgh,12858,48,1,0,1,2,0.041666667
Alpena,48705,600,10,8,7,25,0.041666667
Sioux Falls(Mitchell),57346,48,0,1,1,2,0.041666667
Wichita-Hutchinson Plus,67036,120,2,1,2,5,0.041666667
Wichita-Hutchinson Plus,67545,168,2,3,2,7,0.041666667
Denver,82052,120,2,1,2,5,0.041666667
Rapid City,82711,72,1,1,1,3,0.041666667
Rapid City,82714,96,1,1,2,4,0.041666667
Albuquerque-Santa Fe,88417,72,1,1,1,3,0.041666667
San Francisco-Oak-San Jose,95443,192,3,2,3,8,0.041666667
Spokane,83833,1681,30,19,21,70,0.04164188
Denver,81236,1225,21,15,15,51,0.041632653
Chico-Redding,96024,1033,16,13,14,43,0.041626331
Orlando-Daytona Bch-Melbrn,34762,1874,27,25,26,78,0.041622199
"Portland, OR",97376,1755,28,19,26,73,0.041595442
Phoenix (Prescott),86332,1708,27,21,23,71,0.041569087
Panama City,32445,2478,34,37,32,103,0.041565779
Phoenix (Prescott),85268,24502,378,321,318,1017,0.041506816
Tampa-St. Pete (Sarasota),34236,15423,134,225,281,640,0.041496466
Phoenix (Prescott),86413,14853,249,192,175,616,0.041473103
Bangor,4441,1307,24,13,17,54,0.041315991
Tampa-St. Pete (Sarasota),34275,25339,375,359,312,1046,0.04128024
Columbia-Jefferson City,65079,4390,66,57,58,181,0.041230068
Wausau-Rhinelander,54539,1504,23,22,17,62,0.041223404
Spokane,83848,267,3,3,5,11,0.041198502
Minneapolis-St. Paul,54888,1482,26,17,18,61,0.041160594
Medford-Klamath Falls,97497,1264,25,17,10,52,0.041139241
Fargo,58339,73,1,1,1,3,0.04109589
Seattle-Tacoma,98262,998,14,11,16,41,0.041082164
Seattle-Tacoma,98547,1389,18,22,17,57,0.041036717
Albuquerque-Santa Fe,87010,1170,13,15,20,48,0.041025641
Tucson (Sierra Vista),85625,1926,27,27,25,79,0.041017653
Norfolk-Portsmth-Newpt Nws,23651,634,4,14,8,26,0.041009464
Seattle-Tacoma,98253,2146,31,25,32,88,0.041006524
New York,8735,3076,37,47,42,126,0.040962289
Philadelphia,19436,391,6,6,4,16,0.040920716
Macon,31018,2593,43,31,32,106,0.04087929
Miami-Ft. Lauderdale,33062,24198,242,329,418,989,0.040871146
Portland-Auburn,4558,392,8,3,5,16,0.040816327
Fargo,58331,147,3,2,1,6,0.040816327
Wichita-Hutchinson Plus,67529,294,6,3,3,12,0.040816327
Traverse City-Cadillac,49630,1471,26,13,21,60,0.040788579
Traverse City-Cadillac,49777,1741,23,24,24,71,0.04078116
West Palm Beach-Ft. Pierce,34996,11332,178,167,117,462,0.040769502
Davenport-R.Island-Moline,61285,2948,44,42,34,120,0.040705563
San Angelo,76837,2285,29,30,34,93,0.040700219
Savannah,29928,16562,204,244,226,674,0.040695568
New York,11957,984,15,15,10,40,0.040650407
Denver,82321,665,15,7,5,27,0.040601504
Rochestr-Mason City-Austin,50482,715,13,7,9,29,0.040559441
Austin,78607,148,2,2,2,6,0.040540541
Rapid City,82723,222,4,3,2,9,0.040540541
"Portland, OR",97136,2073,27,30,27,84,0.040520984
Boise,83637,321,7,4,2,13,0.040498442
Utica,13331,173,2,2,3,7,0.040462428
Fargo,58276,421,7,3,7,17,0.040380048
Oklahoma City,73047,6365,100,92,65,257,0.040377062
Colorado Springs-Pueblo,81024,223,4,2,3,9,0.040358744
Minneapolis-St. Paul,56452,1934,30,21,27,78,0.04033092
Marquette,49948,521,7,7,7,21,0.040307102
Albany-Schenectady-Troy,12492,323,6,5,2,13,0.040247678
Duluth-Superior,54827,323,4,4,5,13,0.040247678
Traverse City-Cadillac,49670,1889,30,25,21,76,0.040232927
Albuquerque-Santa Fe,87540,970,13,13,13,39,0.040206186
Duluth-Superior,55603,597,11,7,6,24,0.040201005
Bakersfield,93238,1271,22,10,19,51,0.040125885
Boston (Manchester),2646,1995,24,25,31,80,0.040100251
"Springfield, MO",72668,474,6,6,7,19,0.040084388
Joplin-Pittsburg,66777,549,10,7,5,22,0.04007286
Flint-Saginaw-Bay City,48811,7621,105,94,106,305,0.040020995
Bluefield-Beckley-Oak Hill,24724,25,1,0,0,1,0.04
"Jackson, MS",39173,25,1,0,0,1,0.04
Marquette,49925,500,6,7,7,20,0.04
Fargo,58065,25,1,0,0,1,0.04
Butte-Bozeman,59745,100,2,1,1,4,0.04
Wichita-Hutchinson Plus,67122,175,3,2,2,7,0.04
Wichita-Hutchinson Plus,67137,525,9,6,6,21,0.04
Little Rock-Pine Bluff,72540,100,2,1,1,4,0.04
Denver,80827,950,18,12,8,38,0.04
Medford-Klamath Falls,97637,100,2,1,1,4,0.04
Tampa-St. Pete (Sarasota),34442,17447,269,220,208,697,0.039949562
Burlington-Plattsburgh,5463,551,9,4,9,22,0.039927405
Spokane,83541,1052,24,10,8,42,0.039923954
Denver,81220,251,3,5,2,10,0.039840637
Yuma-El Centro,85367,22320,345,283,261,889,0.039829749
Salisbury,19930,2939,27,44,46,117,0.039809459
Denver,80481,578,7,9,7,23,0.039792388
Portland-Auburn,3227,1257,19,15,16,50,0.039777247
Johnstown-Altoona-St Colge,15832,327,4,3,6,13,0.039755352
Ft. Myers-Naples,33953,8080,121,88,112,321,0.039727723
Boston (Manchester),2653,6344,83,82,87,252,0.039722573
Salisbury,21622,403,8,4,4,16,0.039702233
Chico-Redding,95916,1209,15,20,13,48,0.039702233
Wilmington,28469,9298,139,131,99,369,0.039685954
Duluth-Superior,55612,479,5,7,7,19,0.039665971
Norfolk-Portsmth-Newpt Nws,23356,1664,27,20,19,66,0.039663462
Oklahoma City,73739,353,5,5,4,14,0.039660057
Boise,83622,2221,44,25,19,88,0.039621792
Wilkes Barre-Scranton-Hztn,18842,101,2,1,1,4,0.03960396
Albuquerque-Santa Fe,87821,1314,27,11,14,52,0.03957382
Marquette,49912,809,11,11,10,32,0.039555006
Little Rock-Pine Bluff,72004,1694,21,16,30,67,0.039551358
Portland-Auburn,3259,253,4,3,3,10,0.039525692
Orlando-Daytona Bch-Melbrn,32136,9286,145,110,112,367,0.039521861
Burlington-Plattsburgh,5907,152,3,2,1,6,0.039473684
Watertown,12922,76,1,1,1,3,0.039473684
Roanoke-Lynchburg,24442,76,1,1,1,3,0.039473684
Greenville-N.Bern-Washngtn,28577,304,4,4,4,12,0.039473684
Anchorage,99631,228,4,2,3,9,0.039473684
Missoula,59867,127,2,2,1,5,0.039370079
Sherman-Ada,74576,915,14,9,13,36,0.039344262
Sacramnto-Stkton-Modesto,95720,178,5,1,1,7,0.039325843
Portland-Auburn,4541,51,1,0,1,2,0.039215686
Nashville,37140,1275,18,16,16,50,0.039215686
Chico-Redding,96006,460,10,6,2,18,0.039130435
Salt Lake City,84782,947,13,12,12,37,0.03907075
Johnstown-Altoona-St Colge,15861,128,2,1,2,5,0.0390625
Duluth-Superior,56688,128,2,1,2,5,0.0390625
Gainesville,34498,590,11,6,6,23,0.038983051
Boston (Manchester),1434,1334,17,18,17,52,0.03898051
New Orleans,70091,154,3,1,2,6,0.038961039
Seattle-Tacoma,98222,77,1,1,1,3,0.038961039
Boston (Manchester),2671,1337,25,8,19,52,0.038893044
Phoenix (Prescott),86437,180,2,3,2,7,0.038888889
Chico-Redding,96115,180,4,2,1,7,0.038888889
Wausau-Rhinelander,54512,1004,16,13,10,39,0.038844622
Tucson (Sierra Vista),85640,103,2,1,1,4,0.038834951
Sacramnto-Stkton-Modesto,95934,206,3,1,4,8,0.038834951
San Francisco-Oak-San Jose,94922,335,4,5,4,13,0.03880597
Wausau-Rhinelander,54564,567,9,7,6,22,0.038800705
Colorado Springs-Pueblo,81040,490,7,7,5,19,0.03877551
Casper-Riverton,82513,1781,26,18,25,69,0.03874228
Davenport-R.Island-Moline,61460,284,6,3,2,11,0.038732394
Albuquerque-Santa Fe,87711,284,4,4,3,11,0.038732394
San Francisco-Oak-San Jose,94923,1317,14,20,17,51,0.038724374
Omaha,68348,181,3,2,2,7,0.038674033
Traverse City-Cadillac,49644,1839,28,17,26,71,0.038607939
"Columbus, GA (Opelika, AL)",31815,2021,32,22,24,78,0.038594755
Savannah,29915,622,11,10,3,24,0.038585209
Albuquerque-Santa Fe,87043,5192,65,79,56,200,0.038520801
Utica,13482,26,1,0,0,1,0.038461538
Wichita-Hutchinson Plus,67061,130,2,1,2,5,0.038461538
Denver,82063,78,1,1,1,3,0.038461538
Reno,89413,572,9,6,7,22,0.038461538
Denver,81228,391,6,4,5,15,0.038363171
Little Rock-Pine Bluff,72088,2063,31,23,25,79,0.038293747
Baltimore,21612,418,8,5,3,16,0.038277512
San Antonio,78828,209,4,2,2,8,0.038277512
Phoenix (Prescott),86436,2249,25,31,30,86,0.038239217
Wilmington,28465,8842,122,125,91,338,0.038226646
Tampa-St. Pete (Sarasota),34229,7247,121,98,58,277,0.038222713
"Washington, DC (Hagrstwn)",22729,1125,17,15,11,43,0.038222222
Bakersfield,93255,628,10,8,6,24,0.038216561
Duluth-Superior,55717,341,5,4,4,13,0.038123167
Seattle-Tacoma,98381,446,6,5,6,17,0.038116592
Tampa-St. Pete (Sarasota),34249,184,2,3,2,7,0.038043478
Wichita-Hutchinson Plus,67159,184,3,2,2,7,0.038043478
Anchorage,99605,184,3,2,2,7,0.038043478
Chico-Redding,96051,1264,17,12,19,48,0.037974684
Wichita-Hutchinson Plus,67454,501,8,4,7,19,0.037924152
"Springfield, MO",65658,871,13,10,10,33,0.037887486
Tampa-St. Pete (Sarasota),33706,15218,174,209,193,576,0.037849915
Myrtle Beach-Florence,29582,19844,267,220,264,751,0.037845193
Wausau-Rhinelander,54513,370,4,5,5,14,0.037837838
Phoenix (Prescott),85373,18427,288,222,187,697,0.037824931
Minneapolis-St. Paul,56458,344,4,5,4,13,0.037790698
San Angelo,76854,344,5,4,4,13,0.037790698
Denver,81130,875,11,7,15,33,0.037714286
Missoula,59928,239,3,3,3,9,0.037656904
Chico-Redding,95527,478,8,5,5,18,0.037656904
Tulsa,74084,505,8,7,4,19,0.037623762
Monroe-El Dorado,71404,2076,30,24,24,78,0.037572254
Wilkes Barre-Scranton-Hztn,18214,3120,42,40,35,117,0.0375
Eugene,97413,880,12,10,11,33,0.0375
Denver,80449,1067,20,8,12,40,0.037488285
Wilkes Barre-Scranton-Hztn,17810,5052,57,64,68,189,0.037410926
Tampa-St. Pete (Sarasota),34224,17274,210,195,240,645,0.037339354
Denver,80428,750,12,13,3,28,0.037333333
Fresno-Visalia,93664,670,14,7,4,25,0.037313433
Sacramnto-Stkton-Modesto,95689,1261,17,9,21,47,0.037272006
Bangor,4442,483,7,5,6,18,0.037267081
Marquette,49910,376,4,5,5,14,0.037234043
Greenville-N.Bern-Washngtn,28512,3064,36,35,43,114,0.037206266
Tampa-St. Pete (Sarasota),33786,1667,24,25,13,62,0.037192561
Traverse City-Cadillac,49728,242,3,3,3,9,0.037190083
San Angelo,76862,242,4,3,2,9,0.037190083
San Angelo,76866,592,11,6,5,22,0.037162162
Duluth-Superior,55615,377,3,3,8,14,0.037135279
"Springfield, MO",72631,4149,65,41,48,154,0.037117378
Palm Springs,92264,19654,189,229,310,728,0.037040806
Norfolk-Portsmth-Newpt Nws,23426,27,1,0,0,1,0.037037037
Traverse City-Cadillac,49739,27,0,0,1,1,0.037037037
Davenport-R.Island-Moline,52759,27,1,0,0,1,0.037037037
Duluth-Superior,55613,189,1,1,5,7,0.037037037
Sacramnto-Stkton-Modesto,95923,54,0,1,1,2,0.037037037
"Portland, OR",97877,351,6,4,3,13,0.037037037
Tampa-St. Pete (Sarasota),34293,49664,711,605,520,1836,0.036968428
Phoenix (Prescott),85348,2301,39,28,18,85,0.036940461
Albuquerque-Santa Fe,87827,379,7,4,3,14,0.036939314
Wausau-Rhinelander,54463,704,9,10,7,26,0.036931818
Colorado Springs-Pueblo,81091,813,12,6,12,30,0.036900369
Portland-Auburn,4576,597,6,8,8,22,0.036850921
Evansville,47514,1764,21,19,25,65,0.036848073
Presque Isle,4779,353,5,4,4,13,0.036827195
Orlando-Daytona Bch-Melbrn,34785,34300,429,394,437,1260,0.036734694
Portland-Auburn,3592,1089,12,14,14,40,0.036730946
Quincy-Hannibal-Keokuk,65282,109,2,1,1,4,0.036697248
Denver,80456,1172,17,10,16,43,0.03668942
Portland-Auburn,4003,355,5,6,2,13,0.036619718
Wausau-Rhinelander,54561,82,1,1,1,3,0.036585366
Palm Springs,92210,5004,60,65,58,183,0.036570743
Salisbury,19967,2434,30,30,29,89,0.036565325
Billings,59027,766,6,6,16,28,0.036553525
Denver,80455,411,6,5,4,15,0.03649635
Eugene,97441,274,5,3,2,10,0.03649635
Anchorage,99572,329,5,3,4,12,0.036474164
Salisbury,21824,192,3,1,3,7,0.036458333
Norfolk-Portsmth-Newpt Nws,23829,2421,38,26,24,88,0.036348616
Youngstown,44503,2285,24,26,33,83,0.036323851
South Bend-Elkhart,49116,358,5,5,3,13,0.036312849
Portland-Auburn,4066,579,9,9,3,21,0.03626943
Greenvll-Spart-Ashevll-And,29676,6069,90,69,61,220,0.036249794
West Palm Beach-Ft. Pierce,33484,27845,273,318,418,1009,0.036236308
Missoula,59871,276,5,3,2,10,0.036231884
Chico-Redding,96075,414,7,4,4,15,0.036231884
"Portland, OR",97149,690,10,8,7,25,0.036231884
Greenville-N.Bern-Washngtn,28571,2623,46,25,24,95,0.036218071
Ft. Myers-Naples,34141,250,6,2,1,9,0.036
Augusta-Aiken,29835,7334,90,105,69,264,0.035996728
Salisbury,19944,584,6,7,8,21,0.035958904
"Charleston, SC",29438,3091,41,39,31,111,0.035910709
San Francisco-Oak-San Jose,95465,1173,14,16,12,42,0.035805627
Phoenix (Prescott),86336,11648,142,117,158,417,0.035800137
Clarksburg-Weston,26289,56,1,1,0,2,0.035714286
Fargo,58363,56,1,1,0,2,0.035714286
"Portland, OR",97840,112,2,0,2,4,0.035714286
Seattle-Tacoma,98326,897,12,8,12,32,0.03567447
Savannah,31411,8594,155,108,43,306,0.035606237
Terre Haute,62466,3822,50,40,46,136,0.035583464
"Columbus, GA (Opelika, AL)",31735,759,8,9,10,27,0.035573123
"Springfield, MO",72617,197,4,1,2,7,0.035532995
Phoenix (Prescott),85739,18860,283,198,189,670,0.03552492
Marquette,54120,282,6,2,2,10,0.035460993
Duluth-Superior,54547,1636,29,18,11,58,0.035452323
Norfolk-Portsmth-Newpt Nws,27986,2230,26,29,24,79,0.035426009
Seattle-Tacoma,98569,7398,100,65,97,262,0.035414977
Wausau-Rhinelander,54557,1164,18,14,9,41,0.035223368
Austin,78633,30426,468,351,252,1071,0.035200158
Fresno-Visalia,93604,625,9,8,5,22,0.0352
Chico-Redding,96059,541,8,5,6,19,0.035120148
Green Bay-Appleton,54212,1197,13,14,15,42,0.035087719
Oklahoma City,73841,1340,15,18,14,47,0.035074627
Binghamton,13731,1055,13,12,12,37,0.03507109
San Francisco-Oak-San Jose,94595,17651,294,174,151,619,0.035068835
Marquette,49895,656,9,7,7,23,0.035060976
Burlington-Plattsburgh,5062,600,11,6,4,21,0.035
Traverse City-Cadillac,49782,600,11,6,4,21,0.035
Cedar Rapids-Wtrlo-IWC&Dub,52146,860,11,11,8,30,0.034883721
Missoula,59827,201,4,2,1,7,0.034825871
Oklahoma City,73673,288,3,4,3,10,0.034722222
Burlington-Plattsburgh,3241,1037,17,7,12,36,0.034715526
Little Rock-Pine Bluff,71909,18281,235,201,198,634,0.034680816
Orlando-Daytona Bch-Melbrn,32159,31108,358,376,344,1078,0.034653465
Raleigh-Durham (Fayetvlle),27842,1472,15,22,14,51,0.034646739
Wausau-Rhinelander,54529,1213,20,11,11,42,0.034624897
Green Bay-Appleton,54102,809,11,7,10,28,0.03461063
Ft. Myers-Naples,33947,12350,163,153,111,427,0.034574899
Ft. Myers-Naples,34108,15639,170,196,174,540,0.034529062
Flint-Saginaw-Bay City,48743,58,1,1,0,2,0.034482759
Raleigh-Durham (Fayetvlle),27503,6988,80,81,79,240,0.034344591
Austin,78609,2071,27,25,19,71,0.034282955
Phoenix (Prescott),85262,13898,164,191,121,476,0.034249532
San Francisco-Oak-San Jose,95456,730,11,4,10,25,0.034246575
"Springfield, MO",65676,351,3,4,5,12,0.034188034
Boise,97911,88,1,1,1,3,0.034090909
Orlando-Daytona Bch-Melbrn,32169,10482,131,130,96,357,0.034058386
"Portland, OR",97884,147,2,2,1,5,0.034013605
Portland-Auburn,3579,471,5,4,7,16,0.033970276
Ft. Myers-Naples,33950,25706,278,283,309,870,0.033844239
Duluth-Superior,54821,1420,16,18,14,48,0.033802817
Traverse City-Cadillac,49636,474,4,6,6,16,0.033755274
Colorado Springs-Pueblo,81233,1067,13,12,11,36,0.033739456
Bangor,4686,89,2,1,0,3,0.033707865
Minneapolis-St. Paul,56447,981,16,7,10,33,0.033639144
San Francisco-Oak-San Jose,95452,1103,10,15,12,37,0.033544878
Traverse City-Cadillac,48728,329,3,4,4,11,0.03343465
Binghamton,12421,450,9,3,3,15,0.033333333
Minneapolis-St. Paul,56448,480,9,2,5,16,0.033333333
Albuquerque-Santa Fe,87724,120,1,2,1,4,0.033333333
"Portland, OR",97819,30,1,0,0,1,0.033333333
Terre Haute,47838,3961,45,40,47,132,0.033324918
Green Bay-Appleton,54149,1231,16,12,13,41,0.033306255
Wausau-Rhinelander,54465,662,9,6,7,22,0.033232628
Tampa-St. Pete (Sarasota),34242,6904,81,84,64,229,0.033169177
Chico-Redding,96048,726,11,6,7,24,0.033057851
Bangor,4925,91,1,1,1,3,0.032967033
Palm Springs,92270,17539,200,187,191,578,0.032955129
Wilmington,28467,13619,168,155,125,448,0.03289522
Seattle-Tacoma,98279,852,10,7,11,28,0.03286385
Fresno-Visalia,93669,306,4,3,3,10,0.032679739
Wichita-Hutchinson Plus,67622,460,6,5,4,15,0.032608696
Wichita-Hutchinson Plus,67523,338,6,3,2,11,0.032544379
Seattle-Tacoma,98640,5224,65,64,41,170,0.032542113
Austin,76885,154,2,1,2,5,0.032467532
Salisbury,21627,31,1,0,0,1,0.032258065
"Portland, OR",97837,124,2,1,1,4,0.032258065
Ft. Myers-Naples,33955,11916,122,138,124,384,0.032225579
Phoenix (Prescott),86441,1834,32,11,16,59,0.03217012
Boston (Manchester),2657,3702,34,35,50,119,0.032144787
"Columbia, SC",29051,1747,21,18,17,56,0.032054951
Richmond-Petersburg,22480,1062,13,12,9,34,0.032015066
Richmond-Petersburg,23070,439,5,5,4,14,0.031890661
Tulsa,74829,1576,14,17,19,50,0.031725888
Wilmington,28468,5718,68,58,55,181,0.031654425
Paducah-Cape Girard-Harsbg,62846,1904,22,21,17,60,0.031512605
Salt Lake City,84783,767,8,7,9,24,0.031290743
Detroit,48028,706,8,5,9,22,0.031161473
Denver,80545,1160,15,8,13,36,0.031034483
Odessa-Midland,79854,226,4,2,1,7,0.030973451
Duluth-Superior,54865,485,7,4,4,15,0.030927835
San Angelo,76848,97,1,1,1,3,0.030927835
Tampa-St. Pete (Sarasota),34292,20418,241,214,175,630,0.030855128
Traverse City-Cadillac,49726,878,10,8,9,27,0.030751708
Boise,97906,295,4,3,2,9,0.030508475
Norfolk-Portsmth-Newpt Nws,23867,5214,60,52,47,159,0.030494822
Monroe-El Dorado,71286,2070,18,22,23,63,0.030434783
Seattle-Tacoma,98535,395,5,4,3,12,0.030379747
Traverse City-Cadillac,49725,561,8,6,3,17,0.03030303
Bismarck-Mnt-Dcknsn(Wlstn),59276,33,1,0,0,1,0.03030303
Sioux Falls(Mitchell),57335,265,3,3,2,8,0.030188679
Green Bay-Appleton,54175,1096,12,12,9,33,0.030109489
Seattle-Tacoma,98555,798,11,8,5,24,0.030075188
Orlando-Daytona Bch-Melbrn,32798,1806,22,16,16,54,0.029900332
Traverse City-Cadillac,49768,369,3,5,3,11,0.029810298
Phoenix (Prescott),86351,6542,67,64,64,195,0.029807398
Ft. Myers-Naples,34145,15883,174,156,139,469,0.029528427
Chico-Redding,96010,34,1,0,0,1,0.029411765
Tampa-St. Pete (Sarasota),34217,4901,53,54,37,144,0.029381759
Tampa-St. Pete (Sarasota),34215,785,9,8,6,23,0.029299363
Greenville-N.Bern-Washngtn,27875,376,7,2,2,11,0.029255319
Seattle-Tacoma,98365,5311,53,44,58,155,0.029184711
Denver,80820,892,11,6,9,26,0.029147982
Salt Lake City,84733,103,1,1,1,3,0.029126214
Duluth-Superior,54844,344,4,3,3,10,0.029069767
Orlando-Daytona Bch-Melbrn,34797,1172,14,11,9,34,0.029010239
Green Bay-Appleton,54138,828,9,8,7,24,0.028985507
Denver,80728,936,9,7,11,27,0.028846154
Jacksonville,31527,902,6,10,10,26,0.028824834
Medford-Klamath Falls,97465,2165,29,17,16,62,0.028637413
Sacramnto-Stkton-Modesto,96103,1224,12,11,12,35,0.028594771
West Palm Beach-Ft. Pierce,32963,16929,177,168,139,484,0.028589994
West Palm Beach-Ft. Pierce,34949,8162,64,81,88,233,0.028546925
Wausau-Rhinelander,54545,878,11,9,5,25,0.028473804
Eugene,97390,774,9,7,6,22,0.028423773
"Portland, OR",97711,106,1,1,1,3,0.028301887
San Francisco-Oak-San Jose,95450,391,4,3,4,11,0.028132992
Phoenix (Prescott),86444,1531,11,13,19,43,0.028086218
Portland-Auburn,3907,1533,16,13,14,43,0.028049576
Tampa-St. Pete (Sarasota),33715,7816,66,84,69,219,0.028019447
Phoenix (Prescott),85544,2899,40,23,18,81,0.027940669
Tampa-St. Pete (Sarasota),33767,8404,83,80,70,233,0.027724893
Sioux Falls(Mitchell),57317,397,4,4,3,11,0.027707809
Tampa-St. Pete (Sarasota),34201,3882,40,34,33,107,0.027563112
West Palm Beach-Ft. Pierce,33480,10885,101,104,92,297,0.027285255
Phoenix (Prescott),85118,13935,128,135,113,376,0.026982418
West Palm Beach-Ft. Pierce,33477,13027,104,124,122,350,0.026867276
Wilkes Barre-Scranton-Hztn,17723,149,1,2,1,4,0.026845638
Tucson (Sierra Vista),85614,26805,277,238,203,718,0.026786047
Champaign&Sprngfld-Decatur,62555,416,5,3,3,11,0.026442308
Tampa-St. Pete (Sarasota),34223,20815,200,150,200,550,0.026423252
Spokane,99105,38,1,0,0,1,0.026315789
Phoenix (Prescott),86445,343,3,2,4,9,0.026239067
Houston,75852,3286,35,24,27,86,0.026171637
Orlando-Daytona Bch-Melbrn,32831,3293,18,23,45,86,0.026116004
Portland-Auburn,4554,733,6,6,7,19,0.025920873
Ft. Myers-Naples,33946,2286,25,20,14,59,0.025809274
Sioux Falls(Mitchell),57062,2333,25,15,20,60,0.02571796
San Angelo,76841,78,1,1,0,2,0.025641026
"Portland, OR",97730,353,4,1,4,9,0.025495751
Wausau-Rhinelander,54462,355,3,1,5,9,0.025352113
Wichita-Hutchinson Plus,67574,199,3,1,1,5,0.025125628
Seattle-Tacoma,98320,1436,15,11,10,36,0.025069638
San Francisco-Oak-San Jose,94599,3459,29,19,38,86,0.024862677
New York,8759,35871,252,313,325,890,0.024811129
Clarksburg-Weston,26430,2314,20,19,18,57,0.024632671
Salisbury,21675,122,2,0,1,3,0.024590164
Ft. Myers-Naples,33957,6459,65,61,32,158,0.024461991
Idaho Fals-Pocatllo(Jcksn),83229,41,1,0,0,1,0.024390244
Duluth-Superior,55607,166,2,1,1,4,0.024096386
"Portland, OR",98581,626,7,4,4,15,0.023961661
Little Rock-Pine Bluff,72168,885,5,5,11,21,0.023728814
Bluefield-Beckley-Oak Hill,25059,1541,12,11,13,36,0.023361454
Orlando-Daytona Bch-Melbrn,34481,28453,247,209,208,664,0.023336731
Tampa-St. Pete (Sarasota),34285,18838,129,148,159,436,0.023144708
Phoenix (Prescott),86024,791,10,6,2,18,0.022756005
Seattle-Tacoma,98358,1015,9,7,7,23,0.022660099
Colorado Springs-Pueblo,81062,2304,25,19,6,50,0.021701389
Bangor,4478,328,3,2,2,7,0.021341463
Ft. Myers-Naples,34134,15853,89,105,142,336,0.021194727
Salisbury,21672,147,2,0,1,3,0.020408163
Phoenix (Prescott),86443,49,0,0,1,1,0.020408163
Pittsburgh,16239,3846,35,21,20,76,0.01976079
Orlando-Daytona Bch-Melbrn,32976,9849,71,69,49,189,0.019189765
"Washington, DC (Hagrstwn)",20317,582,3,3,5,11,0.018900344
Ft. Myers-Naples,33931,9301,52,66,57,175,0.018815181
Ft. Myers-Naples,33956,3745,26,29,15,70,0.018691589
Little Rock-Pine Bluff,71643,4783,31,25,26,82,0.017144052
Tampa-St. Pete (Sarasota),34228,7427,33,41,49,123,0.016561196
Paducah-Cape Girard-Harsbg,62943,2985,19,17,13,49,0.01641541
Traverse City-Cadillac,49775,127,1,0,1,2,0.015748031
Memphis,72320,1620,11,9,5,25,0.015432099
Knoxville,38558,9865,60,47,45,152,0.015408008
Tampa-St. Pete (Sarasota),33867,131,0,1,1,2,0.015267176
Phoenix (Prescott),85263,4144,20,21,22,63,0.015202703
Pittsburgh,15433,2474,14,13,9,36,0.014551334
"Portland, OR",97369,277,4,0,0,4,0.014440433
"Albany, GA",39866,1957,15,5,7,27,0.013796627
Philadelphia,8314,2834,9,6,21,36,0.012702893
Boise,97903,158,1,1,0,2,0.012658228
Richmond-Petersburg,23891,1932,9,4,10,23,0.011904762
Salisbury,21626,88,1,0,0,1,0.011363636
San Diego,92140,2059,5,14,3,22,0.010684798
Dallas-Ft. Worth,75861,8495,37,21,31,89,0.010476751
Orlando-Daytona Bch-Melbrn,32163,23352,87,50,56,193,0.008264817
Phoenix (Prescott),85375,28990,87,63,63,213,0.007347361
Phoenix (Prescott),85351,29704,69,71,68,208,0.007002424
Las Vegas,89034,2714,6,3,8,17,0.006263817
Los Angeles,92637,18683,29,37,41,107,0.005727132
Tucson (Sierra Vista),85622,6496,11,12,7,30,0.004618227
Orlando-Daytona Bch-Melbrn,32162,53921,84,60,54,198,0.003672039
Providence-New Bedford,2836,13,0,0,0,0,0
Providence-New Bedford,2877,8,0,0,0,0,0
Portland-Auburn,3897,18,0,0,0,0,0
Portland-Auburn,4226,8,0,0,0,0,0
New York,7881,5,0,0,0,0,0
New York,8887,16,0,0,0,0,0
New York,10020,7,0,0,0,0,0
New York,10112,5,0,0,0,0,0
Albany-Schenectady-Troy,12024,19,0,0,0,0,0
Syracuse,13314,11,0,0,0,0,0
Utica,13859,15,0,0,0,0,0
Pittsburgh,15488,14,0,0,0,0,0
Johnstown-Altoona-St Colge,15564,7,0,0,0,0,0
Pittsburgh,16331,17,0,0,0,0,0
Johnstown-Altoona-St Colge,16850,6,0,0,0,0,0
Wilkes Barre-Scranton-Hztn,17727,20,0,0,0,0,0
Philadelphia,19112,4,0,0,0,0,0
"Washington, DC (Hagrstwn)",20422,43,0,0,0,0,0
"Washington, DC (Hagrstwn)",20433,1,0,0,0,0,0
"Washington, DC (Hagrstwn)",20771,3,0,0,0,0,0
"Washington, DC (Hagrstwn)",20899,5,0,0,0,0,0
Baltimore,21031,7,0,0,0,0,0
Baltimore,21287,8,0,0,0,0,0
Pittsburgh,21522,16,0,0,0,0,0
Norfolk-Portsmth-Newpt Nws,23302,6,0,0,0,0,0
Roanoke-Lynchburg,24581,16,0,0,0,0,0
Bluefield-Beckley-Oak Hill,24830,6,0,0,0,0,0
Clarksburg-Weston,26236,15,0,0,0,0,0
Raleigh-Durham (Fayetvlle),27711,7,0,0,0,0,0
Louisville,40041,16,0,0,0,0,0
"Tri-Cities, TN-VA",41848,13,0,0,0,0,0
Toledo,43436,15,0,0,0,0,0
Cleveland-Akron (Canton),44195,1,0,0,0,0,0
Indianapolis,46971,20,0,0,0,0,0
Indianapolis,47236,11,0,0,0,0,0
Des Moines-Ames,50059,12,0,0,0,0,0
Des Moines-Ames,50259,22,0,0,0,0,0
Rochestr-Mason City-Austin,50481,15,0,0,0,0,0
Cedar Rapids-Wtrlo-IWC&Dub,50649,4,0,0,0,0,0
Cedar Rapids-Wtrlo-IWC&Dub,52252,10,0,0,0,0,0
Quincy-Hannibal-Keokuk,52648,5,0,0,0,0,0
Davenport-R.Island-Moline,52771,4,0,0,0,0,0
Duluth-Superior,56658,4,0,0,0,0,0
Bismarck-Mnt-Dcknsn(Wlstn),57659,3,0,0,0,0,0
Fargo,58236,23,0,0,0,0,0
Fargo,58255,6,0,0,0,0,0
Fargo,58452,18,0,0,0,0,0
Bismarck-Mnt-Dcknsn(Wlstn),58505,4,0,0,0,0,0
Bismarck-Mnt-Dcknsn(Wlstn),58644,16,0,0,0,0,0
Great Falls,59240,8,0,0,0,0,0
Great Falls,59273,15,0,0,0,0,0
Glendive,59341,12,0,0,0,0,0
Helena,59641,9,0,0,0,0,0
Paducah-Cape Girard-Harsbg,62962,16,0,0,0,0,0
St. Louis,63045,5,0,0,0,0,0
St. Louis,63167,11,0,0,0,0,0
Paducah-Cape Girard-Harsbg,63737,4,0,0,0,0,0
Kansas City,66118,18,0,0,0,0,0
Joplin-Pittsburg,66778,12,0,0,0,0,0
Wichita-Hutchinson Plus,66855,4,0,0,0,0,0
Lincoln & Hastings-Krny,69171,20,0,0,0,0,0
New Orleans,70421,13,0,0,0,0,0
Tulsa,74529,15,0,0,0,0,0
Austin,76831,30,0,0,0,0,0
San Angelo,76836,23,0,0,0,0,0
San Antonio,76883,19,0,0,0,0,0
Corpus Christi,78060,8,0,0,0,0,0
San Antonio,78111,13,0,0,0,0,0
Amarillo,79223,18,0,0,0,0,0
Lubbock,79326,11,0,0,0,0,0
Denver,82615,11,0,0,0,0,0
Casper-Riverton,82630,23,0,0,0,0,0
Casper-Riverton,82638,17,0,0,0,0,0
Rapid City,82715,4,0,0,0,0,0
Idaho Fals-Pocatllo(Jcksn),83235,11,0,0,0,0,0
Salt Lake City,84008,3,0,0,0,0,0
Salt Lake City,84143,6,0,0,0,0,0
Amarillo,88123,9,0,0,0,0,0
Amarillo,88133,4,0,0,0,0,0
Los Angeles,91189,6,0,0,0,0,0
Los Angeles,91329,4,0,0,0,0,0
Los Angeles,92338,3,0,0,0,0,0
Los Angeles,92862,14,0,0,0,0,0
Fresno-Visalia,95325,17,0,0,0,0,0
Sacramnto-Stkton-Modesto,95836,14,0,0,0,0,0
Medford-Klamath Falls,96085,13,0,0,0,0,0
"Portland, OR",97861,1,0,0,0,0,0
Boise,97908,71,0,0,0,0,0
"Portland, OR",98628,22,0,0,0,0,0
Spokane,99104,14,0,0,0,0,0
Fairbanks,99704,4,0,0,0,0,0
